e_rara_id,text_len,intersect,intersect_c,diff_flair,diff_flair_c,diff_bpe,diff_bpe_c,sym_diff,sym_diff_c
14432690,46334,"{'Nordamerika', 'Thun', 'Missouri', 'Murten', 'Bielersee', 'Neuenburg', 'Neuenstadt', 'Bern'}",8,"{'Ruhr', 'Bielersee Dorfe Gerlafingen', 'Ammerzwyl, SLOC', 'Hüls', 'Gerlafingen', 'Aare'}",6,"{'Diefibach', 'Moos', 'Gerla', 'Gro-Affolterrn', 'Buren', 'Jaberg', 'Diebach, ', 'Uttingenfiuh'}",8,"{'Diefibach', 'Bielersee Dorfe Gerlafingen', 'Moos', 'Gerlafingen', 'Aare', 'Uttingenfiuh', 'Ruhr', 'Gerla', 'Ammerzwyl, SLOC', 'Hüls', 'Gro-Affolterrn', 'Jaberg', 'Diebach, ', 'Buren'}",14
1757509,49807,"{'Wittwe', 'Altenberg', 'Cmannel', 'Ludw', 'Keilbach', 'Brunn', 'Kornhausplatz', 'Knieling', 'Streichenberg', 'Hotellaube', 'Franz', 'KornhauSplatz', 'Belp', 'Wiegsam', 'Matten', 'Nueff', 'Conrad', 'Stalden', 'Judeu', 'Lauterburg', 'Wyttenbach', 'Ebersold', 'Johann', 'Comp', 'Locle', 'Wasem', 'Tschanz', 'Sulgenbach', 'Meyertsen', 'Bern', 'Wenberg', 'Durheim', 'Samuel', 'Lang', 'Gerwerngraben', 'Arbek', 'Haag', 'Gerwernlaube', 'Woog', 'TettU', 'Zeughausplatz'}",41,"{'Judengaße', 'Kirchgaße', 'Kefichgäßlein', 'Rummel', 'NiehanS Frau Kramgaße', 'Groß Metzger Marti Gottlieb Kramgaffe', 'Münger', 'Dallemagne', 'Jnselgaße', 'Aarberggaße Liithi', 'Volj', 'Hubacher', 'Kramgaße', 'Schulgaße', 'Aarberggaße', 'Ganguillet', 'Spttalgaße', 'Keßlergasse', 'Schauplatzgaße', 'Stempfli', 'Korbmann Spitalgaße', 'NägeliSgäßlein', 'Brückfeld', 'Samuel Gabriel', 'Junkerngaße', 'Bollwerk', 'Krciö', 'Caspar', 'Zeughausgaße', 'Thoren Waisenhaus', 'Pfäffli Bollwerk', 'Feitknecht', 'Jnselgaße Spital', 'Ienner Abraham Matten Käser Aarberggaße Leuchli', 'Haus Christian Metzgerngaße', 'Keßlergaße', 'Fra', 'Rueff Spitalgaße', 'WWWM, SLOC', 'Marktgaße', 'Brunngaße', 'platzgaße', 'Cottonne', 'Wittwe Metzgerngaße', 'Waisenhausplatz Zeughaus', 'Notarien', 'Dünki', 'Neuengaße', 'Fouche Kramgaße', 'Matten Mettler Wittwe Matten Oth', 'Spitalgaße', 'LotterieBureau', 'JohannJakobLienhardt', 'Reuengaße', 'Monbijou', 'Metzgerngaße', 'Zürcher', 'Jfaak', 'Schulgäßlein', 'Gerechtigkeitgaße', 'Wabern', 'Schörer', 'Jngold', 'Kcßlergaße', 'Neuciigaje', 'Willading', 'Allen mann Kramgaße', 'Postgaße Jth', 'Berger Kramgaße', 'Gerechngkeitgaße', 'Mareoni', 'Junkcrngaße', 'Brunngasse Roder Franz Kramgasse', 'Hauptwache', 'Horn Metzgerngaße', 'Linde Ost', 'vonWattenwyl', 'PascaliN', 'Stuber Brunngasse'}",79,"{'Rfe', 'Falke', 'Aloy', 'Wolf', 'Schnegg', 'Lauterburg-Baumann', 'Klein', 'Diebach', 'Iaguet', 'Aarherggae', 'Guisot', 'Habegger', 'Graben', 'Krci', 'Legrand', 'Menteler', 'NiklauS', 'Metzgern', 'Zngold', 'Markt', 'Wamer', 'Ganting', 'Schlapp', 'Echvhalden', 'Danner', 'Niklaus', 'Jenner', 'Lanz', 'Bttikofer', 'Johannes', 'Brunner', 'Friedli', 'Maser', 'Keilbach, ', 'Wasserbrenner', 'Drogerien', 'Hotz', 'Stiefelformeir', 'CorsetS', 'Haar', 'Piano', 'Ueterrch', 'Judengae', 'Jnsclgae', 'Eberhardt', 'Dasen', 'Beck', 'Haller', 'Pauli', 'Grner', 'Lvy', 'Kummer', 'Spezerey', 'Echrch', 'Neuengae', 'Sgenfetler', 'Rothen Marktgae', 'Nieter', 'Lthardt', 'Slro', 'Buchhofer', 'Weiler', 'Obouier', 'Ratz', 'Gyger', 'Postga', 'Aarberg-Thor', 'Vivis', 'Schupp', 'ZwtebelngleiN', 'Sim', 'Noth', 'Nller', 'B.Pgin', 'Mller', 'Schwarz', 'Henzi', 'Leuenberger', 'Glur', 'Rfenacht', 'Kelergae', 'Hrning', 'Pl', 'Pnppelin', 'Schau', 'Conr.Weterich', 'Cuendoz', 'Drvelle', 'Iaqnerod', 'Lenz', 'Bonjour', 'Kirchgae', 'Hemmanu', 'Matthias', 'Trchsel', 'Heiniger', 'Deiwyl', 'Schubert', 'Dfresne', 'Strhl', 'Dizerand', 'Spri', 'Tschau', 'Scheid', 'Zrcher', 'Diwy', '- platz.', 'Gasser', 'Simmen', 'Carrard', 'Worb', 'Jenzer', 'Boskard', 'Marktgaste', 'Muralt', 'Horn', 'Dppen', 'Holligen-Drittel', 'Mevli', 'Schlibaum', 'Schulgae', 'Zumbrunnen', 'Denereaz', 'Rellstab', 'GaletteS', 'Stalde', 'Ost', 'Fiend', 'Liechti', 'Landolt', 'Neucnschw', 'Riklaus', 'Siegmund', 'Zritglockenthurm', 'Graffenried', 'Hug', 'Oppliger', 'Rosselet', 'Kefichga', 'Tieffenbach', 'Zwiebelnglein', 'Leutziger', 'Schlupp', 'Schauplatzgar', 'Hen', 'Rohrer', 'Zeender', 'Pochon', 'Hemmann', 'Krauchthal', 'Retschi', 'Christian', 'Brunngaffe', 'Kisling', 'Giesa', 'Kelergasse', 'Aornhausplatz', 'Frank', 'Bloch', 'Schr', 'Biziau', 'Sradtbach', 'Zeitglockenthurm', 'Jordan', 'Dick', 'Iunkerngae', 'Ebenisten', 'Fisch', 'Aarziehle', 'Ochsenbein', '^', 'Herich', 'Aegerden', 'Michael', 'Meyer', 'Ditmar', 'Gabriel', 'Selterswasser', 'Jnselgae', 'Stuber', 'Dnz', 'Dulick', 'Heller', 'Spiralgae', 'Wlti', 'Wild', 'Blonden', 'Fifian', 'SamuN', 'Schwizgbel', 'Reuengae', 'Zumbach', 'Herdi', 'Frick', 'egg', 'Winkel', 'Gotlhelf', 'Emanuel', 'Tuch', 'Zbin', 'Kornhauplatz', 'Die', 'Gottlieb', 'Waisenhausplatz', 'Tapete', 'Daniel Marktgae', 'Kramzae', 'Gott', 'Leist', 'Holzmann', 'Menberg', 'Lutz', 'Fachinger', 'Widm', 'Burgdorfer', 'Ulrich', 'Daniel', 'Asper', 'Walthard', 'Fetscherin', 'Steiner', 'Beuoit', 'Eerechtigkeitgae', 'Frey', 'Brunngasse', 'Jungfer', 'Aarberggasse', 'Andreas', 'Luginbhl', 'Heba', 'AlthauS', 'Giudice', 'Freudenberger', 'Nohrer', 'Fayence', 'Aeb', 'Steinauer', 'Leuch', 'Roder', 'Gfeller', 'Neuenschwandek', 'Studer', 'Postgasse', 'Guter', 'Metzgerngae', 'Aarberg', 'Rindlispacher', 'BloeSt', 'Wagner', 'Bieri', 'Ars', 'Postgae', 'Brckfeld', 'Dietrich', 'Schlegel', 'Bendichr', 'Wein', 'Attenbxrg', 'Lutstorf', 'Gottlicb', 'Isenschmid', 'Skalden', 'Abraham', 'Bomsel', 'Spitglgae', 'Sterchi', 'Genton', 'Gerxchtigkeitgae', 'Knig', 'Hi', 'Burk', 'Dpau', 'RHeiner', 'Cmauuel', 'Bhlen', 'Metzgerngaffe', '-', 'Spi', 'Drig', 'platzgae', 'Robert', 'Adelmann', 'Leuchli', 'Linde', 'Koch', 'Poftgae', 'Holz', 'Schwob', 'Wassern', 'Zeughausgae', 'Kefichglein', 'Girodon', 'Aebi', 'Tri botet', 'Reidenbach', 'Blau', 'Bhler', 'Blauner', 'Storchenglein', 'Viktor', 'Gerechtigkeitgae', 'Poftgge', 'Schuwey', 'Lamotte', 'Owald', 'Bendicht', 'LiechtiT', 'Zeughausgasse', 'Zenghausgae', 'Friedrich', 'Klein.Metzger', 'Neuciigaj-e', 'Samuel Spitalgae', 'Schneit', 'Lutftorf', 'DurS', 'Kreuzgae', 'Bruyngae', 'Grf', 'Aarberggaffe', 'Sommer', 'Sprngli', 'Steiger', 'Junkerngae', 'Brki', 'Gerechtigkeitgasse', 'Sebastian', 'graben', 'Eig', 'Aebersold', 'Heimel', 'Jmhoof', 'Egg', 'Kerzern', 'Kugel', 'Geilnauer', 'Weibermarkt', 'By', 'Aarziehle-Thor', 'Gschwind', 'Schauplatzgae', 'Lasond', 'Lohri', 'Schwein.Metzger', 'Betten Marktgae', 'Jenni', 'Strahm', 'Werner', 'Bo', 'Portraitmaler', 'Stauffer', 'Kirch', 'Flkiger', 'Aaron', 'Schnauer', 'Surer', '- talgae', 'Kser', 'Liebefeld', 'Mare', 'Adle', 'Lamy', 'Gro', 'Carl', 'Javet', 'Marktgasse', 'Sulgcnbach', 'Schock', 'Rohr', 'Schanplatzgafie', 'Rndolf Marktgasse', 'Bihler', 'Horellaube', 'Oel Puder', 'Cichovien', 'Br', 'MeiSncr', 'Bergen', 'Seide', 'Kenzi', 'Krhenbhl', 'Oltramare', 'Traffelet', 'Rosen', 'Neuhaus', 'David', 'Wy', 'Kramgae', 'Seeger', 'Klaus', 'Kramgasse', 'Germern', 'Krpf', 'Jnbnit', 'Schie', 'Walt', 'Zbinden', 'Lderach', 'Beri', 'Eyen', 'Emmisperger', 'Nro', 'Schohalden', 'Villeneuve', 'Brunngae', 'Lehman', 'ZeughauSgae', 'Merz', 'Spitalgasse', 'Ulrrch', 'Offen', 'Blaser', 'Stachen', 'Thrner', 'Motti', 'Couchoud', 'Bigler', 'Mller Jakob', 'Kurz-Fruting', 'Krebs', 'Rudolf', 'Schauplaygae', 'Schnt', 'Dolmar', 'Ammeter', 'Rthlisperger', 'Lemp', 'Iobann', 'Senn', 'DopS', 'Jth', 'Kinkeltn', 'Schmid', 'Eggimann', 'Freudenreich', 'Mozin', 'Melchior', 'Hotellaybe', 'ach', 'Zcugbausplatz', 'Verlag', 'Lthi', 'Peter', 'Fehlbaum', 'Zumstein', 'Albrecht', 'Nieder', 'Langga-Drittel', 'Spitalgae', 'Zwiebelnglem', 'Bonner', 'Rieh', 'Hofer', 'Metzgerngasse', 'Strmpfen', 'Rohaar', 'Speichern', 'Dellen', 'Lttginbhl', 'Masfecker', 'Schlachthaus', 'Langgae', 'Kpfer', 'Schreinermeisiek', 'Weibel', 'Hartmann', 'Schonauer', '/', 'Stegmann', 'Bruischi', 'Schlsli', 'Heinrich', 'Waisenhaus', 'Kclergae', 'Grau', 'Carl Metzgerngasse', 'Kiener', 'Zeughaus', 'Meley', 'Veyre', 'Moses', 'Neumhle', 'Gautschi', 'Wisard', 'Christinaz', 'Kclergasse', 'Zucker', 'Bru-nngae', 'Allenmann', 'Haberkernen', 'Kirchhflein', 'Jakob', 'Trechsel', 'Stoo', 'Durisch', '- gae', 'Wernli', 'Jsenschmid', 'Chautems', 'Hellen', 'Krieg', 'Ri', 'Vergolder', 'Jnnkerngae', 'Grrechtigkeitgae', 'Blankenhorn', 'Kopp', 'Dnki', 'Schwitz', 'Marktgae', 'Aarberggae', 'Gaudin', 'Breitfeld', 'Langhaus', 'Cachar', 'Sonderegger', 'Wt', 'Jttselgae', 'Morgenthaler', 'Bollin', 'Ernst', 'obern', 'Neuenschwander', 'NiehanS'}",524,"{'Rfe', 'Falke', 'Aloy', 'Wolf', 'Schnegg', 'Lauterburg-Baumann', 'Klein', 'Diebach', 'Iaguet', 'Aarherggae', 'Guisot', 'Habegger', 'Graben', 'Krci', 'Legrand', 'Menteler', 'NiklauS', 'Metzgern', 'Zngold', 'Markt', 'Hubacher', 'Wamer', 'Ganting', 'Kramgaße', 'Schlapp', 'Echvhalden', 'Danner', 'Niklaus', 'Jenner', 'Lanz', 'Bttikofer', 'Johannes', 'Brunner', 'Friedli', 'Maser', 'Keilbach, ', 'Wasserbrenner', 'Drogerien', 'Samuel Gabriel', 'Hotz', 'Stiefelformeir', 'Krciö', 'CorsetS', 'Haar', 'Piano', 'Ueterrch', 'Judengae', 'Jnsclgae', 'Eberhardt', 'Dasen', 'Beck', 'Haller', 'Ienner Abraham Matten Käser Aarberggaße Leuchli', 'Pauli', 'Grner', 'Lvy', 'Kummer', 'Spezerey', 'Echrch', 'Neuengae', 'Sgenfetler', 'Rothen Marktgae', 'Nieter', 'Lthardt', 'Slro', 'Buchhofer', 'Weiler', 'Obouier', 'Ratz', 'Gyger', 'Postga', 'Brunngaße', 'Aarberg-Thor', 'Vivis', 'Schupp', 'ZwtebelngleiN', 'Sim', 'Noth', 'Nller', 'B.Pgin', 'Mller', 'Schwarz', 'Henzi', 'Leuenberger', 'Glur', 'Rfenacht', 'Kelergae', 'Hrning', 'Pl', 'Pnppelin', 'Schau', 'Conr.Weterich', 'Cuendoz', 'Drvelle', 'Iaqnerod', 'Lenz', 'Bonjour', 'Kirchgae', 'Hemmanu', 'Matthias', 'LotterieBureau', 'Trchsel', 'Heiniger', 'Deiwyl', 'Monbijou', 'Schubert', 'Dfresne', 'Jfaak', 'Strhl', 'Dizerand', 'Spri', 'Tschau', 'Scheid', 'Zrcher', 'Diwy', '- platz.', 'Gasser', 'Simmen', 'Carrard', 'Worb', 'Jenzer', 'Boskard', 'Marktgaste', 'Allen mann Kramgaße', 'Muralt', 'Horn', 'Dppen', 'Holligen-Drittel', 'Mevli', 'Schlibaum', 'Schulgae', 'Zumbrunnen', 'Gerechngkeitgaße', 'Denereaz', 'Rellstab', 'GaletteS', 'Stalde', 'Ost', 'Fiend', 'Liechti', 'Junkcrngaße', 'Landolt', 'Neucnschw', 'Riklaus', 'Siegmund', 'Linde Ost', 'Zritglockenthurm', 'Graffenried', 'vonWattenwyl', 'Hug', 'Oppliger', 'Rosselet', 'Kefichga', 'Tieffenbach', 'Zwiebelnglein', 'Leutziger', 'Schlupp', 'Stuber Brunngasse', 'Schauplatzgar', 'Hen', 'Rohrer', 'Zeender', 'Pochon', 'Hemmann', 'Krauchthal', 'Retschi', 'Christian', 'Brunngaffe', 'Kisling', 'Giesa', 'Kelergasse', 'Aornhausplatz', 'Frank', 'Bloch', 'Schr', 'Biziau', 'Sradtbach', 'Jnselgaße', 'Zeitglockenthurm', 'Volj', 'Jordan', 'Dick', 'Iunkerngae', 'Ebenisten', 'Fisch', 'Aarziehle', 'Aarberggaße', 'Ochsenbein', 'Ganguillet', 'Spttalgaße', '^', 'Herich', 'Keßlergasse', 'Aegerden', 'Schauplatzgaße', 'Michael', 'Meyer', 'Ditmar', 'Gabriel', 'Brückfeld', 'Selterswasser', 'Jnselgae', 'Stuber', 'Dnz', 'Dulick', 'Caspar', 'Heller', 'Spiralgae', 'Zeughausgaße', 'Wlti', 'Wild', 'Blonden', 'Fifian', 'Thoren Waisenhaus', 'Pfäffli Bollwerk', 'SamuN', 'Schwizgbel', 'Reuengae', 'Zumbach', 'Herdi', 'Frick', 'egg', 'Winkel', 'Gotlhelf', 'Emanuel', 'Tuch', 'Zbin', 'Kornhauplatz', 'Die', 'Gottlieb', 'Waisenhausplatz', 'Tapete', 'Daniel Marktgae', 'Kramzae', 'Gott', 'Leist', 'Holzmann', 'Menberg', 'Marktgaße', 'Lutz', 'platzgaße', 'Fachinger', 'Waisenhausplatz Zeughaus', 'Spitalgaße', 'Widm', 'Burgdorfer', 'Ulrich', 'Daniel', 'Asper', 'Walthard', 'Fetscherin', 'Steiner', 'Beuoit', 'Eerechtigkeitgae', 'Frey', 'Brunngasse', 'Jungfer', 'Aarberggasse', 'Reuengaße', 'Zürcher', 'Andreas', 'Luginbhl', 'Schulgäßlein', 'Heba', 'AlthauS', 'Giudice', 'Freudenberger', 'Nohrer', 'Fayence', 'Aeb', 'Steinauer', 'Leuch', 'Roder', 'Gfeller', 'Neuenschwandek', 'Studer', 'Postgasse', 'Guter', 'Metzgerngae', 'Postgaße Jth', 'Berger Kramgaße', 'Aarberg', 'Rindlispacher', 'BloeSt', 'Wagner', 'Bieri', 'Ars', 'Postgae', 'Brckfeld', 'Dietrich', 'Schlegel', 'Bendichr', 'Wein', 'Attenbxrg', 'Lutstorf', 'Gottlicb', 'Isenschmid', 'Skalden', 'Abraham', 'Bomsel', 'Spitglgae', 'Sterchi', 'Genton', 'Gerxchtigkeitgae', 'Knig', 'Hi', 'Burk', 'Dpau', 'RHeiner', 'Cmauuel', 'Bhlen', 'Kefichgäßlein', 'Rummel', 'Metzgerngaffe', 'NiehanS Frau Kramgaße', '-', 'Groß Metzger Marti Gottlieb Kramgaffe', 'Münger', 'Spi', 'Drig', 'platzgae', 'Dallemagne', 'Robert', 'Adelmann', 'Aarberggaße Liithi', 'Leuchli', 'Linde', 'Koch', 'Poftgae', 'Holz', 'Schwob', 'Wassern', 'Zeughausgae', 'Kefichglein', 'Girodon', 'Aebi', 'Tri botet', 'Reidenbach', 'Blau', 'NägeliSgäßlein', 'Bhler', 'Blauner', 'Junkerngaße', 'Storchenglein', 'Viktor', 'Bollwerk', 'Gerechtigkeitgae', 'Poftgge', 'Schuwey', 'Lamotte', 'Owald', 'Bendicht', 'LiechtiT', 'Zeughausgasse', 'Zenghausgae', 'Feitknecht', 'Friedrich', 'Klein.Metzger', 'Neuciigaj-e', 'Samuel Spitalgae', 'Haus Christian Metzgerngaße', 'Schneit', 'Keßlergaße', 'Lutftorf', 'Fra', 'Rueff Spitalgaße', 'DurS', 'Kreuzgae', 'Bruyngae', 'Grf', 'WWWM, SLOC', 'Aarberggaffe', 'Sommer', 'Sprngli', 'Steiger', 'Junkerngae', 'Cottonne', 'Wittwe Metzgerngaße', 'Notarien', 'Dünki', 'Brki', 'Gerechtigkeitgasse', 'Neuengaße', 'Fouche Kramgaße', 'Matten Mettler Wittwe Matten Oth', 'Sebastian', 'graben', 'Eig', 'Aebersold', 'Heimel', 'Jmhoof', 'Egg', 'Kerzern', 'Kugel', 'Geilnauer', 'Weibermarkt', 'By', 'Aarziehle-Thor', 'Metzgerngaße', 'Gschwind', 'Schauplatzgae', 'Lasond', 'Lohri', 'Schwein.Metzger', 'Betten Marktgae', 'Jenni', 'Strahm', 'Werner', 'Bo', 'Portraitmaler', 'Schörer', 'Jngold', 'Stauffer', 'Kirch', 'Flkiger', 'Aaron', 'Kcßlergaße', 'Schnauer', 'Surer', 'Willading', '- talgae', 'Kser', 'Liebefeld', 'Mare', 'Adle', 'Lamy', 'Gro', 'Carl', 'Javet', 'Marktgasse', 'Sulgcnbach', 'Schock', 'Rohr', 'Schanplatzgafie', 'Rndolf Marktgasse', 'Bihler', 'Hauptwache', 'Horellaube', 'Oel Puder', 'Cichovien', 'Br', 'MeiSncr', 'Bergen', 'Seide', 'Kenzi', 'Krhenbhl', 'Oltramare', 'Traffelet', 'Rosen', 'Neuhaus', 'David', 'Wy', 'Kramgae', 'Seeger', 'Klaus', 'Kramgasse', 'Germern', 'Krpf', 'Jnbnit', 'Schie', 'Judengaße', 'Walt', 'Kirchgaße', 'Zbinden', 'Lderach', 'Beri', 'Eyen', 'Emmisperger', 'Nro', 'Schohalden', 'Villeneuve', 'Brunngae', 'Lehman', 'ZeughauSgae', 'Merz', 'Schulgaße', 'Spitalgasse', 'Ulrrch', 'Offen', 'Blaser', 'Stachen', 'Thrner', 'Motti', 'Couchoud', 'Bigler', 'Mller Jakob', 'Kurz-Fruting', 'Krebs', 'Rudolf', 'Schauplaygae', 'Schnt', 'Stempfli', 'Dolmar', 'Korbmann Spitalgaße', 'Ammeter', 'Rthlisperger', 'Lemp', 'Iobann', 'Senn', 'DopS', 'Jth', 'Kinkeltn', 'Schmid', 'Eggimann', 'Freudenreich', 'Mozin', 'Melchior', 'Hotellaybe', 'ach', 'Zcugbausplatz', 'Jnselgaße Spital', 'Verlag', 'Lthi', 'Peter', 'Fehlbaum', 'Zumstein', 'Albrecht', 'Nieder', 'Langga-Drittel', 'Spitalgae', 'Zwiebelnglem', 'Bonner', 'Rieh', 'Hofer', 'Metzgerngasse', 'Strmpfen', 'Rohaar', 'Speichern', 'Dellen', 'Lttginbhl', 'Masfecker', 'Schlachthaus', 'Langgae', 'Kpfer', 'Schreinermeisiek', 'Weibel', 'Hartmann', 'Schonauer', '/', 'Stegmann', 'Bruischi', 'JohannJakobLienhardt', 'Schlsli', 'Heinrich', 'Waisenhaus', 'Kclergae', 'Grau', 'Carl Metzgerngasse', 'Kiener', 'Zeughaus', 'Meley', 'Veyre', 'Moses', 'Neumhle', 'Gautschi', 'Wisard', 'Christinaz', 'Kclergasse', 'Gerechtigkeitgaße', 'Zucker', 'Wabern', 'Bru-nngae', 'Neuciigaje', 'Allenmann', 'Haberkernen', 'Kirchhflein', 'Jakob', 'Trechsel', 'Stoo', 'Durisch', '- gae', 'Wernli', 'Jsenschmid', 'Chautems', 'Hellen', 'Krieg', 'Mareoni', 'Ri', 'Vergolder', 'Jnnkerngae', 'Grrechtigkeitgae', 'Brunngasse Roder Franz Kramgasse', 'Blankenhorn', 'Kopp', 'Dnki', 'Schwitz', 'Horn Metzgerngaße', 'Marktgae', 'Aarberggae', 'Gaudin', 'Breitfeld', 'Langhaus', 'Cachar', 'Sonderegger', 'Wt', 'Jttselgae', 'PascaliN', 'Morgenthaler', 'Bollin', 'Ernst', 'obern', 'Neuenschwander', 'NiehanS'}",603
1397203,830914,"{'Kirebgasse', 'Neuengasse', 'Junkern', 'Oldenburg', 'Klein', 'Twann', 'Ebnetberg', 'Wyl', 'Weiermannshaus', 'Saignelegier', 'Nydau', 'Oder', 'Choisy', 'Burgistcin', 'Habkerenthal', 'Gurnigelbad', 'Mctzgergaffe', 'Pruntrut', 'Markt', 'Oberdorf', 'Speichcrgasse', 'Oeschinensec', 'Gerbernlaube', 'Lauterburg', 'Reitschule', 'Koppigen', 'Aarbcrg', 'Niklaus', 'Rothhorn', 'Engelberg', 'Zunkerng', 'Kornmarkt', 'Messina', 'Schwarzenburg', 'Marktg', 'Ncgot', 'DelSbergerthal', 'Thalheim', 'Stal', 'Frankreichs', 'Kirchberg', 'Schifflaube', 'RougemontS', 'Kehrsatz', 'Brunnaderndrittel', 'Petersinsel', 'Urtcnen', 'Pole', 'Bclpberg', 'Tramlingcn', 'Boujeau', 'Reuengasse', 'Fr', 'Huttwyl', 'Kirchlhurm', 'Diemti', 'Italien', 'Sahli', 'Herzogenbuchsee', 'Lofwyl', 'Bramberg', 'Radelfingen', 'Schauplatzgaffe', 'Bellefontaine', 'Eriswyl', 'Biet', 'Bubenberg', '8unkerng', 'Erlach', 'Gcistkirche', 'Ferenbalm', 'Englisberg', 'Schmalz', 'Jnselg', 'Steinbruch', 'Weiler', 'Grimscl', 'Beruh', 'Sebwarzenhorn', 'Neuenstadt', 'Brunngassc', 'Altenbergdritrel', 'SumiSwald', 'Utzenftorf', 'Roggwyl', 'Burg', 'Junkcrngasse', 'Gchauplatzgasse', 'GuggiSberg', 'Untcrseen', 'Burghorn', 'Wiflisburg', 'Hutwyl', 'FricniSberg', 'Ludw', 'Vellevue', 'Thierachern', 'Konolfingen', 'Neucnburg', 'Adclboden', 'Grafenried', 'Saig', 'Wichtrach', 'Sam', 'Kouolfingen', 'Oranienburg', 'Zeughauseck', 'Saiguelegier', 'Eichholz', 'Allmend', 'Salzmagazin', 'Aarbergcrg', 'Oberland', 'Pintenwirth', 'Chirelbach', 'Murtcn', 'GerechtigkeitSgasse', 'Kaufhaus', 'Ueber', 'Interlacken', 'Schanplatzgasse', 'SignaU', 'Laubstock', 'Kanderthal', 'Reichenbach', 'StettleN', 'Unterbrod', 'Ncuen', 'Ludeng', 'Schlieren', 'Zntcrlackcn', 'Uri', 'Kirchgasse', 'Neucngasse', 'Licbefeld', 'Biglen', 'Scheunenberg', 'Schmadribach', 'Worb', 'Oberbipp', 'Albr', 'Messen', 'Loh', 'Lousssn', 'Dornach', 'Lorraine', 'BubenbergS', 'Tavel', 'Muralt', 'Gabr', 'Beril', 'Lenzburg', 'Gcrberen', 'Badlaube', 'ThunersecS', 'Wyler', 'Thunersees', 'Montbijou', 'Europas', 'Luzerit', 'Rud', 'Gcrbernlaube', 'Zcughausgasse', 'Spiez', 'Judeng', 'ThurgaU', 'Gaulibach', 'Ny', 'Holligendrittcl', 'Jura', 'Grindelwald', 'Thunstetten', 'Simmenthals', 'Liebegg', 'Obersimmenthal', 'Meienried', 'Hug', 'WimmiS', 'Windisch', 'Steinibach', 'PranqtnS', 'Jfsiger', 'Dicsbach', 'Beaulieux', 'Cambridge', 'Metzgerg', 'Jnselgaffe', 'Einw', 'Belpberges', 'Simmensiurz', 'Delsperg', 'Lcibsberg', 'Eichberg', 'Woog', 'Thuncrsee', 'Kramgaffe', 'Bubenbergs', 'Enggistein', 'Aargav', 'Neirjcau', 'Belpbergs', 'Krauchthal', 'Altenberg', 'Gerberntaube', 'Jnnkcrn', 'Brunngaffe', 'Gcrzensee', 'HaSle', 'Laucnenalp', 'Feldegg', 'Judengasse', 'Niederbipp', 'Jcnghansgasse', 'Blatt', 'Untervillier', 'Gerbern', 'Frankfurt', 'Wiesenthal', 'Courtclary', 'Aarburg', 'Limbachbad', 'Bern Marktgasse', 'Ins', 'Brunnengasse', 'Lungern', 'Pontarlier', 'Stalden', 'Europa', 'Muri', 'Meiringen', 'Staubbach', 'Gerzensee', 'Belpberggipfel', 'Gent', 'St', 'Murgenthal', 'Utzenstorf', 'Murtei', 'Sigriswyl', 'Lyon', 'Jsaak', 'Gerzcnsee', 'WyningeN', 'Rothhaus', 'Obersimmensturz', 'Metzgergaffe', 'Falkcnplatzli', 'Sardinien', 'LauperSwyl', 'Salzmagazingaffe', 'Aarbergcrgaffe', 'Lausanne', 'Hofstetten', 'Geltersingen', 'Ursenbach', 'Stockhorn', 'Liebeck', 'Roggenbourg', 'Schangnau', 'Grimsel', 'Fcllenbergs', 'Ringgenberg', 'Wengercnalp', 'Trachselwald', 'Fraubrunnen', 'Wtttigkofen', 'Nosenbcrg', 'Ler', 'Paris', 'Baden', 'Habkercn', 'Tittingen', 'vonNieder', 'Thorberg', 'Sepraip', 'Moos', 'Kirchfeldes', 'Judengaffe', 'Zimmerwald', 'Byfang', 'Kirchplatz', 'Saanen', 'Romang', 'fwyl', 'Jntcrlacken', 'Aargau', 'GlaruS', 'Tracksclwald', 'Gadmenthal', 'Ges', 'Spiej', 'Junkerngasse', 'Seeland', 'Tschamari', 'Nikl', 'BernS', 'Holzmarkt', 'Hasle', 'Junkcrngaffe', 'Signau', 'Frienisberg', 'Cbr', 'Gerol', 'Neuenegg', 'Gercchtigkeitsgasse', 'Jmhof', 'Lasle', 'Speichergasse', 'Andimourt', 'Savoyen', 'Schwarzwald', 'Thuner', 'Weissenheim', 'Pintcnwirth', 'Brunngasse', 'Altenbergstrasie', 'Java', 'Burgdorf', 'Bcllelay', 'Jnterlacken', 'Salzinagazin', 'Englis', 'Schwaribach', 'Juukerngasse', 'NydaU', 'Marignano', 'Frankreich', 'Alpenthal', 'Jffigenthal', 'London', 'Lelvetik', 'Grindel', 'Grubcnwald', 'Nancy', 'Neucn', 'Reuti', 'Bremgarten', 'Berit', 'Courroup', 'FellenbergS', 'Lerzogenbuchsce', 'Kaufdorf', 'Schwarzen', 'Alpen', 'Enggisteinbad', 'Ritzlihorn', 'Rohrmoos', 'Duggingen', 'Kehl', 'Cappclen', 'Aarbergcr', 'Lad', 'Neuenburgersee', 'Brandts', 'Postgasse', 'Rcichenbach', 'Bassecourt', 'Gadmcnthal', 'Elfenau', 'Secdorfsee', 'Marktgassc', 'NeuhauS', 'Chatillonet', 'Bremgartenwald', 'Belp', 'Aarberg', 'Neucngaffe', 'Hirschgraben', 'Langenthal', 'Lengnau', 'Wildegg', 'Courrendlin', 'Courgemont', 'Spitzlaube', 'Brienz', 'Oesterreich', 'Weissenstein', 'Weyermannshaus', 'Guttanncn', 'Jnterlaken', 'Bleienbach', 'Justithal', 'Unterwalden', 'Thunersee', 'Dalmatien', 'Ulr', 'Scheidegg', 'Jos', 'Lauenen', 'Joh', 'Zudengasse', 'Skalden', 'Tavannes', 'Aaraa', 'Kram', 'Spis', 'Oberstmmenthal', 'Oberwyl', 'Bonstetten', 'Metz', 'Riedburg', 'Brienzersee', 'Lauter', 'Geiser', 'Bubenbcrg', 'Tschingel', 'Leidenstadt', 'Lenk', 'PeterSinsel', 'Faulhorn', 'FrieniSberg', 'Judcngasse', 'Hotellaube', 'Murten', 'Blumenstein', 'Bclrichard', 'Juragebirge', 'Douann', 'Bleiche', 'Freiburg', 'Fahr', 'Abr', 'Hindelbank', 'Donau', 'Falkenegg', 'OberbaSli', 'Aarbergassc', 'Jagdburg', 'Rcnnendorf', 'Zoll', 'Lauterbrunnenthal', 'Rotweil', 'Blumcnstcin', 'Metzgcrgasse', 'Jak', 'Schulgasse', 'ZeughauSg', 'Lothringen', 'Suleckalp', 'Seeberg', 'Diesbach', 'Burgdokf', 'Oldenbach', 'AargauS', 'Aarbergergaffe', 'Irland', 'Em', 'Negot', 'Hilterfingen', 'Bendicht', 'Schweiz', 'Bielcrsee', 'Zeughausgasse', 'Wyttcnbach', 'Ober', 'Erlenbach', 'Schlapbach', 'Barenwart', 'EriSwyl', 'DelSberg', 'Gletscherhorn', 'Schaff', 'Laupen', 'Lauensee', 'Wankdorf', 'Kreuzgasse', 'Oberhasli', 'Wyttenbach', 'Delsberg', 'Castel', 'Lauterbrunnen', 'Maykirch', 'Buchsee', 'Wylhof', 'Schauenburg', 'Pontenat', 'Moritz', 'Junkerngaffe', 'Zscltwald', 'Schwarzenegg', 'Thoren', 'Reitweg', 'Grimselhospitz', 'Schreiber', 'BriSlach', 'Znmbacb', 'Viercrhauschen', 'Geedorf', 'Wiedlisbach', 'Rheinwald', 'Zoh', 'Jmhoof', 'Konolstngen', 'Alpengebirge', 'Vauffelin', 'Libanons', 'Pruntrm', 'Sizilien', 'Pavia', 'Weibermarkt', 'Luzern', 'Metzgergasse', 'Aarbcrgergasse', 'Sumiswald', 'Melchnau', 'Bohnenmoos', 'Eymatt', 'Hofwyl', 'Kienthal', 'Aolligendrittel', 'Stalden Sonnseite', 'Neuengassc8', 'Oldenhorn', 'Mettenberg', 'Oberried', 'Spitalacker', 'Grimmenstein', 'Genf', 'Metzger', 'Bargen', 'Schwyz', 'Wcndelsee', 'Kirchlindach', 'Jngold', 'Kirch', 'Blumenstcin', 'Goldbach', 'Oxford', 'Lotellaube', 'Melchna', 'Bregenz', 'Lolligendrittel', 'Rohrbach', 'Zeughausplatz', 'Belpberg', 'Ladcnwand', 'Ncucngasse', 'Nizza', 'Kiesen', 'Kornhausplatz', 'Bclp', 'Uhli', 'Spitalg', 'Bachalp', 'Steck', 'RiggiSberg', 'SimmenthaleS', 'Marktgasse', 'Waadtland', 'Berns', 'Aar', 'Oberbalm', 'Jnselgasse', 'Aarbergerg', 'Niesen', 'Navarra', 'Amsoldingen', 'Staldcn', 'Grauholz', 'Wylerfeldes', 'ZeughauSgasse', 'Bergen', 'Burgistein', 'Grindelberg', 'Spihlaube', 'Urbachthal', 'Basel', 'Neuhaus', 'Arni', 'Brunng', 'Courtelary', 'Bernzoll', 'Affoltern', 'Kramgasse', 'Aarau', 'Simmenthal', 'Dcltheim', 'Stadtbach', 'Ellenberg', 'Holligenfabrike', 'Castell', 'Buren', 'Oberburg', 'Monrcpos', 'SolothurN', 'Bricnzersee', 'Licchti', 'Burggasse', 'Gsteig', 'LaupeN', 'Jmmerthal', 'Wylerfeld', 'Orleans', 'Brugg', 'Herreng', 'Beru', 'BlumensteiN', 'Weinnegot', 'Jolimont', 'Casinoplatz', 'Amerika', 'Sauley', 'Brunnhaus', 'Courtlary', 'Badwirth', 'Emmenthal', 'Heimenhausen', 'GutmannShauS', 'Delemont', 'Christ', 'S', 'Spitalgasse', 'Wattenwyl', 'Mejrgergassc', 'Postgassc', 'Langnau', 'Altcnbergdrittel', 'Neichenbach', 'Elba', 'Sulgenbach', 'Ursanne', 'Aarbcrgerg', 'Roscnlauibach', 'Kienbach', 'Neapel', 'Clavaleyres', 'Landshut', 'Lotzwyl', 'Word', 'Ciburrg', 'Landbach', 'Frutigen', 'Eggiwyl', 'Brunnqaffe', 'Holligendrittel', 'Nie', 'Ricdburg', 'Neueneck', 'Herrengasse', 'Nordamerika', 'Speicherg', 'Junkerngassc', 'Fraubrunncn', 'Christoffelthurm', 'Moutier', 'Baumgarten', 'Meningen', 'Waadt', 'Gerechtigkeitsgasse', 'GerechtigkeitSgaffe', 'Steffisburg', 'Krone', 'Brunnengassc', 'Neuenburg', 'Rom', 'Loch', 'Rnmmlingen', 'Schaffhausen', 'Noirmont', 'Kandersteg', 'Scheideck', 'Jegistorf', 'Lauperswyl', 'BurgisteiN', 'Schauplatzgasse', 'Clavaleyers', 'Nidaii', 'Frienis berg', 'Carlsruhe', 'Abrah', 'Leimberg', 'Heidenstadt', 'Lerzogen', 'SavovenS', 'Chin', 'Rcufincr', 'Aarziclctbor', 'Gottstadt', 'Grandson', 'Saignelcgier', 'Kramg', 'Bern', 'Aeschi', 'Gstad', 'Wangen', 'Beatenberg', 'England', 'Pfarrdorf', 'GumoenS', 'Rawyl', 'Haslegut', 'Blumensteinbad', 'Wengernalp', 'Schauplatzgassc', 'Neugasse', 'Bend', 'Aarbergergasse', 'Fluh', 'Sieuengasse', 'Chasseral', 'Rain', 'Unterseen', 'Bad', 'Adelboden', 'BerN', 'Zcughausplatz', 'Aarbcraergasse', 'Guggisberg', 'Seliauplahgassc', 'Holligcndrittel', 'Jtingenau', 'Solothurn', 'Aarbergcrgasse', 'Aargan', 'Birs', 'Bielersee', 'Habkeren', 'Rabenthal', 'Walther', 'Mererhaus', 'Bcnd', 'Guttenberg', 'AarbergertboreS', 'Scbwarzcnburg', 'Ried', 'Kirchen', 'Ncuengasse', 'Kanton', 'Appenzell', 'Uettingen', 'Junkerng', 'Wabern', 'Rosenberg', 'Wyningcn', 'Nidau', 'Lauffcnthal', 'Saxelen', 'Magerbad', 'FaulhorN', 'TavanneS', 'Hcrrengasse', 'Jakob', 'Knuchel', 'Kramgaffc', 'Streichenberg', 'Riedcrsimmenthal', 'ErguelS', 'Jagberg', 'Aarwangen', 'Willtsau', 'Piemont', 'GumoenSmatte', 'Altenbergdrittel', 'Jsenschmid', 'Nydeck', 'Rupvlds', 'Sonceboz', 'Mctzgergasse', 'Gottl', 'Tellenberg', 'Zeughausg', 'Bnrgdorf', 'Hnselgasse', 'Thun', 'Heimberg', 'Lcnkthal', 'Altenbcrgdrirtel', 'Wengi', 'Emmcnthal', 'Sansouci', 'Ravyl', 'Deutschland', 'Hasli', 'Brcitenrain', 'Wytten', 'Wildmann', 'Zunkerngassc', 'Cbamouny', 'Morgctenbach', 'Steinhaus', 'WalliS', 'Alb', 'Laupcn', 'Graubolz', 'Neiebcnbach', 'Landvlt', 'Bubenbergsrain', 'SigriS', 'Meyringen', 'Schaffisheim', 'Kasp', 'Wimmis', 'HandelSm', 'Rubigen', 'Ueten', 'Stadrbach', 'Wallis', 'Gipfel', 'Ostindien', 'Murtenthor'}",800,"{'Beim Hasenbrunnen Gipfel', '87t', 'Bannwärt', 'Madiswyl', 'Strumpfweber', 'Bern St St Ursannc', 'Röthenbach', 'Thuncrsccs', 'Adler Langnav', 'Zngold', 'Kniebrechen', 'Dürrenroth', 'Seftigcn', 'Xaver', 'Bure Langenthal', 'Doldenhor', 'Wallisergrenze', 'Stubenschreiber', 'Belpberg Kirchdorf', 'tcnbode', 'BielcrseeS', 'Btz dem Ober', 'Chaluat', 'Guigucr', 'Nydeckkirchc', 'Müllcrlaube', 'Hauenstein', 'Mailand Italien', 'Lünerthal', 'Dicßbach', 'Oberstlieutenant', 'BrüggfeldwirthShaus', 'Tillicr', 'Oberaintmann', 'CluS', 'Nr Käser Krämer Kramg', 'Alpenkette', 'Bern Parrat', 'Eidgenöff Kreuz', 'AltrathShcrr', 'Pcterlingen', 'Pfisternwirth', 'Boücourt', 'Hak', 'Signau Simme', 'Hilterfinge', 'Brienzer', 'Thann', 'Poschenried St Sennhütte RusiSwald', 'Traufhöhle', 'Pulvermagazin Staldcn', 'Bähler Bend', 'Regicrungsstatthalter', 'Emmen', 'Luttwyl Su', 'Folterthurm', 'Kaminfeger', 'Gerechtigkeitsg', 'St Lenk St Rennfluh Fluh Untere Stierlügcr Obere Gticrlüger Ravylsee Höhe', 'Moussclinehändler', 'Kcßlerg', 'Schvßhaldendrittel', 'Zweilütschinen', 'Nr Rohr Anna des Sigrists', 'Niederhauscr', 'St Courrcndelin', 'Obcrlande', 'Bay', 'Kirchplatz Stift', 'Sand', 'Austin', 'Hindclbank', 'Ludw Gabr', 'Hoüigendrittel', 'AmtSnotaw', 'Das Belvedere', 'Holzmatt', 'Kappenmachcr', 'Saanen Thun', 'JnselspitalS', 'Kanton Waadt Gumoens', 'Bürcn', 'Rathhauöplatz', 'Chr', 'Lotteriebureaux', 'Trüschen', 'Untcrstatthalter', 'Abr Balth', 'Grimsclspital St Aerlen', 'Opcrators', 'Keßlerg', 'Schuhmachermstr', 'ObcrgerichtSkanzlci', 'Laupen Romang', 'SFuß', 'Regenschirmfabrikant', 'Spenglermstr', 'Viques', 'Frick Spitzlaube Jnselein', 'Bujatrik', 'Stoekmar Laver Negiernngsrath', 'Susienhor', 'Hauptstraße', 'Negot Woüenwaaren GerechtigkcitSgaffe', 'Jnnerschwand Adelboden St Ganzen St Reitweg', 'Profeff', 'bach', 'Wildenmannwirth', 'Friede', 'Aarzielidrittcl', 'Schlossermstr', 'Grellingcn', 'Spring', 'Standesbuchhalter', 'Linden', 'Wohlthat', 'Tbal', 'Jnterlacken Pfd', 'Gaicht', 'Bantigen', 'Brühli', 'Untcraufseher Museum', 'Glockenthürm', 'St Eggenschwand', 'Stadtbuchhalter', 'Vilctte', 'BelleFoniaine', 'Donnerbühl', 'Glaser', 'BrodicreriN', 'Eyen Gotklicb', 'Joh Frdr', 'Schultheiß', 'Gasterenthal', 'Fricdhof', 'stlberne', 'Ganguillet', 'Schaafe', 'Schuhmaehermstr', 'Thal Geren', 'Schärer Bern', 'Engegüter', 'Fkgr Orth Franz Speziercr Gcrcchtigkeitsgasse', 'St BraiS', 'Bern Aeschlimann', 'Wahlalp', 'Brünigen', 'Lehnkutscher', 'Dachsfel', 'Kirchenselektgesang', 'Walkringen Rnfener Christ', '0ooFr', 'Nißlcr', 'Herrenqasse', 'Lausanne Neucng', 'Adlensried', 'Parel', 'Schaüplahg', 'Leuenbergcr', 'Der Belpberg', 'Buchbinder', 'Breuleux', 'St Oberjaun Ablentschen', 'Zäziwyl Konolsingen', 'AmrSstädtchen', 'Atuniei', 'Saanenlande', 'Wirthshaus', 'UnterWankdorf', 'Münsters', 'Seengen', 'Handeck', 'Stoos Hebamme Metzgerngassc', 'Dorf', 'Römer', 'Grenzbureav', 'Lchnkutscher', 'Tschien', 'Wattemvyl', 'D', 'Glovclier', 'RathhauS', 'Emme', 'Theobald', 'St von Bern', 'NydcckHöflein', 'Mühlenlaube', 'Grandson JennerMüller', 'Piemont Savoyen Deutschland', 'Hehlen', 'Aalbock', 'Herrenschwand Christ', 'Mehgerg', 'Zeughausgaffe Schlüssel', 'ZeugbausgS', 'Balstger', 'Gcrberlaube', 'St Michelsthörli', 'St Johannis', 'LeimiSwyl', 'Manche', 'Lütsche', '1oroorie', 'Bantiger Bantiger', 'Lenk St Senenfluh', 'Grindelwaldgletschcr', 'St Tosten St Rüm', 'Grimselhöhc', 'Centralpolizeidirek', 'Eisenhündler', 'Aarburg Mailand', 'Hübeli Schönegg', 'St Viel St Evilard', 'Sennhütte Finsterwald', 'Neuenstadt Büren Paris', 'Selüffslaubc', 'Stadtschreiber', 'SoihisreS', 'Seinr', 'Breithorn', 'MontSseve', 'Hauseigenthümer', 'KäShändlcr', 'Wyß', 'Joux', 'Oberamtmann', 'Blösch Bend', 'Thun Bern', 'Sam Frdr', 'Frutigcn', 'St Bad Blumensteiii', 'Müllermstr Aarzieledrittel', 'Bärschcnhaus', 'Ermcl', 'Falkenplätzli', 'Oberrichter R', 'St Furka', 'Saanen St Voltigen', 'Schrcinermstr', 'Thun DelSberg', 'Weißenheim', 'Adelbodenthals', 'Ouchy Joh Markt', 'Thierarzncischule', 'Knabenwai', 'Schwalmeren', 'Münger', 'Jammerthal', 'BürcN', 'GuivernoiS', 'Gurtengebirgs', 'Dav Rud', 'Därstetten', 'gr Straße', 'Graben kncz', 'Messcrli', 'DeleyreS', 'Frz Zkaver Schneidermstr', 'Stadtbauamtkasster', 'Künkcl', 'Finster', 'Wäali', 'Riedstatt St Kalkstätten', 'Bergdorfe', 'Gerechtigkeitsa', 'Burgcrrath', 'Alpcnkette', 'Barbcn Alet', 'Kamon Bern', 'Kurzernei', 'Weyern', 'Friedrich', 'Wildcrswyl', 'Biland', 'Münchenbuchsee', 'Oberbottigen', 'Weißcnburg', 'linkS', 'Ncgotiantinnen', 'Obergerichtschreibcr', 'PeterSburg', 'Leinr', 'AmtSverwescr', 'Burgerspital Hasenfrah', 'Pruntrut Straße St Tavannes Dachsfclden St Fünt Belay Zoux Sauley Gloveilliers St Boncourt Asuel', 'Wasen Trüßcl Sam', 'St Thun St Gwatt', 'Rütte', 'Waagmacher', 'Bern Kramgasse', 'Bielersee NeuhauS', 'Spitalpromenade', 'Lauterbrunnen Geich', 'Dünki', 'Lohn', 'Berghauptm', 'Montillion Sulgeneck', 'Trödler Brunng', 'Weiler Hochburg', 'Schönfärber', 'Kirchenthum', 'Handelsstraße', 'Steinhölzli Wirthshaus', 'Sennbütte', 'Ankenlaubc', 'Bergsirom', 'Kunsistraße', 'Uhrenmachcr', 'Ankenhalle', 'Höh Friedr', 'GuirodoN', 'Länggaß', 'Lolligendrittcl', 'Helisbühl', 'Wirthe', 'Kassa', 'Hauptm', 'Jnterlacken Gebirgsstock', 'helvetischen Republik', 'Albr Sam', 'Zäziwyl', 'Thalgut Gießbach', 'Klavperläubli', 'Tschingelgletschcrs Steinberg Schmadribach', 'selgasse', 'HandelSmnn', 'Sennhütte Boden', 'Wasen Rechen', 'Bern St', 'SchullchrerWittwen', 'Les BoiS', 'Charmoille XXII Frieden', 'Eigenöff Kreuz', 'Flor', 'Limonadcfabrikant', 'St Habkercn', 'Jnterlacherhof', 'MädchenSchulhanscs', 'Louis', 'Herrenschwand', 'Seilermstr', 'Lombach der Harder', 'Fclshörner', 'Rathhaus Sevt', 'Strahlhorn Hier', 'Jffibach', 'St St Spietz', 'Untersten St', 'Korbmann', 'Str St Solothur Stadt St Oberdorf', 'Bütschelcck', 'RathShcrrn', 'Oberst', 'Büchsenschmied', 'Franziskanerkirche', 'Tempcrli', 'Znsclgäffe', 'W', 'Sisclen', 'Bricnzling Sulute', 'Jcnni', 'Zeitglockenthurm Zwiebelngäßlein', 'St St St', 'Gysenftein', 'Pruntrut Basel', 'Obstbera', 'ESq', 'Landstuhl', 'Preußen', 'Jungfrau Nickt', 'Brunncngassc Nr Werk', 'Gurtest', 'Amsoldingen Tschaywo', 'Saignclegier Liegt', 'Das Rathhaus', 'Ruinen Bubenberg', 'Zweisimmcn', 'Buchbindermstr', 'GerechtigkeitSg', 'Hebammcnschule', 'Aarbergerstraße', 'Speziercrin', 'St Oder', 'Küher', 'Münchw', 'Mstggüßlein', 'Blauhaus', 'Oelmühle', 'Comp', 'Vorrathskam', 'soldingcn Poleren Sennhütte', 'Murrenerthor', 'Oberhofen', 'St Saanen', 'Thal Ruinen', 'Meier', 'Sumiswald Langnau', 'Marktgasse Nr Wurstemberger', 'Oberstin', 'HugS', 'DasSchloß', 'Kolligendrittel', 'Zollbrück', 'Schwclldamm', 'Lehenbesteher', 'Saanenland Saignelegier', 'Jndermüble', 'Rud Jak', 'Büren Saignelegier', 'Kaufhause', 'I4e Zeitglockenthurm', 'Baltesperger', 'Obergrindelwaldgletschcr', 'Freiburg Neuenburg', 'Dietiker', 'imZehen', 'Brunnengrcib', 'Schtff', 'Pruntrut Sai', 'Sennhütte Wintereck Murren Gümmclwald Reuti St Schmadribach', 'Äiel Saignclegier', 'Brandcasscnverstchcrung', 'Joh Jak', 'Oberhasli Reich', 'Rebeuvelier', 'Grünes Quartier', 'Schneidermeister Salzmagazin', 'Kirchthum', 'Ant', 'GumocnS', 'Das Casino', 'Grünenbcrg', 'Neuengaß', 'Hotellaude', 'Zwiebelngäßl', 'Vermeille Ank', 'Feuersbrunst große', 'BourgeoiS', 'Saanenland', 'ThurmeS', 'Völlige St Habstetten', 'GurnigelS', 'Stettle', 'Flachmalcr', 'Montcbcllo', 'Burgdorf Grimsel', 'Spitalkirche', 'Schloßtrümmcr', 'Kcßlergasse', 'St Gurnigelbad St Kehl', 'Drechslermstr', 'GerechtigkcitSg', 'Judeng Nr Mitten', 'Doubs', 'Schneidermfir', 'Bauchcr', 'Hirschgrabcns', 'Engcpromenade', 'Pruntrur', 'Oberstlicut', 'wallis Suleck', 'Pfeffingen', 'Langenthal II', 'Dittinge', 'Saignelegicr', 'Käfiggäßlein', 'Baumwollzeugen', 'JlfiS', 'St Sonccboz', 'Länggaffe', 'Badwirthschaft', 'Weinncgot', 'Nöthinger', 'Diese Vcrsorgnngs', 'Neü', 'Tavanncs', 'czr GerechtigkeitSgasse', 'Bencdikt', 'Tannenbühl', 'Unteres Kehrhciuschen', 'Literarschule', 'Weinzäpfli', 'PoitterliN', 'Kathar', 'Allmend Wnrgler Ulr', 'franz Nidau', 'BrunnerGerlach', 'Landwirth', '3ns', 'Schlüsselwirth', 'Bethause', 'Leichcnhanseru', 'Schoßhaldendrittcl', 'Jmmcnhubel', 'Altenbergdrrttel', 'Adrcffcnluch', 'Geör', 'Lütschine', 'KönigSfelden', 'Schreckhörner', 'Aarwanqcn', 'St Hindclbank St Mötschwyl', 'Storchcnwirth', 'Barbier', 'Kostgeberiii', 'Weinbandlung', 'Murzelen', 'Münchenwyler', 'NiehanS', 'Mctzg', 'Grandval', 'Gottl David', 'Bümplitz', 'Güntlisberger', 'Konr', 'Pont', 'Zürchersees', 'Allenlüftcn', 'Gurowski', 'Untcrschlcifen', 'Lager', 'MontierungSvorräthe', 'St Hin', 'Kander', 'Vurgerrathes', 'Meinrad', 'Jnterlachen', 'Sleubrück', 'BetthLudlcrittncn', 'Thunerstraße', 'Todtenackcrs', 'Ekelsrücken', 'Amtsverwcser', 'Könitz', 'Mari Wittwe', 'St Sonceboz', 'Burgdorf der Emme', 'Postgaffc', 'DelSberger Thal', 'Joh Sam', 'Altenbcrgbrücke', 'Modisten', 'Goldschmied', 'UndervillierS', 'Bern Vermeille', 'Acbcrhard', 'AarflusseS', 'Domaineninspcktor Bern', 'Speziereriii', 'SumiSwald Nieder', 'Mittaaliorn', 'Werrv', 'Gloggenthal', 'Brandeorps', 'UnderSwyl', 'Rothes Quartier', 'Klösterli', 'Aarzicledrittel', 'Lchnkutschcr', 'St St Courtclary', 'senay', 'Straße St Bethlehem', 'Chri', 'Rath Jun kerngasse', 'Hochgebirge', 'Löchligut', 'Großen Rathes', 'Metzgermsir', 'St Krai', 'Marktgasse Nr B6rard Dav Louis Hutmarchand', 'GercchtigkcitSg', 'St Brodhäuschcn St WimmiS', 'Lustenberg', 'TodtengärteN', 'Aargaii', 'Ackermann Ank', 'Montier Flecken', 'Lehenmann', 'HortiN', 'Kruoüstsin', 'Riggisberg St Hintcrgiebelcck', 'Junkerng Nr Tscharner', 'Neuhaus Bla', 'St Könitz', 'Meningen St St', 'Scheid', 'Rörswyl', 'Gartenwärterin', 'Kißling', 'Glovelier St', 'Eisenhandelsmann', 'St Ein', 'Küblisbad St Fahrweg', 'Regierungsratb', 'St Fahrweg', 'Bätlerkinden', 'Klaviermachcr', 'französ', 'Pruntrut Marti', 'Grünenberg', 'Ludw Gottl', 'Sattler', 'Miocourt', 'HolligcndrittelsChoisi', 'Hrn Ostcrrieth', 'Zollikofcn DicmerSwyl', 'St Holzach St Adelboden St Reitweg', 'Wasen Köhler', 'KönigSfclden', 'Käfiggäßl', 'Obcrschaffn', 'Loh Em', 'Käs', 'Pintenwirkh', 'Wochenmarktbuden', 'Graffenried', 'Badanstalt', 'Bärenfels', 'Gäst', 'Schloß Wyl', 'Zähringen', 'Tromwyl', 'Obergerichtsweibel', 'St St Bachsee', 'Schreinermstr', 'Aarzieledrittel', 'Bubenseeli', 'Schaalgäßlein', 'Tuchschercr', 'Frau Lands', 'Walterswyl', 'Erlacherhof', 'Haus Haus', 'tzi', 'Neqot', 'Sumatra', 'HandelSin', 'Bühl', 'Pleigne', 'McchanikuS', 'Obcrscherli', 'Frz', 'Küfermstr', 'Sui', 'Brandvcrlusre', 'Schuhmachermcister', 'Viescherhörner', 'Gerechtigkeirsg', 'Burglaucnen', 'Lauenthal Laufen', 'Keßlergasse', 'Mattcn', 'Bremgartenanlage', 'Graubünden', 'St Schwarzenburg', 'Brückfeld', 'Salm Spätjahr Lachs', 'Aarberg Aarglet', 'Thunerscc Besttzt', 'Standcskaffier', 'Dragoncrmajor', 'Handlungsschule', 'Liesberg', 'simmenthal', 'Gspaltenhorn', 'Postwagner', 'Wallnuß', 'Lebenmann', 'Belp St Heiteren', 'cii', 'Zyrv', 'Lauterbrunnenthals', 'Zürcher Zoh', 'Gemeinderath', 'Fuhrmann', 'Oberster', 'Marmorlafcln', 'ValeyrcS', 'Bcrgelbachbrücke', 'Schöne', 'Bubenbergs Weg', 'Neuenstadt Joneli', 'Ainade', 'Lände', 'Schenswerther', 'Maimonats', 'Schiffländi', 'Weinhändlcr', 'Reuchenette', 'St Saphorin St Saphorin', 'Breitenrain', 'RathhauStcrrasse', 'Ravyl Renan', 'Turnanstalt', 'Jndienncdrucker', 'Jonquisre', 'Wettcrhorn', 'Thierspital', 'lauralp St', 'Eurer Commis Junkerng', 'Wachmann', 'Mittholz', 'Steg Eggimann', 'Leichcnhäuscr', 'Gerechtigkeitsgasse Krone', 'Lolligen', 'Vom Schlosse', 'Fontenois', 'Sefligen', 'Zoh Jak', 'Judengassc', 'Zweilütschencn', 'Braun', 'Spätobst Mostobst', 's3i St Wyl', 'St Saphorin Hudcn', 'Gcrcchtigkeitsgassc', 'Rechtsagcnt', 'DiehölzerneBrückc', 'St Kehrsatz St Ruinen Aegcrteii', 'Neuenburg Erlach', 'Zweistmmen', 'Zinngießer', 'St Stockhorngipfcl St Thun St Allmendingen', 'Kantiniäre', 'Edelhirsche', 'Welse', 'Obersimmenthal Berg', 'Blumenstein St', 'Büren Aarbrücke', 'Steiger ebendaselbst Denkstein', 'Grindelwald Fahrweg', 'DÜrrenroth', 'Nr Pulver Albrecht', 'RathhauSterasse', 'Ant Ludw', 'Münsterplatz Kirchplatz', 'Dauben', 'Naillard Negotiant', 'CarnicS', 'Gchwemmetzger', 'ReconvillierS', 'Bierstübli', 'Gtcinhauermstr', 'Ferd', 'Bergstrom Oberland', 'Rud Kricdr', 'Waadtlande', 'Pieterlen', 'Lüsel', 'Saane', 'St Peter', 'Thun Fahr', 'Weyermannshaus WiegsaM', 'Slockhornkettt', 'Zsenschmid', 'Elrichsricd', 'Lsrolss', 'Jschi', 'Artillcriehauptmanns', 'Feuerspritzenmagazin', 'Nikl Frdr Beruh', 'Zollstätte', 'Bern Stockmar', 'Frd', 'MustklehreriN', 'melanDessouS St Rußille LeS Cerlatez St Saignelegier Flecken Schangnau Fuhrweg St Hcimberg St Stcffisburg Schwar', 'Job', 'Frz LLw', 'Weibcl', 'Vicekönigs', 'Schneidcrmstr', 'Grindelwald St Wergisthal St Sennhütte Alpigeln St Sennhütte Busti', 'JsenschmidBay', 'Reuge', 'Twinghcrren', 'Jgnace', 'Spczierer', 'Ublancnofstzicr', 'Geiftkirche', 'Orvim Les PrsVaillonS', 'lingen', 'Ktrchhöfli', 'Elisc', 'Gemscnflüh', 'Schncidermstr', 'Speziererili', 'Neuenegg Brücke', 'Chasseral 4sso', 'Frieden', 'Nods', 'Rüderswyl', 'Bern 3voo', 'WeißenburgBad', 'Ank', 'Krähenbühl', 'St Ursitz Str St', 'Nöthlis', 'Sennhütte Chriencn', 'Weiler Deißwyl', 'Landeck', 'Laden', 'Noterminirte', 'Käfichgäß', 'Hermeringen Bellmund Nidau', 'Bitzius Alb', 'ILmpsrour', 'DequerviN', 'teregg', 'Rütihübcli', 'Jolimont Erlach', 'Schmadribach Schmidwcyerbad', 'Harnischthurm', 'Aargauer Stalden', 'Spcnglermstr', 'TerrassesamtPa', 'Pferret', 'Landstraße', 'Mcyringen', 'Rothhorn Jnterlacken', 'Aarberg Frotb', 'Schweinmetzger', 'Lütschene', 'Guttanne', 'Gerbcrlaube', 'GcrechtigkeitS', 'Schwarzes Thor', 'Kalch', 'Brunnadern', 'Leberberg Schappuis', '2rBrunngasseA', 'Bäckcrmstr', 'St Gstaad St Thurbach Thurbachbad Unterseen', 'Weißenburg', 'Schafalp', 'NüegSau', 'Schweizerfranke', 'Schauplatzg', 'St von Meiringen', 'Allenbach', 'Elay', 'Eiskeller Bern', 'RathcS', 'Fürst Baselschen Schloß', 'Metzggebaudc', 'Schützenmattpromenade', 'Adrcsscnlttch', 'Neußcr', 'Sennhütte', 'Schneidermstr', 'St Vom Gipfel', 'Trach', 'St Delemont', 'Jrlet', 'Rath', 'Häffcli', 'Joli', 'Brüttelenbad', 'Mühldorf', 'Brienzersee Fahrweg', 'Müllerlaube', 'Twann Äartmann', 'Diesse', 'Stalden Wirthshäuser', 'Neuenburgersiraße', 'LudwAlbr', 'Niedersimmcnthal', 'Schlosses Erguel Gpiez', 'Angr Mcycrhöfer Gebrüder Schrcinermcister Salzmagazin', 'Ebersold Elisabeth', 'Oberes Kehrhüuschen', 'St Johannes KornhauS', 'X', 'Aeckenmatt', 'Gemmi Berg St Kandersteg', 'Witkwer', 'Füllenbach', 'Rußland Oesterreich', 'Kostgeber', 'Joh Jak Albr', 'Elis', 'Adresscnbuchs', 'St Brünig', 'Lchenmann', 'feld', 'Salpeterthüler Fahrweg', 'Schreincrmstr', 'Schoßhalden', 'Roßalp', 'Slübbl St Sennhütte Matten St Lauenen St St Von Lenk St', 'Gentelthal', 'Kleidermagazin', 'Philosophenweg', 'Snell', 'Neuengasse Nr Bitzius', 'Rütihübeli', 'Soulce', 'Linde Elfenau', 'hausen Zürich', 'Burgdorf Luzern', 'Ludw Abrah', 'Bern Jmer', 'Schinznach Leuk', 'Slcrztc', 'Gypsreiber', 'Lebküchlerin', 'Nagelschmied Aug Hügney Pinlenwirth Wittwe', 'WachS', 'Droz', 'Küentzi', 'St Johann', 'Längcnberg St Kehrsatz', 'Klosterterasse', 'Müllermstr', 'Strütlingen', 'Oberlvyl', 'Cafinoplatz', 'Gastcrenthal', 'Hall Bernh Friedr', 'Frutigen St Nach Adel', 'SumiSwald Niedern', 'Zwin', 'Lithograph Kramgasse', 'Lieci', 'St St Ueber Lauterbrunnen', 'Jak Christ', 'Vtzade', 'Waadt Freiburg', 'Tfchaywo II', 'St Gallen', 'Frdr', 'Alterthums', 'St Gümmenen', 'LouiS', 'Falkeneck', 'Bern Neuengasse', 'Sauvain', 'Aare', 'Grindelwaldgletscher', 'Mid Burgund', 'Mayen', 'WickhardSwyl', 'Burgerrath', 'St Rüscheck', 'Dotzigen', 'St Büzberg', 'Frau RathSherrin tzr Junkerng', 'PolizciweibclS', 'Bern Junkerng', 'Südwcst', 'Büchl Frz', 'Solothurn Knuchel', 'Gmgnard', 'Ostermundigcn', 'Zes Bapt', 'Zweistmmcn', 'Kanton Bern', 'Uebergangs', 'Germanus', 'Sumiswald Alchenberger', 'Tschingelhorn', 'Mittaghor', 'Fcuz', 'ÄitziuS', 'Thal JnterlackeN', 'Säselimatt', 'Acbi', 'Luzern Luttwyl', 'Acberhard', 'Vcrmes', 'Gansbrunnen St Cremine', 'Hak Ulr', 'Franz', 'Courrendlin Rennendorf', 'Schneidmühle', 'St Sonbcval', 'äLüsl', 'Wildermett', 'Weißenburg St Bad', 'Burgcrgemeindebehörden', 'Standesweibel', 'Thiele', 'Rathsherr', 'Gartcnbcsteher', 'Albert', 'Kuliy, SLOC', 'WagnerSommer', 'St Gsteig', 'Schloß Tellenburg Mander', 'Dägcrtschi', 'Badhaus', 'Seftigen', 'Stadt', 'Jagdschloß Nydeck', 'Seitenstraße', 'Lunkerng', 'Berner Rath', 'Kirchthurm', 'Zollbrücke', 'Ringgcnberg', 'Baumgartcn', 'St Jmmerthal', 'Bätterkinden', 'Geltenbach', 'Hioubet', 'Rußland', 'Bergthal', 'Lehnkutsch', 'Klaßvorstehcrinncn', 'Rathhaus Gerber Samuel', 'Hclisbühl', 'Aarbergerthor', 'St Thun St Gwatt Kandcrbrücke', 'Kirchet', 'Rathhausplatz', 'Wallis Freiburg', 'Kandcr', 'Zihl', 'Solothurner ThorS', 'St Lauterbrunnen St Trümmelbach Grund Reuti Trachsellauenen Sennhütte Ammerten Sennhütte Stein', 'Flecke St Gstaad', 'Obersimmcnthal', 'BettmacheriN', 'Wylerfcld', 'BrunnengrciberHandlang', 'SS', 'Merlingcn', 'Steiger Gottlieb', 'Mervelier', 'Promenade', 'Singine', 'St Waltrigen Huttwyl St St Langnau', 'Ruch', 'Gumoens', 'St St Ganzen Aeschi Fahrweg', 'Müllerlanbe', 'Hahnenmöser', 'Bern Spcichcrgassc', 'Spitalgasse Bern', 'Standcsläufer', 'Lyssach', 'Alpcn', 'SeigneDessus MomelonDeffus Lorette St Ursanne', 'Meiringen St Tracht', 'Huttwyl Su', 'Eichenholz', 'Rentiere', 'Ill Niesen', 'St Untersccn', 'St Adelboden', 'Kirchhof', 'Flußadler', 'CarlSruhe', 'Bäckermstr', 'Nicderhauser', 'ModisteS', 'Stadt St Matten', 'Aarbergerthore', 'Birs Nahe', 'Alterthum', 'Napoleons', 'Bern Rossignolat', 'Benoittc', 'Nohrbach', 'DoubS', 'Bigler Fr', 'Tschug', 'Uebischisee', 'ColisseS', 'Bielersees', 'Schiffslaube', 'Kästchgäßlcin', 'Lauffen', 'klsrcbsnd', 'Steinhaucrmstr', 'St Strütlingen', 'Obergericht', 'Postgasse Nr Bay', 'Handelsmann', 'Penstonshalter', 'Mülchi Bangerten', 'Lauterbrunnen St Zweilütschcnen St Stüllc Sausbachbrücke Lochbruck Lauterbrunnen', 'Eisennegot', 'Birs Pruntrut', 'Bellevüe Aarzieledrittel', 'St Simon Tempel', 'Christn', 'Kornmagazin', 'St St Bütschelcck', 'Neuenstadt Büren', 'Hcrbstm', 'RathhausTcrasse', 'Hochaltar', 'Halbinsel', 'St Außerschwand', 'Strättlingen', 'Marti Frau gebHenzi Krämerin Marktgasse', 'Schloß Word Ganz', 'Graffcnried', 'HaSli', 'Bay Gabr Rud', 'Oberlande', 'Schloß Landshut', 'Nägelisgäßlein Metzgergasse Sonnseite', 'Thalkirche', 'altOberamtmann', 'Hotellaubc', 'St langes Thal', 'Ogi', 'St AttiSwyl', 'Leimfabrikant', 'Schüpbach', 'Osterrieth', 'Aidemajor', 'Golattematthor', 'Gemmi St Gestcler', 'Siebenthal Schmales', 'St Tavannes St Molin Brcleu Tra', 'St Montbijou', 'Raubgewild', 'Sticrlin', 'Speziercriii', 'Schnottwyl', 'DachSfelden', 'Burgdorf St Sommerhausbad', 'BurgerspitalS', 'Höh', 'Kästggäßleins', 'Plaffeyen', 'Weißensee', 'Mutach', 'St St Gurten Reitweg St Ueber Großwabcrn', 'Wcndelhorn', 'Aarberg Aarberg', 'Twingherrcnstreit', 'Land', 'Dampfschiff Bellevue', 'Burgerrathes', 'Kirchbcrg Bürg', 'Neuenstadt Belp', 'Dällenbach', 'Lolligcndrittel', 'Berghöhe', 'KyburgHabsburg', 'Wildbolz', 'BernhFrdr', 'Buchhändler', 'Schlipfen Bay', 'Miirrenbachs Zweilütschenen Gch madrid', 'Schöftland', 'LeS Gene', 'Walkringen Dällenbach', 'Bergrückens', 'Joh Rud', 'Gerzensec', 'Brod', 'Metzgcrmstr', 'Schwend', 'Thore der Stadt', 'Montebcllo', 'Unterstattbalter', 'Schulhaus Nr Nr Todtengräberwohnung Wylergut', 'Qeschinenthal', 'Burgcrrathcs', 'Meiringen Brienz', 'Landwerksschule', 'Bögelin', 'Torfanstalt', 'Fürsprech', 'Bei der Hochwacht', 'BätterkindeN', 'Welderen', 'Lioci', 'Petersinsel Bielersec', 'SamstMorgens', 'Häusern', 'Wangenbachs', 'Spezierer He', 'Werkmeisters Mättcli', 'Java Westindien', 'Rothhorn GebirgSstock Saanen', 'Obcrstlieut', 'Combe Franz Ebenist Meubclnmagazin Plainpied', 'Schloß Bipp', 'Unspunnen Jnterlacken', 'St St Mit Fuhrwerk St Fahrweg', 'WilderSwyl', 'St Grimsel', 'Münchenbuchsee Langhaus', 'Sittengericht', 'gasse', 'Gcbärhause', 'Zoire', 'Paßbureau', 'Joh Negot', 'Sybold', 'Kanton Aargau', 'Hand', 'AugSburgcr', 'Mathys Christ', 'Srull', 'Hambühl', 'ZuckcrbäckcriN', 'Uhrenmacher Hermann', 'Graveur', 'Hochburg Byfang Belpberggipfel', 'Freiberge', 'Bourrigno', 'Lütschenen', 'Valley Marg', 'Zinsmcistcr', 'Hauptparadeplatz', 'thurneii', 'Nydeckkirche', 'Wasen Trllßcl', 'Bierbrauer', 'RüggiSberg', 'Oberhasli Berg', 'Wattcnwvl', 'Stockhornkette', 'Neuenburg t3äo', 'Joh Friedr', 'Oberhasli Mineralbad', 'Wcibel Kunstmaler Ncnengasse Zlr 122b Wcibcl Niklaus Gypscr Salzmagazin', 'Blümlisalp', 'GrauholzeS', 'Höchstettcn', 'Bogen schützengcsellschaft', 'Schmiedenwirth', 'Reu', 'Sennhütte Schwandmatt', 'Zwiebclngäß', 'Brienzersees', 'Eselinnen', 'Strumpfwcbermstr', 'Gottesacker', 'Eiger', 'Landelsm', 'Faulhorngipfel', 'selwald', 'Lüttisbach', 'Barbiererin', 'Präposttus', 'Aebnit', 'Wurstemberger', 'St Petersinsel St Porrentruy', 'Weißenburgerbad', 'Bern Sträub', 'LandclSm', 'Belpberg St Großwabern Kleinwabern Lehrsatz', 'Lindenthal Weg', 'St Cornol Cour genay Voyebeu Porrentruy', 'Sonvillier', 'Thorberg Utzigen', 'Berchtold Münsterkirche Monument', 'Schangnau St Sch madribach Reitweg St', 'Rudrauff', 'buchsee', 'Rikcnbach', 'Münsingen', 'Altenbergstraße', 'Handelsm', 'Schloß Riggisberg', 'Flcury', 'Schrlimli', 'Schreckhorn', 'Schüttepromenade', 'Burgersvitalverwalter', 'Lütschinen', 'Kcßlcrgasse', 'Bautcuaure', 'Nr Eich Joh', 'Oberamtm von Fraubrunnen', 'LaurcntiuS', 'Gcffenay', 'Wagnermstr', 'Gerstenhorn', 'Kornträger', 'Word Ober', 'Lanqnau II', 'Lchcnmann', 'Europaö', 'Klösterli Nr Eggut Schwellenmatt Vorderes Dalmatien', 'Dav', 'EKeikofen', 'KnopfmacheriN', 'Eisenbolgen', 'Bielersee Münster', 'Arzt', 'Bijoutiers', 'Badhaus Hornbachgraben', 'Spenglcrmstr', 'Weber Christ', 'Bächlcr', 'Pulver', 'Oberbofen St Reitweg', 'RüderSwyl', 'Dan', 'Frutigen Simmen', 'Könij', 'Störschncider', 'Lugenbach', 'Finsteraarhorn', 'Amtsgerichtschreiber', 'Kühlenwylcck', 'kommissür', 'Scheideck Sennhütte Wengercn Sennhütte Mettlen Schiltwald Mengen Lauterbrunnen St St Lenk', 'Lauptmann', 'Lander Simmenthal', 'Aebersold', 'Oberhasle', 'Emmenthals', 'Schweinmetzgep', 'Lura', 'Stockhorns', 'Keßlergaffe', 'Bielcrsce', 'Mußmatte', 'Sumiswald Schwyz Paris', 'Gottl Friedr', 'Eagut', 'St Ganzen St Adelboden', 'Bärcngrabens', 'St St Oder', 'St Gurnigelbad', 'ThurneN', 'Außcrstandcshaus', 'Gig Dorf', 'Sennhütte Buhlberg', 'NcuhauS St Fahrweg', 'Bildhauer czi', 'Cortcbert', 'thurner Gränze Untersten', '4soo', 'Nathsherr', 'Straße St Viel St Bözingen', 'Pfd', 'Wittwe', 'St St Thurbachbad', 'Käsigthurm', 'Schützcnmatt', 'Georg Christ', 'Dicmtigen', 'Schuhmachermftr', 'Büren', 'Kappenmacher', 'St Rieb', 'Hochalpen', 'JngelramS', 'Wengernalp Schcidcck', 'Aarbergcrgassc Nr Luginbühl', 'Gemmi', 'Münsterterrasse', 'Berges', 'St Grindelwald', 'Vergolden Spitalg', 'Neuenstadt Freiburg', 'Luzern Messagerie', 'Stadtgarnison', 'Worblen', 'Brüggfeld', 'Tbalc', 'Privathäuscr', 'Kädereggen', 'Teuffelen Löscher Erlach', 'Maria', 'Balsiger', 'Burgmattcn', 'Gambach', 'Lurxsrvsrein', 'Courfaivre', 'Biclersec', 'Güder', 'ThunerseeS', 'Röche', 'Vinelz', 'Kirchhoftcrrasse', 'Lotterievureaux', 'Regierungsrath', 'Rath HandelSm', 'Appolloni', 'Bomont', 'St Hondrich Mülinen St Rcichenbach Kanderbrücke Frutigen', 'St Homlisthal', 'BräterhäusliwirthiN', 'Keßlcrgasse', 'Labourg', 'Gypsermstr', 'Jäggi', 'Marranne', 'Länggaßdrittel', 'Aarzrclcdrittel', 'Käfichgäßleindir', 'Münster', 'Newa', 'Rathhause', 'Hinzugckomnien', 'Zos', 'Morgens Mes', 'Sollberger Barb', 'Schweinmctzger', 'Schulgasse Stöckli', 'Hunnenfluh', 'Lohnwascher', 'Mctzgermstr', 'Don Krailingen', 'Obcrfcld Loch', 'Aarbcrgerq', 'Ncucng', 'Schauspielhaus', 'Rud Karl Gottl', 'Arm', 'Zunkern', 'Salom', 'EselSrücken', 'KaffecwirthiN', 'Sulg', 'Jnselibad', 'Wüthericb', 'BüetigeN', 'Bcllcvue', 'Graffenricd Holzmarkt', 'Rothfarberei', 'Klapperläubli', 'Gränze', 'Joh Nud', 'Murtensee', 'Nr Wyß Rudolf Schrcincrmcistcr Spitalgasse', 'lisberg Lauenen St St Laupcn Stadt St Niederwangcn St Laupen St St', 'GerechtigkeirS', 'Armagnakcn', 'Dürrmühlc', 'Flecken Schwarzes Quartier', 'Rcgierungsrath', 'Thal', 'Häbcrnbad', 'Heiligengeistkirche', 'OberWankdorf', 'St Saphorin', 'Znterlackcn', 'St Napfgipfel', 'Lciligengeisikirchc', 'Steinibach Belp', 'Wallis Solothurn', 'AmtSnokar', 'Jegenstorf Knuchel', 'große Straße', 'CourrendliN', 'Adreßbuchs', 'MöSli', 'Allemann', 'Bierhübeli', 'Bättwyl', 'Musmatte', 'RegierungSftatthalter', 'Thal von St Länge', 'Math', 'Obersttn', 'Rorhhorn', 'Grünes Cluartier', 'Storchen Spitalgasse', 'Rathes', 'Ub Galgenhübeli', 'Großer Rath', 'Aarbergergasse Nr Becherat Rothgerber Gerberngraben', 'Schloß Reichenbach', 'Zunkcrng', 'Mühleberg', 'Län', 'Jnselspital', 'St Gwatt St', 'Münster Eisenwerk', 'NichanS', 'nördl Staaten', 'Waldegg Hüdeli Schöncgg', 'St Courtelary St Cormoret Villeret St Inner', 'Dorf Eggimann', 'Lehenmsnn', 'Bern Lcrber', 'Obmann', 'Sans Hofer', 'Bsvillard', 'OberhaSli', 'Großen Rath', 'Geißbühler', 'Schwellenmätteli', 'Uhrenmacher', 'Bantiger Berg St Völligen', 'Epsaeh', 'Wimmis St Reitweg', 'Lüzelflüh', 'Schloß Blankenburg', 'Todtengräber', 'Das Kornhaus', 'GrimmensteiN', 'Tschiengelfclsstafel', 'Mcdaillen', 'Wollentuch', 'Hohgant', 'Mayenwand', 'St SchulmeistcrhauS', 'Gercchtigkcitögassc', 'Kantons Bern', 'Weiler Flugbrunnen', 'Gastwirth', 'Republik Bern', 'Burgerspital', 'Längenberg', 'Flecken', 'Fayance', 'Courchavoix', 'Engemeister', 'ZeichnungSlchrcr', 'Oberstlieut', 'Blauncr', 'Wcgmühle', 'St Stephan', 'Lehenkommiffär', 'Quiqucrez', 'Oberlandes', 'Alpengclände', 'Bern Blätter', 'Mctzgcrg Nr Länggaßdrittcl', 'GcburtShülfe', 'RathSbcrr Spitalg', 'Entlibuch', 'Gerberlaube', 'Gclpke', 'Schlößli', 'Kirchthurnen Riggisberg Rütti', 'Hafnermstr', 'Vermes', 'Morlotlaube', 'Aarberg Nr FetscheriN', 'Amr Fraubrunnen', 'Waadt Wallis Solothurn', 'Schloß Nydeck', 'Thuner Almend', 'Kantonsuhrenmachev', 'Büderich', 'Oberlieut', 'Rodt', 'Hirtenland', 'Brunnengräber Aarbergcrg', 'Stockhornkette Noch', 'Luzern Diligcnce', 'Grüningen', 'St Burgdorf', 'Burgerschreiber', 'Lutmachermstr', 'Lüthardt', 'Eman', 'Joh EM', 'Ludwig', 'Schwand', 'Leuenberger', 'Wallis Saignelegier', 'Büren Freiburg', 'Simmenthales', 'Waffenmagazin', 'Sohii', 'Solothurnerthor', 'Mumprecht', 'Thu Namens', 'Saanen Saignelegier', 'Derselbe', 'Bötzingen', 'aiiiö Lombach', 'Zss Gebäude', 'St von Wangen', 'Gsteig Dorf', 'Bevillard', 'St Word St Ried Großhöchstetten Zcizziwyl Steinibach Signau Langnau Flecken St St Lauenen Fahrweg St Reuti St Stalden Lauenen Reitweg', 'Kostgeberin', 'Zürich', 'Mark', 'Quincallarichändl', 'Zwirg', 'Im Hooff', 'Wyßloch Gemeiner Sood', 'Casinv', 'Unterseen St', 'Barthol', 'Gebrüder', 'Neubrück', 'Thierarzneischule', 'Thierarzneikunde', 'KornhauscS', 'Ayrv', 'Jouxthales', 'Bernh Lud', 'Lehnkutfcher', 'NamenS', 'Schwarzhorn', 'Melchenbühl Wittigkofen', 'Joh Sam Christ', 'Reichenbachs', 'Jungfrau Lauterbrunnen', 'Aarau Murgenthal', 'Rosenlauibad', 'Schlösser Bremgarten', 'Diehi', 'Löffelkricg', 'Annetcr', 'vanneS', 'HofstettcN', 'Gcmeindcwesen', 'Salzbüchslcin', 'Rüeggis berg', 'Bönigcn', 'Spejiercr', 'AarflußeS', 'Untcr', 'Ssnnseite', 'Amtsvcrweser', 'Altcnbergdrittel Lorrain', 'Delsberg Boffart', 'Bärengraben', 'Ortschwaben St Schü', 'Bönigen', 'Zeitglockenthurm', 'Stcinhauermstr', 'Kueren', 'Bremgarten Mettlek', 'Krauch', 'Kornhäuser', 'Grundbacher', 'Notar', 'Tesstn Deutschland', 'Kantor', 'Tabaknegotiant', 'Lerrenküfers', 'Kästggäßl', 'Schloß Susten Reitweg St Meiringcn St', 'St Urtenen', 'Sulgenbachdrittcl', 'Washington', 'Käfigthurm', 'Weißspengler', 'HundeShagen', 'Hünerwadcl', 'Schooßhaldendrittel Obstberg Nr Liebegg AcgelmooS', 'St Sennhütte', 'Negotiant', 'Vcrqolder', 'WohlcingerichtetcS Spital', 'Büren Paris', 'Jnterlackcn', 'Schanzpromcnave', 'Küchlerin', 'Schone', 'Enge Läng', 'St Reidenbach', 'Wylerfeld Manövrirplatz', 'Oder Fahrweg', 'Unteraargletscher', 'Georg Frdr', 'St Gränze St Wange', 'Genf Waadt Wallis Büren', 'Schloßberg', 'Dominikanerkloster', 'Hauptwachcn', 'NegierungSstatthaltervonJntcrlacken', 'Lolligcndr', 'Casino Jnselgasse Sonnseite', 'Lausanne Gumoens', 'Aarberg St Walperswyl', 'Langnau Paris', 'Salzmagazin Feld', 'Walthard', 'MühlemachernndOehlcr', 'Eine Fahrstraße', 'Meiringen Heid', 'Stalden Nr Merveilleux', 'St MettlcN', 'Büren Basel', 'Schafloch', 'Gurnigel Weißenburg', 'Schnetdermstr', 'Zdinden', 'Marktgasse Nr Champagnac Monteil Gebrüder Ncgenschirmfabrikantcn Kram', 'St St', 'Furka', 'Zürcher', 'Wilh', 'Moser Pintenwirth Slarbergergaffe Nr Mouthigtty', 'Hunkerng', 'Anknnft', 'Gürbenthales', 'Schlatt', 'Schüpbach Oberhünigen', 'Jegenstorf Jak Witschi', 'Sumiswald Schwyz', 'Durheim', 'Ortschwabcn', 'Bern Derselbe', 'Steinhaushorn', 'cNLioouUsi', 'St Wiedlis', 'Langgaßdrittel', 'St St St Murgenthal', 'Felscnthors', 'Schreckhor', 'Abr Jak', 'Alpe Winter', 'Uhrcnhändler', 'Marktgasse Nr Tessaro Dominiqne Kunsthändler Gcrechtigktsge', 'Gugger', 'ThalS', 'Schoßhaldendrirtel Aarzieledrittel', 'Waisenhause', 'Stemhölzli', 'Rentisre', 'Hauscigcnthümcr Bern', 'Werbt Links', 'KostgcberiN', 'Slraßburg', 'Obrccht', 'Trümpi', 'Dietrich', 'Assen', 'Fahrstraße', 'St MciringeN', 'Nr Hürner Ank', 'Rätzligletscher', 'Likerarschule', 'Zi', 'Faulhorn Grindclwald', 'Mürsett', 'Parfümcur', 'GercchtigkeitSg', 'Saanefluß', 'Keilbach', 'Brenzikofen', 'Twann Bielcrsee', 'Grindelwald 24is Gstcig', 'Bigler Wrttwe', 'Rostna', 'Siebenbrunnen', 'Gemcindweidc', 'Küfer', 'lä St Kandersteg St Ocschinenbrücke', 'Cascrnen', 'Banquier', 'Zeughausplai', 'Gottstatt', 'Stiegcngang', 'Heinr', 'Schooßhalden', 'Buren Stadt Straße', 'Appclla', 'St Subigen', 'Gerechtigkeilsgasse', 'Nr Steinhäusli', 'Holligendritcel', 'Dießbach', 'Blacken', 'Metzgergasse Goldene Adler', 'Viescherhörncr', 'Grempler', 'Donnerst', 'Etzelkofen', 'Rentier', 'Münsterkirche', 'Thun Bachmanil', 'Steinhauermstr', 'Holzmesser', 'Oberamtmann von Aarwangen', 'Dürrbach', 'Fra', 'Frick Xr', 'Äle', 'Hufschmied', 'Basel Neuenburg', 'thurn', 'Schmadribaches', 'BirS', 'Nr Lützclflüh', 'Bern Großer Rath', 'RathhausGalkrie Kramgassc', 'Müüermstr', 'Dürrmühle', 'Schloffermstr', 'Bouvert', 'Frutigen Schertenlcib', 'Solothurncrstraßc', 'Mr', 'St Wattenwyl', 'Adrcssenbnch', 'Thun St', 'Oberstfeldarzt', 'Artillerielicut Schreinermstr', 'Lafnermstr', 'Frz Rud', 'Mülinen', 'höhc', 'Elts', 'Obcrgericht', 'Salpeterthurm', 'Tschiffcli', 'Bern Theil', 'Kräm Zeughausplatz', 'Nr Hirt Lehnkutscher Marktgasse', 'Sauser Zwieselberg', 'Geisi Zc Hof', 'SornetaN', 'Speze', 'Krämer', 'Brüssel', 'St Langnau St Trüb', 'Wüthrich', 'Kaffewirthin', 'Leinen', 'Zeughaus gasse', 'St St St Ueber Jscltwald', 'Burgcrspitals', 'Landjägerlicut', 'Alte Reitschule', 'Steinkohlenflötz Lenk', 'Viande', 'Otz', 'Kirchhöflein', 'Nr Stubcr Abr Schreinermstr', 'Obcramtmann', 'Heuerlinge', 'Nägeliögäßlein', 'BelleRive', 'Gabr Gottl', 'Karl Jak Rud', 'Kappelisacker St Zolltkofen Hofwyl St Fußweg', 'HünigerS', 'Jnselhof', 'Aeschmann', 'Alpe', 'Strättlingerberg', 'Frutigtuch', 'Svitalg', 'Tscharner Lcisigen', 'Word König', 'Courtetelle', 'Schifflände', 'Bern St Ueber Merligcn', 'Hebräer', 'Kaukasus', 'Kirchdorf St Fahrweg', 'Braix', 'Kornamtsschaffner', 'Müllerlaubc', 'czi', 'Spiegelbelcger', 'Frz Gottl', 'Schoßhaldendrittel', 'buchsee Kirchberg', 'Widdenberg', 'Athen', 'Mühleberg Münchenwyler', 'Mädchenschule', 'Adler', 'Kunzlcn Sennhütte', 'Jungfrau', 'Schauplatza', 'Banquiers', 'Marg', 'Bellerive Tscharner', 'Duperret', 'Freiberg', 'Nasbaum St Sennhütte Haslerberg TrütliS Berghohe Trüt', 'Fricdr', 'Nydcckkirche', 'Aarberg St Lyß', 'Sattlermstr', 'Vinelz Pfd Erlach', 'Straßburg', 'Kästggäßlein', 'Sennhütte Unterwintereck St Sennhütte Oberwintereck', 'FrischingstipendiuM', 'Delsberg Hauptstraße', 'Lütschinenthal', 'Nicsengipfel St St Oeschinenthal', 'Burgerspital Zeughausplatz', 'Lühelflüh', 'Salzhandlungsverwnlter', 'Kellcrhaltcr', 'Bonstettcn', 'Rhone Grindelwald', 'Schoßhaldendrittcl Nr Schläfli', 'Musikinstrunien', 'Alpen Gletscher EiSgebirge', 'Staub Jak', 'Kirchhofterrasse', 'Roschi', 'Lebenm', 'Lindenallee', 'Tannengehölze', 'Scherlenbach', 'RcgierungSrath', 'Kerzerz', 'Neuenstadt Brätst', 'Schuhmachcrmstr', 'Sumiswald Schwyz PariS', 'Grimselstraße', 'Hornbach', 'Js', 'Niedcrsimmenthal Pfd', 'St Sennhütte Unterstopf', 'Heimiswyl', 'Schlachthaus', 'Klein Abr', 'Junkcrg', 'Sennhütte Win', 'Phärit', 'BachhüuSchen', 'Arber', 'Kirchenfeld', 'Münchenbuchsce', 'Mühlcdorf', 'Jnter', 'Bitzius Fr', 'Nenzlingcn', 'Krähenbühlleist', 'Schwarzhörn', 'Freiburg Breisgau', 'LeS Laives', 'Urner', 'FrantzaiSbad', 'Neuengasse Nr Tillicr', 'Friedr', 'Sus', 'Untcrstatthaltcr', 'Lbambellaii', 'Lenk Reichenbach Oberhasli', 'Jnsclscheuer SalzbüchSlcin', 'Lübeck', 'Aimmcrmstr', 'Berner Hochlande', 'Kielte', 'Solothurii', 'Saancnmöser', 'Fried', 'Käfichgäßlcin', 'Aarberg St WalperSwyl', 'Häbcrenbad', 'Stökli', 'zogenbuchsee', 'Frutigen Spitalgasse', 'Stistsgebäude', 'scN', 'Saignelegier Basel', 'Jntcrlackcn Gsteig', 'Nydeck Jagdschloß', 'Büchsenschmiedmstr', 'Hebräeb', 'vonFschy', 'Bödeli', 'Weißenburgbad', 'Unterstatthaltcr', 'Blumenstein St Blumensteinkirche', 'Reichenbachfall', 'Ncgotiant', 'Wengernalp Scheideck', 'Pintenwirthin', 'Enggisicinbad', 'Bibcrist', 'Gipsermstr', 'Bath', 'Aarburg Schwyz', 'Dieß', 'Ankcnlaube', 'Metzgermstr', 'Wildpret Vogel', 'StaldenhornS', 'SeftigeN', 'Biireii', 'Mädchenwaisenhauses', 'Goldswyl', 'Guggisberg Schwarzenburg', 'St Faulhorn', 'G', 'Büchsenschmicd', 'Lyon Genf', 'Gentclthal', 'Zwiebelngäßlcin', 'Irrenanstalt Jnselspital', 'Bor', 'Gicßbach', 'St Ricdstatt'}",1986,"{'Buben', '', 'Strki', 'Schnegg', 'Leberberg', 'Lan', 'Lasen', 'St. Sch', 'Lindenhof', 'Graben', 'Gambach.', 'Grnner', 'Ge', 'Kvlliken', 'alden', 'Lerren', 'Unterwattenwyl', 'Jenner', 'Senenfluh', 'Nudelf', 'Banjormas', 'Herzog', 'Gygax', 'Reggisberg', 'Iudcn', 'Brtst', 'Metzgergassc', 'Jnsclgasse', 'Lrtscher', 'Weienburgbad', 'Kunzlcn', 'Mettlen', 'Wilard', 'Strub', 'Sger', 'Lanqnau', 'Saxetenthal', 'Stry', 'Milano', 'St. Jmmerthal', 'Sonnenseite', '- miswald', 'Altoberamtmann', 'Brggfcld', 'Rlggisberg', 'Oberbhl', 'Chopard', 'Lcistabwarl', 'Oschivaiid', 'Altrnbcrg', 'Rudols', 'Belle-Rive', 'Lerzogenbch', 'Limpbach', 'Rssel', 'Kelerg', 'Mlincn', 'Spiialg', '- kerngasse', 'Stcinaker', 'Brien', 'Oberbtzberg', 'Tessin', 'Schafleken', 'Schaufelberg', '- wichtrach', 'Groweibcl', 'Drrenmatt', 'Mur', 'Lnggadr', 'Krmcr', 'Deiwyl', 'Knigsfeldcn', 'Neuenburgersirae', '- Diebach', 'Gloor', 'Jfaak', 'Oheubcrger', 'St. Ried', 'Sebauplatzgasse', '- gaffe', 'Mhlencn', 'Sthli', 'Mnllcrlaube', 'Vorderes', 'Simmen', 'Koppigcn', 'Emanue', '- stn', 'Drogerie', '- plitz', 'Meikirch', 'St. St.', 'Mnster', 'Carnal', 'Frz.Ldw', 'Oberwintereck', 'Gercchtigkcitsgaffe', 'Judenq', 'Grnematt', 'Krschenbrunnen', 'Baadwirth', 'Brhegen', 'Schwefelberg', 'St. Thurbach', 'Grafenricd', 'Mhlenlaube', 'Liechti', 'Bnigen', 'Viehmarkt', 'Ruille', 'NegSau', 'GmmligermooS', 'Madretsch', 'Hambhl', 'WeycrmannshauS', 'Morgarten', 'Zhringcn', 'Vuilleumier', 'Werthmller', 'Burgbhl', 'Schlupp', 'Maisonette', 'Meykirch', '- singen', 'HaSlebachcr', 'Hahnenmser', 'Altenbergvorstadt', 'Sdwcst', 'Grubcr', 'Str', 'Jcughausgasse', 'Messageric', 'Sllanplatzg', 'Selffslaubc', 'Salzbtte', 'Gnmeis', 'Kelergasse', 'Maybach', 'KornhauSplatz', 'Rathhaus-Gal', 'Junkerugasse', 'Schwendi', 'Wachs', 'tschrcmcr', 'Mhleberg', 'NeuengaA', 'Fredcveanx', '^', 'Schweden', 'HariSbcrg', 'ZnBaninwollwaar', 'Marolf', 'Solothurncrstrac', 'Schohaldcndrittcl', 'Granitstcinbrecher', 'M-itach', '- deckstege', 'Mattland', 'St. Kirchberg', 'Stange', 'Grinsel', 'Leuw', 'Brnigen', 'Balegues', 'Tscharner', 'Thurgau', '- gnclegier', 'Vrunncngassc', 'Pintcmvirth', 'Merveilleux', 'Gerbernlaubc', 'Narbcrgcrgasse', 'Gpitalg', 'Frsprech Marktgasse', 'SteiniSweg', 'Bernern', 'Krieug', 'Mttenberg', 'RterichSbodcn', 'Kirchgaffe', 'Ioh', 'Kyburg-Habsburg', 'Trimstein', 'Dllcubach', 'Ulrich', 'Mer-qergasse', 'Mummenthal', 'Bremgarte', 'Stalder', 'Meutfauceu', 'Seiler', 'Wndfluh', 'Gerech', 'Brgger', 'LeS', 'Sonccboz', 'Tfchaywo', 'Gypscr', 'Zwieselberg', 'Lngenberg', 'Ldrach', 'Frei brg', 'Kehrhciuschen', 'Elfcnau', 'St. Zelg', 'Jun kerngasse', 'Bttwyl', 'Luginbhl', 'Gndhardt', 'Aegcrten', 'Altenbergstrae', 'Brunucngasse', 'St. Wciffenburg', 'Rmligen', 'St. Altstaffel', 'Joo', 'Kcilbach', 'Tischg', 'Ril', 'Leinwandbandl', 'Rli', 'Lombachthurm', 'Niederlindach', 'Staubbachhhe', 'Ricdgrub', 'Steingut', 'Nencngassc', 'Guttannen', 'Minder', 'Perer', 'Drrbach', 'Hahnenkrat', 'Schrch', 'Geist-Kirche', 'Deyong', 'Am', 'Zugwyl', 'Sumpfland', 'Gserz', 'Obergoldbach', 'Hrner', 'Rmlingcn', 'Bdclithal', 'Wiesen', 'Neleren', 'Nieschang', 'Sustcnbcrg', 'Tirano', '- brck', 'Gmmligenthal', 'Kng', 'Bessart', 'Knig', 'Schwellenmatt', 'Tes', 'Rytz', 'Zunkerngasse', 'Waltrigen', '-', 'MciringeN', 'Bandclier-Gru', 'Beljean', 'Buhlberg', 'Linde', 'Wattcnwyl', 'Aarbcrgergaffc', 'St. Meiringcn', 'Eisenwerk', 'Blau', 'simmcnthal', 'Aufranc', 'Bangerten', 'Cam', 'Obersim', 'Bollwerk', 'Homlisthal', 'Straburg', 'Tedlingen', 'Mschbergcr', 'Knechtenhofer', 'Brkfeld', 'Tramlingen', 'Klopfcusteiu', 'Hotcllaube', 'Ncncugaffe', 'Namscycr', 'Kclergasjc', 'Weienburgerbad', 'Marktgaffe', 'Preuen', 'Wynau', 'Triner', 'Molin', 'Ncuhaus', 'Voltigen', 'Sandstein', 'Aarber', '- simmenthal', 'Waudsth', 'Zorn', 'Wahlenhaus', 'Kelergaffe', 'Osten', 'Brki', 'Haag', 'Riedbad', 'Seckler', 'Gadmcn', 'Breisgau', 'TannenneuhauS', 'Zlarbcrgcrgasse', 'Blumensteiii', 'Wnbermarkt', 'Mei', 'Schauplahga', 'ZcughauS', '- gelnjager', 'Brggfeld', 'Mzcnberg', 'Aarzichlidrittel', 'Gantcrisch', 'BrodhuSchcn', 'St. Laupcn', 'Salza', 'Schallenberg', 'Metzgcrngaffe', 'Schmidwcyerbad', 'Bo', 'Statten', 'Joh.Baumgartner', 'Winzenried', 'Altenbergcs', 'Grohochstetten', 'Kelcrgassc', 'Stndcr', 'Tbun', 'Emmert', 'Nummel', 'Aug. Saiguelegier', 'Kruchi', 'Kornhansplatz', 'RatbhauSplatz', 'Mattstettcn', 'Aarzichlidrittcl', 'Msti', 'Klopfcnstein', 'Gurnigel', 'Casp', 'Mattez', 'Kumbach', 'Liennv', 'Sombeval', 'Monto', 'Stalden8Nr', 'Mnsterterrasse', 'St. Johannis', 'Aarbergerq', 'Berner', 'Baumgartncr', '- bergen', 'Brumiengassc', 'Utzigen', 'Tschanz', 'Unterscen', 'Neuen brg', 'Stnber', '- bon', 'Wy', 'Leinwand', 'Wein-Negot', 'Zeh', 'Witschi', 'Postgaffe', 'Portenier', 'Rscheck', 'Jcughausplatz', 'Teller', 'Sollberger', 'Brttelenbad', 'Frcieiihof', 'Fankhauser', 'Trt', 'Bellmund', 'Zrich', 'Niederbaden', 'Burkhalter', 'May', 'St. St', 'Tramelan', 'Schlnpp', 'Faivre', 'Neuengaffe', 'Grbenthales', 'Guilhicr', '- lisberg', '- ring', 'nenbrcke', 'Simmcnthal', 'Buchwalder', 'Blaser', 'Unterschallen', 'Mattenberg', 'Bieler', 'Krebs', 'Weienburg', 'D.A.Delarenfrille', 'Aarbergerstrae', 'Postg', '- hausen', 'Bmplitz', 'Ncucnburg', 'Stcgmatt', 'Basellandschaft', 'Uuterthor', 'Schabrod', 'Aarbergerga', 'Kienholz', 'Kramgasse-K', 'Rathhauplatz', 'Rolli', 'Nomang', 'Niedern', 'St. Lenk', 'Kantost', 'Holziger', 'Rieb', 'Sriswyl', '- thal', 'Krauchthaller', 'Tribolet', 'Zudcngaffe', 'Bellcvuc', 'Wicdmer', 'Clarctsack', 'Frutlgen', '- bcrnkellcr', '- dorf', 'Aarbrrgergassc', 'Sleubrck', '- Marktqasse', 'Ncueng', 'Denerez', 'Fridolin', 'Altenbcrgbrcke', 'St. Gsteig', 'Nnbin', 'Kesslerg', 'Schwarzenbach', 'Rderswy', 'Carl Ebcnist', 'Mchenbuch', 'Peunuerats', 'Buwyl', 'Lerber', 'Fllenbach', '/', 'P.Daubalder', 'Leibundgut', 'ZcughauSg', 'Maneowitz', '- talgaffe', 'Brcn', 'Solo', 'Langnan', 'Kfigglcin', 'Mlinen', 'Jegenstorf', 'Mnchenbuchsee', 'Draperie', 'Mohn', 'Belle-Foniaine', 'Groggenmoos', 'Grering', 'Spitalgasso', 'Kclergasse', 'Modiskc', 'Luttwyl', 'czr', 'Hchstettcn', 'Iunkerngassc', 'Gicbach', 'Prting', 'Schulgaffe', 'Stephan', 'Vikt', 'KSicber', 'Stram', 'Knubel', 'Moni', 'Helisbhl', 'ViehmarktNr', '- keitsgasse', 'Bnigcn', 'Ela', '- Reitweg', 'Nu', 'Mnsterkirche', 'enbura', 'Mal', 'berSumis', 'Berger', 'West', 'Peri', 'Niederscherli', 'Kubitz', 'Lauenthal', 'Speiebergassc', 'Heinigcr', 'Choffat', 'Klopfenstein', 'Spich', 'Huppererdegrube', 'StefsiSburg', 'u.nrdl.Frankreich', 'Rennfluh', 'Mnst', 'Snlgcnbaeb', 'Ucbersax', 'Kfigglein', 'Lans', 'Blenstein', 'Emdthal', 'Rbsaat', 'StessiSbnrg', 'Augsburg', 'Konolsingen', 'Brunncngasse', 'Lzelflh', 'Zauggenried', 'St. Stllc', 'Scidclhorn', 'St. Strtlingen', 'NiklauS', 'Hans', 'Mnsterthal', 'Routen', 'Betig', 'Luternau', 'Gomerkindcn', 'Brunner', 'Napf', 'Maser', 'Iudengafse', 'BrunngaffeNr', 'Lcngnau', 'Leiitcrsoy', 'Andr', 'Brnig', 'Schwanden', 'Stmpcl', 'Gilgen', 'Mctzgerg', 'Vermeille', 'Ceutiu', 'Bcud', 'Salzmagaziu', 'Kstgglein', 'Jtz', 'GuggiS', 'Sainncl', 'Tschingelgletschcrs', 'Streit', 'Bheud', 'Lauven', 'Villeret', 'Neuengassc', 'Aarzichli', 'Hnni', 'Gerolstngen', 'SvmiSwald', 'Kreuz', 'Schpfen', 'Griebach', 'Schncnbcrg', 'Hofstetter', '- thor', 'Krummstab', 'Mnchenwyler', 'Gtalden', 'Kclerg', 'HaSlethal', 'Uoutbgou', 'Grocnbaeber', 'Sai', 'Dubach', 'Vgeli', 'Sebauplatzgassc', 'Trcl', 'Oberhofcn', 'Pcuntrut', 'Lntternau', 'Mhlebach', 'Glutz', 'Schwarzwasserbrcke', 'Siltbrunn', 'Lnggadrittel', 'Ncuenftadt', 'Picmont', 'Untersten St.', 'Zwingelhof', 'Hirsbrunner', 'McyclSgrund', 'Gallen', 'Schnfrber', 'dlarbergcrgasse', 'Mchgcrgasse', 'Ncllstab', 'Niederbtschel', 'Knitz', 'Tiornollaz', 'Klopfensteiu', 'Gebrd', 'Haslerberg', 'Kfichglein', 'Jenzer', 'Finsterwald', 'Utzlgcn', 'Menth', 'Jhi', 'Amtsnolar', 'Altenbergd-rittcl', 'Zug', 'Amstutz', 'Ktzing', 'Ncncugasse', 'Dachsfclden', 'Moscr', 'Chalomell', 'Wyden', '- Neuengasse', '- gaffc', 'Schoren', 'Mumatte', 'Gerberlanbe', 'Oele', 'Walkmhle', 'Neukom', 'Klei', 'Schrer', 'Sausbachbrcke', 'Kachelmarkt', 'Grnbcr', 'Saaneflu', 'Jscltwald', 'Brunnen', 'Wendelstein', 'Neuen', 'Vurgdorf', 'Drrenroth', 'Dttwylcr', 'Zofingen', 'Bleien', 'gie', 'Columban', 'MooS', 'Acugschmied', 'Biimplitz', 'Daulte', 'Salstsberg', 'Sonnseite', 'Leindotter', 'Garnier', 'Zlarbcrgergasse', 'Cornol', 'Gstcig', 'Meyer', 'Sustenpa', 'Ltschinenthal', 'Frisching', 'Buri', 'Aarziclithor', 'Wcienbach', 'Schttepromenade', 'Aar bergergasse', 'Musigen', 'Dnz', 'Bernschuh', '- kcitsgassc', 'Gwatt', 'Kiling', 'Ven', 'Rleuuiiig', 'Pastetcnbck', 'Kclergaffe', 'Lcuenberger', 'Ta', 'Cugnotee', 'Neueng', 'Trb', 'Kirchdorf', 'Konolftngen', 'Die', 'Ksichglein', 'Uarieots', 'Mnster.', 'Gehaffhausen', 'Neuenstabt', 'Verdat', 'Zcnghausgassc', 'Challandes', 'ZenghauSgasse', 'Thonen', 'Nud', 'Fabr', 'Gasthof', 'Nydcck', 'Nydegger', 'Nenengassc', 'Zziwyl', 'Frciberg', 'Heimenhauscn', 'SchadaU', 'Effinger', 'Bumplitz', 'Schoohaldendrittel', 'Tschaywo', 'Kblisbad', 'Hestvyl', 'St. Stockhorngipfcl', 'GroSjean', 'Galgenhbeli', 'Wterich', 'Grnenberg', 'Fnt', 'Brunnengaffe', 'Rtz', 'Fliickiger', 'Parts', 'Germann', 'Eticnne', 'Altcnbcrgdrittel', 'Fellenberg', 'Leuiv', 'Feilcnhaucr', 'Nderswyl', 'Grnenbcrg', 'Thunerstrae', 'Ruinen', 'C.Llidw', 'St. Maikirch', 'Bieri', 'Lngen', 'Belletruche', '- burg', 'Steinern', 'Jscli', 'Marklgassc', 'madrid', 'Chriencn', 'Wein', 'Graubnden', 'Netar', 'Ginggen', 'Siselen', 'Schwar', 'Niedersimmenthal', 'Stander', 'St. Thurbachbad', 'Judengaff', 'Grnen', 'Latterbach', '- und Untcr', 'Oberwangen', 'Wirth', 'Lbeck', 'Spi', 'Aspalt', 'Sveicherg', 'Hegg', 'Blumen', 'Aarbergcrga', 'Lautcrburg', 'Gaber', 'Brcnfuh', 'Ostcrmundigcn', 'Poftgasse', 'RderSwyl', 'Jngelram', '- senay', 'Jabcrg', 'Renan', 'Oberricd', 'Buntschi', 'Bnningen', 'Kdereggen', 'Lsel', 'Blankcnburg', 'Zlbraham', 'Aarbergcrgassc', 'Sinneringen', 'Diligence', 'Schncgg', 'Kclcrgasse', 'Furenrain', 'Struchen', 'Rederswyl', 'Brenbcrg', 'Zllbrccht', 'Neichcnbach', 'Hondrich', 'Regg', 'St. Schmadribach', 'Busti', 'St. Ursitz', 'Bruuncngasse', 'ZcnghauSplatz', 'Oeltrotte', 'Zeugbansgassc', 'Walkringcn', 'Batzen', 'Konstanz', 'Ochse', 'GcrcchtigkcitSgasse', 'Unter-Wankdorf', 'Thunftetten', 'Rderswyl', 'Tannerboden', 'Holland', 'Sommer', 'Brtschi', 'Schrcr', 'Triest', 'St. Zolltkofen', 'Miebael', 'Brodbck', 'EriS', 'Obcrspictz', 'KornhauS', 'Flckiger', '- lande', 'Nydcck-Hflein', 'Thalgutbad', '/ Bad', 'Blutthurm', 'Mctzgcrg', 'Aarwangcn', 'Mont', 'Bubenbergswcg', 'Messa', 'Raps', 'Bipp', 'Seiden', 'Castnoplatz', 'Growabcrn', 'Kcnzi', 'Seignelegier', 'Grohchstetten', 'Aarbcrgcrg', 'Melchenbhl', 'GercchtigkcitSgasse', 'Neinhart', 'Rubens', 'Schcrler', 'Trmmelbach', 'Rnd', 'Lozwyl', 'Krau', '- weg', 'Zehender', '- stall', 'Kir', 'Ber', 'Oeschberg', '- wald', 'Jaggi', 'Grosscnbacher', 'Brunnaderndrit', 'Widmcr', 'Bern.43', 'Sulgcnbach', '- bach', 'Schattseite', 'Zwiebetngl', 'Vorderaargletscher', 'St. Jmer', 'Altenbcrgdrittel', 'Inner', 'Bcnoit', 'Rfli', 'Murren', 'Schwaab', 'Cappel', 'Kanderbrcke', 'Scheid egg', 'Bricnz', 'Aarbcrgergassc', 'madribach', 'Mnsingen.43', 'St. Minuten', 'Nikolas', 'Trachscl', 'Lolz', 'Fcllcnberg', 'Niedcrosch', 'Jnbnit', 'Tanncnneuhaus', 'Morgcnthal', 'Mller-Dallemagnc', 'St. Thun', 'Schweinmehger', 'Lderach', 'Fraubrunne', 'Btzberg', 'Kantonalbank', 'Lngcnberg', 'Lantcrbrunncn', 'Corgcmont', 'Oberbofen', 'Rancb', 'Mumenthaler', 'Murgcn', 'Blsch', 'Court', 'Interlaeken', 'Hochburg', 'Schvhaldendrittel', 'Obcrwichtrach', 'Hgli', 'Boret', 'Ruland', 'Dicbach', 'tNtt', 'Pfaffcrei', 'Sans', 'Gloveilliers', 'Oeler', 'Grummbach', 'Valore', 'Salzanswger', 'Montfaucon', 'Emmenthaleralpen', 'Schz', 'Thunersce', 'Lrn.Jonquierc', '- stiege', 'Mhlcdorf', 'Senn', 'Sigism', 'Hasienbach', 'Eggimann', 'Aarglet scher', 'Nicsengipfel', '- lcrie', 'Kien', 'Sandsche', 'Signa', 'Bubenbcrgsrein', 'Zakeb', 'Seedorf', 'Mooser', '- eigen / Plaffeyen', 'Bierstbli', 'Freydig', 'Frutiger', 'Jffwyl', 'Metzgerngasse', 'Stmpfli', 'Thierstein', 'Lug', 'Mungnau', 'Dufresne', 'Mirchel', 'Alpigeln', 'Oberwohlen', 'Spietz', 'Ober-Wankdorf', 'Brssel', 'Thorbcrg', 'Karnen', 'Gerechtigkcitsgasse', 'Graffenricd', 'St. Jakob', 'Obersteg', 'Brenfels', 'Grnig', '- buchsee', 'Weisienburg', 'Almendingen', 'Freiburghaus', 'Spitalgaffe', 'Leuziger', 'Herven', 'Jnnkcrngassc', 'St. Saphorin', 'Schweizer', 'St. Fleury', 'Suttwyl', 'dir', 'KnigSfclden', 'Ammerten', 'Zeughaus', 'Brunngasse.', 'Neucngasse8Nr.113r.gr', 'Walperswyl', 'Krachholz', 'Jcnner', 'Schinz', 'Mistelberg', 'Walkringen', 'Rubin', 'Lerzogenbuchsee', 'Coucy', 'Nebengasse', '- thurneii', 'Moreau', 'Trachsel', 'Zeughausgaffe', 'St. Riedburg', '- genthal', 'Drig Marg', 'BuchLndkr', 'Juden', 'Matten', 'Gerechtig', 'Sury', 'Kanderbrgg', 'Boncourt', 'Punier', 'Salom.', 'Hermeringen', 'Gcrechtig', 'St. Brnig', 'Acbnit', 'Gmlingen', 'Girod', 'Ncnengasse', 'imLngga', 'Wyachcngraben', 'Hotelplatz', 'Asuel', 'Poleren', 'PariS', 'Erguel', 'Salzmagazing', 'Brg', 'Lolzmarkt', 'Brunncngassc', 'Diebach', 'Zelg', 'Mch', 'Reichen', '- fee', 'Wyder', 'Ncgoeiant', 'Oberes', 'nrdl', 'Zimmlisberg', 'Mnchringen', 'Knrr', 'Miinsterplatz', 'Mctzgcrgassc', 'Mnchen', 'Grbe', 'Kitzlig', 'Mattstetten', 'Lanz', 'Tschannen', 'Cgger', 'Zllner', 'Eybrgg', 'Toffen', 'Aarbcrgcrgasse', 'Brttclen', '- Kramgasse', 'Mtschwyl', 'Seelandes', 'Bschlcr', 'LucienBorcl', 'Brunncngaffc', 'Niederdorf', 'Bel', 'Spcichcrgasse', 'Fliege', 'Wien', 'Cratat', 'Brodback', 'Nenengasse', 'Steinmann', 'Ratzenberg', 'MSli', 'A.L.Mattez', 'Kclergassc', 'Haller', '- rechtigkeitSgasse', 'Ausland', 'Spcichcrgassc', 'Wtw.Monnier', 'Ke', '- vanneS', 'Rickli', 'Hngelen', 'Allenlftcn', 'Neuenburger-Seen', '- zogenbuchsee', '- baum', 'EiSgebirge', 'Ofen', 'Ablentschen', 'St. Lauterbrunnen', 'RohrmooS', 'VillarS', 'Gcrmaiu', 'St. Btschelcck', 'Jegensrorf', 'Nicdcr', 'Wittigkofen', 'Aarbcrgcrgaffc', 'Bonjour', '- tigkcitsgassc', 'Portner', 'Trubschachen', 'Lenzn', 'Jselin', 'Geibhlcr', 'Sd', 'Schrmli', 'Rtte', 'St. Reitweg', 'Schauplatzaasse', 'Voralpen', 'Holzach', 'Holligenfchlo', 'Bzingen', 'Lnggaffe', 'Lngmauer', '- pfen', 'Wieland', 'Grcllingen.41', 'Reggis', 'KramgasseNr', 'Lemairc', 'Aubonne', 'Zr', 'Strae', 'Gntnee', 'Markig', 'Hintcrgiebelcck', 'Brunncngasft', 'Zumbrunnen', '- keitSgaffe', 'Znsclcin', 'Althaus Jakob', 'Mnchcnbuchsee', 'Niki', '- landes', 'Kandergrund', '8udeng', 'Pastetenbcker', 'Tufli', 'Neiicnstadt', 'Wildenstein', '- soldingen', '- zcnegg', 'Wuhlbezirk', 'Sonvilliers', 'Rohrer', 'Maulbeerbaum', 'Nvrar', 'Obstberg', 'Roms', 'Brodhuschcn', 'Brunucugaffe', 'Metzg', 'Leuk', 'Hallcr', 'Schmcinbrunncn, ', 'Schlipfen', 'LeberbergeS', 'Lngga', 'Bbend', 'Schoncgg', 'Vrunnengassc', 'Tra', 'Oberoens', 'Gutenburg', '- fingen', 'Ly', 'Schiippach', 'Zabe', 'Lom', 'Buchen', 'Biktor', 'Hafner', 'Griengrube', 'WalperSwyl', 'Bchsenfchmied', 'Quiquercz', 'Schtzcnmatt', 'ZumbrunnhauS', 'Kirchg', 'Iunkerngaffe', 'Bicocca', 'Junkcrngasse8Nr.183', 'Hammerschmied', 'Josua', 'Wstenbach', 'Luginbbl', 'Schaffhauscn', 'Metzgergafse', 'Bren', 'KnigSfelden', 'Lhelffh', 'Hcimberg', 'Oppligcn', 'Langga', 'Slbbl', 'Bruunengasse', 'obere Enge', 'Westindien', 'Geistkirche', 'Zumbach', 'Brunncugassc', 'Handenschild', 'Sigg', 'Kelcrg', 'Tuch', 'Brpbach', 'Bcndicht', 'elp ensecundIi', 'Inselgasse', 'Krakau', 'Allmendingen', 'Berchtbold', 'Etienne', 'Riedstatt', 'St. Belpberggipfel', 'Aarzichlibad', 'Uebyngen', 'DieSbach', 'Wolfci', 'Couch', 'Poschenried', 'Nieder Peter', 'St. Zweiltschcnen', 'Steiner', 'Kappelisacker', 'Morcau', 'Korn', 'Sinncr', 'Khli', 'Kirchgassc', 'Sarbach', 'Lochbruck', 'Simmenthaler', 'Berg', 'DicmerSwyl', 'Wcycr', 'Subigen', 'Breiten', 'Thcol', 'Lehrsatz', 'Keler', 'Kafichgchen', 'Aeschlimann', 'Vichmarkt', 'Lehlibad', 'Blindenbach', 'Schweizern', 'St. Trmmelbach', 'Fayence', 'Ravylsee', 'Wvllenspimicrci', 'Leuch', 'Siebenpfeiffer', 'Martin', 'Mllinen', 'Jost-Biffard', 'Brunn', 'Riedgasse', 'Wiedmer', 'Brnnimann', 'iel', 'Lindenthal', 'St. Ablentschen', '- Zoire', 'Untertbor', 'Schremer', '- gcrgasse', 'ZcugbauSplatz', 'Eggli', 'Lscher', 'Gticrlger', 'Brckfeld', 'Drstetten', 'Kclcrgassc', 'Lutstorf', 'Gottlicb', 'lach', 'Kelergassc', 'Conr', 'Abraham', 'Rsti', '- menzind', 'Frci', 'St. Erlcnbach', 'SalviSberg', 'Schppach', 'Sommerleist', 'LanS', 'Bhlcr', 'Jnselein', 'Ziehlebach', 'Zlarberger', 'Burgdovf', 'Dcllcnbach', 'St. Hasle', 'Junkcrugasse', 'Niederwangcn', 'Spiralg', 'Grellin', 'Jucharten', 'Lemann', 'Flugbrunnen', 'Orvin', 'Limpach', 'Reidenbach', 'Zcughansgasse', 'Wohleyberg', 'Wicdlisbach', 'AcgelmooS', 'Oclmhle', '- teregg', 'Allimann', 'Plainpied', 'Germanu', 'Fubokc', '- gnelegier', 'Engegter', 'Aarufer', 'Duzcr', 'Lerzog', 'SalzbchSlcin', 'Buchmann', '- mcnthal', 'Marfeldingen', 'Perront', 'Pruutrut', 'Zenghansgasse', 'Saignclegier', 'Schauplatzgasic', 'St. Sdel', 'Parrat', '- berg', 'Schreiner', 'Groenbacher', 'Schpbach', 'Sulgeneck', 'St. Blumensteinkirche', 'Ntz', '- kercn', 'Baseler', 'Canivet', 'Aarbcvgcrgassc', 'Burgund', 'Klopfcnstcin', 'Oberlindcn', 'Sphtig', 'Salomea', 'Schauplagasse', 'Klsterli', 'St. Laupen', 'Gercchtigkcitsgasse', 'RusiSwald', 'Anten', 'Gpiez', 'Win', 'Gerechtigkeitsgaffe', 'Sennhtte', 'Siebenthal', 'Wintereck', 'Egg', 'ZeughauS gasse', 'Badeigenthmer', 'Weienburg-Bad', '- laubc', 'Hachen', 'Schweinmarkt', 'Schwaben', 'Gcbrd', 'Schaufelbhl', 'Dentenberg', 'Bcrgolder', '- bergSweg', 'Niedcrbtschcl', 'St. Spietz', 'Rcggisbcrg', 'Kelcrgasse', 'Delsbcrg', 'Choiffcusc', 'Blonav', 'artmann', '- brunnen', 'Brunnq', 'Gtschmann', 'Metten', 'Dtroit', 'Corgemont', '- Marktg', 'Thcurillat', 'Lder', 'Herzogen', 'end', 'Wiegsam', 'Th.', 'Weienbach', 'Buntschibad', 'Slarbcrgcrgaffe', 'Montillion', 'Brnnngaffc', 'Gri', 'Murtc', 'Schlli', 'Leuthold', 'Untersten', 'rlacken', 'Ebenist', 'Freiheitsbaum', 'Kleinwabern', 'Seide', '- soldingcn', 'Krhenbhl', 'Unter', 'Sonbcval', 'Slarbergergaffe', 'Bcndlcht', 'Lcntulus', 'Dicbach.41', 'Montfau', 'anchPin', '- melan-DessouS', 'Nppcr', 'Stockhorngipfel', 'Adel', 'Gcrwer', 'Gletscher', 'Mad', 'Sdercn', 'Zbinden', 'Gradey', '- Rosen', 'St. Courtclary', '- lcrgasse', 'Schohalden', '- Liese', '- see', 'Sommer Peter', 'Schwab', 'Zlarbergergassc', 'Rcnhans', 'Grondonaz', 'Neubrck', 'Kfichg', 'alli', 'Jaselholz', 'Hun', 'Meyringcn', 'Kehrhuschen', 'Ebersold', 'Bchsenschmicd', 'Langenegger', 'Spitalgaffc', 'Schnt', 'St. Sennhtte', '- Strtlingen', 'Glovelier', 'Herren', 'Allhaus', '- ringcn', 'LangloiS', 'Niedcrstmmenthal', 'Krcuzg', 'Freudenreich', 'Nordost', 'Strttlingerberg', 'Prntenw', 'Dnbach', 'Lthi', 'Mnstngen', 'Bierhbeli', 'BlmeliSalp', 'Niedcrsimmenthal', 'Altenberadrittel', '- boden', 'Kramgassc', 'Nieder', 'Knsch', '- gasse8', 'Znberbhler', 'Oberstekholz', 'RathhauSplatz', 'Gch', 'Stkli', 'Jmbodcn', 'Lloines', 'St. Saphorin Hudcn', 'Grundh', 'Nikl.Soltcrmann', 'Sorne', '- und Niedersimmcnthal', 'Oeschenbach', 'Bohard', 'Schlo', 'Bantiger', 'St. Oeschbcrg', 'Zlarbergergasse', 'Weinnegoeiant', 'Weibel', 'Utz', '- kirch', 'Bzberg', 'Mhlcnlaube', 'Stockmar', 'Bruchenbhl', 'Brhli', 'Kriedr', 'Mctzgcrgasse', 'Brunncngaffe', 'Guggisbcrg', 'Hab', 'Zcngschinicd', 'IliS', 'Growabern', 'z.weienRo', 'Brodbcck', 'Casino', 'Oeschinenthal', 'Nttcr', 'Gncrvain', 'Ortbach', 'Erlachs', 'Trachtbach', 'Burgderf', 'Gelter', 'Durisch', 'ZeughauSgaffe', 'nrdliches', '- Teuffelen', 'Svitzlaube', 'Ortschwaben', 'Slarbergergasse', 'Pestgasse', 'Btzberger', 'GcrechtigkeitSg', 'Flachmaler', 'Rschcgg', 'Wcrren', 'Kc', 'Rothgerber', 'Grimselstrae', '- tigkcitSgasse', 'Bafel', 'GercchtigkeitSgasse', 'Werth', 'G.Borel', 'Cour', 'Gli', 'Spychcr', 'Krhcnbhl', 'Aarbergergassc', 'Rothcnbbl', 'St. Tracht', 'Lombach', 'Acschlcr', 'crg', 'Gcrechtigkeilsgasse', 'Balm', 'Zurbrngg', 'Wange', 'UYr', 'St. Fahrweg', 'Metzgern', '- gergasse', 'Schoohalden', 'Neucngassc', 'Dllenbach', 'Herzpgenbuchsee', 'Konolfingcn', 'Salpeterhtte', 'Oberrichtcr', 'Zimmermann', 'Cormoret', 'Mehgcrngasse', 'Andres', 'Grneisen', 'Wasserbrenner', 'tzolzmarkt', 'St. Stephan', 'RapperSwyl', 'Stckli', 'Wergisthal', 'Oberfimmcnthal', 'Vadlaube', 'tAiedcrbach', 'Unterstopf', 'nrdl Staaten Ruland', 'Pintenwirtb', 'Gerzensce', 'Belay', 'Altcnbcrgdrittcl', 'Badewirth', 'Tesstn', 'Schlup', 'Zrchersees', 'Montcusen', 'Grner', 'Kubli-Joost', 'Mctzgcrgaffe8', 'Metzgcrugassc', 'Ltschenthal', 'Zcnghausplatz', 'Niedergurzelen', 'Kelcrga', 'Bichsel', 'Tellenburg', 'Rm', 'Freibergen', 'Ritzenbach', 'Unteres', 'Kallnach', 'Weber', 'Mller', 'Grcycrz', 'Schwarz', 'See', 'Btscheleck', 'Henzi', 'Hospclmatte', 'Wildbolz-Lutz', 'St. Aarwangen', 'Rfenacht', 'Pl', 'Distelzwang', 'Bubenbergsweg', 'Reit', 'Rtti', 'Rued', 'Steinalp', 'Rthenbach', 'BrggfeldwirthShaus', 'Kirchet-Hhe', 'Kb.gr', '- lingen', 'Regsbach', 'Olttgen', 'Jttingenau', 'BachhuSchen', 'Lnggadrtttel', 'Obcrfcld', 'Schund', 'Benedikt Schwyzer', 'Badlaubc', 'Zrcher', 'Bm', 'Nufli', 'Belleve', 'Weltmeers', 'Oeager', 'Lsinggadrittel', 'HormatSgasse', 'Rothgerbcr', 'Ger', 'Lwen', 'Alex', 'Wylcr', 'Rebert', 'Schwarzhrn', 'Wciermannshaus', 'Peterlingen', 'Nagelschmicd', 'Kleinmetzgermstr', 'Scheidegger', 'Gammen', 'Grningen', 'Zenghausgaffe', 'Delarenfrille', 'U.b', 'Stcinhaucr', 'Stulzen', 'Obrecht', 'Auerschwand', 'Bourguignon', '- strae', 'Brunneugasse', 'Mander steg', 'Treiten', 'Gerberngraben', 'Lieut', 'St. Voltigen', 'Bschlin', 'Neucng', 'JuN', 'Hinterurweid', 'Obcrthor', 'Bubenbcrgsrcin', 'Bure', 'Aellig', 'Bhmen', 'Spital', 'Spitalgassc', 'Berge', 'Schweingruber', 'Rothgiccr', 'Weid', 'Wettach', 'Schluep', 'Schmarrcnbach', 'Freicnhof', 'Ke lergassc', 'Neuengasse8Nr', 'HirS', 'Schnenbhl', 'Bdeli', 'Btz', 'NcuhauS', 'Gypser', 'Walke', '- lauralp', '- chenthurncn Mhlegraben', 'Schattenseite', 'Schnster', 'Stierlgcr', 'Brechbhl', 'Tanne', 'Zninstci', 'Straberg', 'Willimannsacker', 'St. Kalksttten', 'Blesch', 'Nolli', 'Obcrbtschcl', 'HnigerShauS', 'Brnnngasse', 'Mttcli', 'Telsberg', 'ZeughattSgasse', 'Mailand', 'Stein', 'Gereebtigkeitsg', 'NidaU', 'Rmlingen', 'Tschugg', 'Runf', 'Metzgcrgassc', 'St. Gstaad', 'Pfingsten', 'Znrbrugg', 'Nyfeler', 'Slraburg', 'Wyloch', 'Mau', 'KantonS', 'KienerSrti', 'Berghohe', 'Metzgerngassc', 'Aarbcrgcrgassc', 'Utzi', 'Lobsigen', 'Signav', 'Nydeck.1.832', 'Langnav', 'Sood', 'LansRubin', 'St. Langnau', 'Rothacher', 'Deka', 'St. NiklauS', 'Nikolaus', 'Ncncngasse', 'Langenkhal', 'Krgmgasse', 'Zwiebclng', 'Lchligut', 'Sommerhausbad', 'Pieren', 'Loser', 'St. Aarberg', 'Lthi Peter', 'Brienzerfee.I', 'Salzmaun', 'Speichcrgasst', 'Hbcrnbad', 'Brunuengasse', 'Ridau', 'Kapp', 'Zollbrcke', 'Mnsters', 'Schmied', 'Metzgcrngasse', 'Marktgaffc', 'Schnceberger', 'Schappuis', 'Gmmenen', 'Zeughausga', 'Cerlatez', 'Zweiltschinen', '- Dicsbach', 'Schwarzcncgq', 'Jndengasse', 'Zegrich', 'Wagner', '- Brunngasse', 'Garn', 'Zcugbausgasse', 'Lrachselwald', 'Gcrechtigkeitsgasse', 'Saagcr', 'Milden', 'Jnnkerng', 'Nicdcrhuscr', 'derFrick', 'Ncuengassc', '- undSimmcnthal', 'Stadthaus', 'Sterchi', 'Waltri', 'Spitalga', 'Mnchenbuchsce', 'Ebcnist', 'Kemmeriboden', 'Wafferbrenner', 'Ncucngaffe', '- gauerstrae', 'berg', 'Zaugg', 'Jsaac', 'Howald', 'Wylergut', 'Aarberger', 'Weinnegotiant', 'Metzgerngaffe', 'Bleyenbach', 'Schloberg', 'Thun-Gschneit', 'MooSseedorf', 'Drig', 'Kirchbcrg', 'Baumgart', 'Aarbcrgcrgaffe', 'Lnginbnhl', 'Mhlcberg', 'Btzingen', 'Belljeau', 'Alpenseen', 'Holz', 'Konrad', 'Keltberg', '- Lauterbrunnen', 'Mstgglein', 'Schauplabgasse', 'Aarziehli', 'Bohren', 'Zakob', 'Su', 'Borte', 'Bach', 'Schmiedmstr', 'Gcrcchtigkeitsgasse', 'Meiringe', 'Zordan', 'Rthlisberger', 'Denkstein', 'Gipser', '- wylgrats', 'Ebenso', 'Lng', 'Mittaghorn', 'Blumenstcinbad', 'Christen', 'Hchstetten', 'Mhledorf', 'Schauplapgaffe', 'BraiS', 'Enge', 'ZeugbauSgaffe', 'St.', 'Gerbergraben', 'Ricdstatt', 'Nicolet', 'Stcffisburg', 'Wybach', 'Pintcnschenk', 'Nasbaum', 'Ocschinenbrcke', 'Knigsfcldcn', 'Mllerlaube', 'Dellenbach', 'Steiger', 'Lcodegari', 'Gttlich', 'Napfgipfel', 'Brcleu', 'Gerechtigkeitgasse', 'Eggut', 'graben', 'dleuengasse', '- sengipfcl', 'Jnnerschwand', 'rechtiqkeitsgasse', 'Schiltwald', 'Ostermontag', 'Ks', 'Nagelschmied', 'Mnsingen', 'Saumel', 'Billette', 'Bratschi', 'Brne', 'Pest', 'Habstetten', '- ried', 'Wengercn', 'Obergurzelen', 'Jnsctgasse', 'Mhlhcim', 'Benteli', 'Stauffer', 'Lang', 'Bottigcn', 'Trogenried', 'GerbernkaubeNr.145', 'yi', 'spergcr', 'Zo', 'Suld', 'Bomattschachcn', 'Zcizziwyl', 'Brcchbuhler', 'Pruntrut.', 'Martini', 'Lohncr', 'Hdeli', 'Zwci', 'MettlcN', 'Langcnthal', 'Mllcrlaube', 'Porrentruy', 'Stern', 'Pintemvirth', 'Kfer', 'Schl-fli', 'Montbenay', 'Reucr', 'Oberjaun', 'Brnnncngaffe', 'Mhliinan', 'Flhlen', 'Siehe', 'Krhenbhlleist', 'Schohaldendrittcl', 'Sselimatt', 'Lnggadrittcl', 'Voyebeu', '- gasse', 'Ring', '- Frutigcr - Emmenthaler', 'Finot', 'Zeughansplatz', 'Ochsen', 'Marfort', 'Bnbcnbcrgs', 'Nlarktgassc', 'Wber', 'Sitten', '- fenbach', 'Altenbergdrittcl', 'Viel', 'Thu', 'Bossardt', 'Mebgergasse', 'Knait', 'Piqucrez', 'Oestreich', '- thurn', 'Fuweg', 'Vincen', 'Steinberg', 'Noiremont', 'Lutcrnau', 'Lnschberg', 'v.Burg', 'Mestral', 'Savoycn', 'Schmid', 'St. St. Ursannc', 'ZrcherinBuchcn', 'Mohren', 'Drrmhle', 'Thomann', 'Narbergcrgassc', 'Peter', 'Gmmclwald', 'Grimselspital', 'Gasel', 'St. Thuner', 'Lcga', 'Riesen', 'Hgelland', 'St. Murgenthal', 'Sternen', 'Frankhauser', '- rcchtigkeitsgasse', 'Gcrechtigkeitsgaffe', 'Kinkelin', 'Merlingen', 'Giebach', 'Zoux', 'Buert', 'Riggisberg', 'Sam Karl', 'Waldegg', 'Blankenburg', 'Letzwyl', 'St. Vorderurweid', 'Stolzen', 'TrtliS', 'Belvedere', 'Thurbachbad', 'Altcnbergdrittcl', 'Bielersec', 'Neschlcn', 'Post', 'Lffel', 'Hindeibank', 'Pestalozzi', 'Judcng', 'zgasse', 'Tavcl', 'Diligcnce', 'Nderswylcrfcld', 'Rosengarten', 'Gcrcchtigkcitsgasse', 'Kstggl', 'Zollikofcn', 'Samuel', 'Lombardei', 'Wyachengraben', '- genbcrg', 'Gpitqlgaffe', 'FreiburghauS', 'Hasenbrunnen', 'Kernen', 'Stoo', 'Lienhardtz', 'St. Beaten berg', 'Wagner Vrunnengasse', '- bcrg', 'BuchserVe-Zurbrgg', 'JonaS', 'Lttisbach', 'Kandcrbrcke', 'Schafroth', 'Aarbrcke', 'GroSzean', 'Dnki', 'Fuhrweg', 'Ried bad', 'Tschiffeli', 'Vrunng', 'Breitfeld', 'Nudel', 'Niederstmmenthal', 'Lehnsdorf', 'Zurbrgg', 'Metzgcrg', 'Weicnburg', 'Holligcndrittcl', 'St. Bielcrsee', 'Neuenschwander', 'Straacker', 'Nffcnacht', 'St. Klus'}",2072,"{'Buben', '', 'Beim Hasenbrunnen Gipfel', 'Strki', 'Schnegg', 'Leberberg', 'Lan', '87t', 'Bannwärt', 'Madiswyl', 'Strumpfweber', 'Bern St St Ursannc', 'Lasen', 'St. Sch', 'Lindenhof', 'Röthenbach', 'Thuncrsccs', 'Graben', 'Gambach.', 'Grnner', 'Adler Langnav', 'Zngold', 'Ge', 'Kvlliken', 'Kniebrechen', 'alden', 'Dürrenroth', 'Seftigcn', 'Lerren', 'Xaver', 'Bure Langenthal', 'Doldenhor', 'Wallisergrenze', 'Stubenschreiber', 'Belpberg Kirchdorf', 'tcnbode', 'Unterwattenwyl', 'Jenner', 'Senenfluh', 'BielcrseeS', 'Nudelf', 'Banjormas', 'Btz dem Ober', 'Herzog', 'Chaluat', 'Guigucr', 'Gygax', 'Reggisberg', 'Iudcn', 'Brtst', 'Metzgergassc', 'Nydeckkirchc', 'Müllcrlaube', 'Hauenstein', 'Mailand Italien', 'Jnsclgasse', 'Lünerthal', 'Dicßbach', 'Oberstlieutenant', 'Weienburgbad', 'Lrtscher', 'BrüggfeldwirthShaus', 'Tillicr', 'Kunzlcn', 'Mettlen', 'Wilard', 'Oberaintmann', 'CluS', 'Nr Käser Krämer Kramg', 'Strub', 'Alpenkette', 'Bern Parrat', 'Eidgenöff Kreuz', 'Sger', 'AltrathShcrr', 'Lanqnau', 'Pcterlingen', 'Saxetenthal', 'Stry', 'Milano', 'St. Jmmerthal', 'Pfisternwirth', 'Sonnenseite', 'Boücourt', '- miswald', 'Altoberamtmann', 'Hak', 'Brggfcld', 'Signau Simme', 'Hilterfinge', 'Brienzer', 'Thann', 'Rlggisberg', 'Oberbhl', 'Chopard', 'Poschenried St Sennhütte RusiSwald', 'Lcistabwarl', 'Traufhöhle', 'Pulvermagazin Staldcn', 'Oschivaiid', 'Altrnbcrg', 'Rudols', 'Emmen', 'Belle-Rive', 'Bähler Bend', 'Regicrungsstatthalter', 'Luttwyl Su', 'Lerzogenbch', 'Limpbach', 'Folterthurm', 'Kaminfeger', 'Rssel', 'Kelerg', 'Gerechtigkeitsg', 'Mlincn', 'Spiialg', 'St Lenk St Rennfluh Fluh Untere Stierlügcr Obere Gticrlüger Ravylsee Höhe', 'Moussclinehändler', 'Kcßlerg', 'Schvßhaldendrittel', '- kerngasse', 'Stcinaker', 'Zweilütschinen', 'Brien', 'Oberbtzberg', 'Tessin', 'Schafleken', 'Nr Rohr Anna des Sigrists', 'Niederhauscr', 'St Courrcndelin', 'Obcrlande', 'Schaufelberg', '- wichtrach', 'Groweibcl', 'Drrenmatt', 'Bay', 'Kirchplatz Stift', 'Sand', 'Mur', 'Austin', 'Hindclbank', 'Ludw Gabr', 'Lnggadr', 'Hoüigendrittel', 'AmtSnotaw', 'Krmcr', 'Das Belvedere', 'Deiwyl', 'Knigsfeldcn', 'Holzmatt', 'Neuenburgersirae', '- Diebach', 'Gloor', 'Jfaak', 'Oheubcrger', 'St. Ried', 'Kappenmachcr', 'Saanen Thun', 'JnselspitalS', 'Bürcn', 'Sebauplatzgasse', '- gaffe', 'Kanton Waadt Gumoens', 'Mhlencn', 'Sthli', 'Mnllcrlaube', 'Vorderes', 'Rathhauöplatz', 'Simmen', 'Koppigcn', 'Emanue', '- stn', 'Chr', 'Lotteriebureaux', 'Drogerie', 'Trüschen', 'Untcrstatthalter', '- plitz', 'Meikirch', 'St. St.', 'Mnster', 'Abr Balth', 'Carnal', 'Grimsclspital St Aerlen', 'Frz.Ldw', 'Opcrators', 'Keßlerg', 'Oberwintereck', 'Schuhmachermstr', 'ObcrgerichtSkanzlci', 'Laupen Romang', 'SFuß', 'Gercchtigkcitsgaffe', 'Judenq', 'Regenschirmfabrikant', 'Grnematt', 'Spenglermstr', 'Viques', 'Frick Spitzlaube Jnselein', 'Bujatrik', 'Stoekmar Laver Negiernngsrath', 'Krschenbrunnen', 'Baadwirth', 'Susienhor', 'Brhegen', 'Schwefelberg', 'St. Thurbach', 'Hauptstraße', 'Negot Woüenwaaren GerechtigkcitSgaffe', 'Grafenricd', 'Jnnerschwand Adelboden St Ganzen St Reitweg', 'Mhlenlaube', 'Profeff', 'bach', 'Liechti', 'Bnigen', 'Wildenmannwirth', 'Friede', 'Viehmarkt', 'Aarzielidrittcl', 'Ruille', 'NegSau', 'GmmligermooS', 'Schlossermstr', 'Grellingcn', 'Spring', 'Standesbuchhalter', 'Linden', 'Madretsch', 'Hambhl', 'WeycrmannshauS', 'Morgarten', 'Wohlthat', 'Tbal', 'Zhringcn', 'Vuilleumier', 'Jnterlacken Pfd', 'Gaicht', 'Werthmller', 'Burgbhl', 'Schlupp', 'Bantigen', 'Maisonette', 'Meykirch', '- singen', 'Glockenthürm', 'HaSlebachcr', 'Brühli', 'Altenbergvorstadt', 'Hahnenmser', 'Sdwcst', 'Grubcr', 'Str', 'St Eggenschwand', 'Jcughausgasse', 'Stadtbuchhalter', 'Messageric', 'Sllanplatzg', 'Selffslaubc', 'Salzbtte', 'Gnmeis', 'Vilctte', 'BelleFoniaine', 'Kelergasse', 'Maybach', 'KornhauSplatz', 'Donnerbühl', 'Glaser', 'Rathhaus-Gal', 'BrodicreriN', 'Eyen Gotklicb', 'Junkerugasse', 'Schwendi', 'Wachs', 'Joh Frdr', 'tschrcmcr', 'Schultheiß', 'Gasterenthal', 'Fricdhof', 'Mhleberg', 'stlberne', 'Ganguillet', 'NeuengaA', 'Fredcveanx', '^', 'Schaafe', 'Schweden', 'Schuhmaehermstr', 'HariSbcrg', 'Thal Geren', 'Schärer Bern', 'Engegüter', 'ZnBaninwollwaar', 'Fkgr Orth Franz Speziercr Gcrcchtigkeitsgasse', 'St BraiS', 'Bern Aeschlimann', 'Marolf', 'Wahlalp', 'Solothurncrstrac', 'Brünigen', 'Lehnkutscher', 'Dachsfel', 'Kirchenselektgesang', 'Schohaldcndrittcl', 'Granitstcinbrecher', 'Walkringen Rnfener Christ', '0ooFr', 'M-itach', 'Nißlcr', 'Herrenqasse', '- deckstege', 'Lausanne Neucng', 'Adlensried', 'Mattland', 'Parel', 'Schaüplahg', 'Leuenbergcr', 'Der Belpberg', 'Buchbinder', 'St. Kirchberg', 'Breuleux', 'St Oberjaun Ablentschen', 'Zäziwyl Konolsingen', 'AmrSstädtchen', 'Atuniei', 'Stange', 'Saanenlande', 'Grinsel', 'Wirthshaus', 'Leuw', 'UnterWankdorf', 'Münsters', 'Seengen', 'Brnigen', 'Balegues', 'Tscharner', 'Handeck', 'Thurgau', 'Stoos Hebamme Metzgerngassc', 'Dorf', 'Römer', 'Grenzbureav', 'Lchnkutscher', '- gnclegier', 'Vrunncngassc', 'Pintcmvirth', 'Tschien', 'Merveilleux', 'Gerbernlaubc', 'Wattemvyl', 'Narbcrgcrgasse', 'D', 'Glovclier', 'Gpitalg', 'Frsprech Marktgasse', 'SteiniSweg', 'Bernern', 'Krieug', 'Mttenberg', 'RathhauS', 'RterichSbodcn', 'Kirchgaffe', 'Emme', 'Theobald', 'Ioh', 'St von Bern', 'NydcckHöflein', 'Mühlenlaube', 'Kyburg-Habsburg', 'Trimstein', 'Dllcubach', 'Sohii', 'Ulrich', 'Mer-qergasse', 'Mummenthal', 'Bremgarte', 'Stalder', 'Meutfauceu', 'Seiler', 'Grandson JennerMüller', 'Piemont Savoyen Deutschland', 'Hehlen', 'Aalbock', 'Herrenschwand Christ', 'Wndfluh', 'Gerech', 'Brgger', 'LeS', 'Sonccboz', 'Mehgerg', 'Tfchaywo', 'Gypscr', 'Zwieselberg', 'Lngenberg', 'Ldrach', 'Frei brg', 'Zeughausgaffe Schlüssel', 'Kehrhciuschen', 'St. Zelg', 'Jun kerngasse', 'Elfcnau', 'Bttwyl', 'ZeugbausgS', 'Luginbhl', 'Balstger', 'Gcrberlaube', 'Gndhardt', 'St Michelsthörli', 'Aegcrten', 'St Johannis', 'LeimiSwyl', 'Manche', 'Lütsche', '1oroorie', 'Bantiger Bantiger', 'Altenbergstrae', 'Lenk St Senenfluh', 'Grindelwaldgletschcr', 'Brunucngasse', 'St. Wciffenburg', 'Rmligen', 'St Tosten St Rüm', 'St. Altstaffel', 'Joo', 'Grimselhöhc', 'Centralpolizeidirek', 'Kcilbach', 'Tischg', 'Ril', 'Leinwandbandl', 'Rli', 'Lombachthurm', 'Niederlindach', 'Staubbachhhe', 'Ricdgrub', 'Nencngassc', 'Guttannen', 'Steingut', 'Eisenhündler', 'Minder', 'Perer', 'Aarburg Mailand', 'Drrbach', 'Hübeli Schönegg', 'Hahnenkrat', 'St Viel St Evilard', 'Sennhütte Finsterwald', 'Neuenstadt Büren Paris', 'Schrch', 'Selüffslaubc', 'Geist-Kirche', 'Deyong', 'Am', 'Stadtschreiber', 'SoihisreS', 'Zugwyl', 'Sumpfland', 'Gserz', 'Obergoldbach', 'Seinr', 'Hrner', 'Breithorn', 'MontSseve', 'Hauseigenthümer', 'Rmlingcn', 'Bdclithal', 'KäShändlcr', 'Wiesen', 'Neleren', 'Nieschang', 'Sustcnbcrg', 'Wyß', 'Joux', 'Oberamtmann', 'Blösch Bend', 'Tirano', 'Thun Bern', '- brck', 'Gmmligenthal', 'Sam Frdr', 'Kng', 'Frutigcn', 'Bessart', 'Knig', 'St Bad Blumensteiii', 'Müllermstr Aarzieledrittel', 'Bärschcnhaus', 'Ermcl', 'Falkenplätzli', 'Kander', 'Oberrichter R', 'Schwellenmatt', 'Tes', 'Rytz', 'St Furka', 'Saanen St Voltigen', 'Schrcinermstr', 'Thun DelSberg', 'Weißenheim', 'Adelbodenthals', 'Zunkerngasse', 'Ouchy Joh Markt', 'Thierarzncischule', 'Waltrigen', 'Knabenwai', '-', 'Schwalmeren', 'MciringeN', 'Bandclier-Gru', 'Münger', 'Jammerthal', 'BürcN', 'Beljean', 'GuivernoiS', 'Buhlberg', 'Linde', 'Wattcnwyl', 'Aarbcrgergaffc', 'Gurtengebirgs', 'Dav Rud', 'Därstetten', 'St. Meiringcn', 'Eisenwerk', 'gr Straße', 'Graben kncz', 'Messcrli', 'DeleyreS', 'Blau', 'simmcnthal', 'Frz Zkaver Schneidermstr', 'Aufranc', 'Bangerten', 'Stadtbauamtkasster', 'Künkcl', 'Finster', 'Cam', 'Obersim', 'Bollwerk', 'Wäali', 'Riedstatt St Kalkstätten', 'Bergdorfe', 'Gerechtigkeitsa', 'Homlisthal', 'Straburg', 'Tedlingen', 'Mschbergcr', 'Burgcrrath', 'Alpcnkette', 'Knechtenhofer', 'Brkfeld', 'Tramlingen', 'Klopfcusteiu', 'Barbcn Alet', 'Ncncugaffe', 'Hotcllaube', 'Namscycr', 'Kurzernei', 'Kclergasjc', 'Weyern', 'Friedrich', 'Wildcrswyl', 'Biland', 'Weienburgerbad', 'Münchenbuchsee', 'Oberbottigen', 'Weißcnburg', 'linkS', 'Ncgotiantinnen', 'Marktgaffe', 'Preuen', 'Wynau', 'Obergerichtschreibcr', 'Triner', 'PeterSburg', 'Molin', 'Leinr', 'AmtSverwescr', 'Burgerspital Hasenfrah', 'Voltigen', 'Sandstein', 'Aarber', 'Ncuhaus', 'Kamon Bern', '- simmenthal', 'Pruntrut Straße St Tavannes Dachsfclden St Fünt Belay Zoux Sauley Gloveilliers St Boncourt Asuel', 'Wasen Trüßcl Sam', 'St Thun St Gwatt', 'Rütte', 'Waudsth', 'Waagmacher', 'Bern Kramgasse', 'Zorn', 'Bielersee NeuhauS', 'Spitalpromenade', 'Wahlenhaus', 'Lauterbrunnen Geich', 'Kelergaffe', 'Osten', 'Brki', 'Dünki', 'Haag', 'Lohn', 'Lager', 'Berghauptm', 'Montillion Sulgeneck', 'Trödler Brunng', 'Weiler Hochburg', 'Riedbad', 'Seckler', 'Gadmcn', 'Schönfärber', 'Kirchenthum', 'Breisgau', 'TannenneuhauS', 'Zlarbcrgcrgasse', 'Handelsstraße', 'Steinhölzli Wirthshaus', 'Sennbütte', 'Blumensteiii', 'Ankenlaubc', 'Wnbermarkt', 'Bergsirom', 'Kunsistraße', 'Uhrenmachcr', 'Ankenhalle', 'Höh Friedr', 'GuirodoN', 'Länggaß', 'Lolligendrittcl', 'Mei', 'Helisbühl', 'Wirthe', 'Schauplahga', 'Kassa', 'ZcughauS', 'Hauptm', 'Brggfeld', '- gelnjager', 'Jnterlacken Gebirgsstock', 'Mzcnberg', 'helvetischen Republik', 'Albr Sam', 'Zäziwyl', 'Aarzichlidrittel', 'Thalgut Gießbach', 'Klavperläubli', 'Gantcrisch', 'Tschingelgletschcrs Steinberg Schmadribach', 'BrodhuSchcn', 'St. Laupcn', 'selgasse', 'HandelSmnn', 'Sennhütte Boden', 'Wasen Rechen', 'Salza', 'Schallenberg', 'Metzgcrngaffe', 'Schmidwcyerbad', 'Bo', 'Statten', 'Joh.Baumgartner', 'Bern St', 'SchullchrerWittwen', 'Winzenried', 'Altenbergcs', 'Les BoiS', 'Charmoille XXII Frieden', 'Eigenöff Kreuz', 'Grohochstetten', 'Kelcrgassc', 'Stndcr', 'Flor', 'Limonadcfabrikant', 'St Habkercn', 'Jnterlacherhof', 'MädchenSchulhanscs', 'Tbun', 'Louis', 'Herrenschwand', 'Seilermstr', 'Lombach der Harder', 'Emmert', 'Nummel', 'Aug. Saiguelegier', 'Fclshörner', 'Rathhaus Sevt', 'Strahlhorn Hier', 'Jffibach', 'Kruchi', 'Kornhansplatz', 'RatbhauSplatz', 'Mattstettcn', 'Aarzichlidrittcl', 'Msti', 'St St Spietz', 'Untersten St', 'Klopfcnstein', 'Gurnigel', 'Casp', 'Mattez', 'Korbmann', 'Kumbach', 'Str St Solothur Stadt St Oberdorf', 'Bütschelcck', 'Liennv', 'RathShcrrn', 'Oberst', 'Sombeval', 'Monto', 'Büchsenschmied', 'Franziskanerkirche', 'Tempcrli', 'Stalden8Nr', 'Mnsterterrasse', 'Znsclgäffe', 'Aarbergerq', 'St. Johannis', 'W', 'Berner', 'Baumgartncr', '- bergen', 'Brumiengassc', 'Sisclen', 'Bricnzling Sulute', 'Utzigen', 'Jcnni', 'Tschanz', 'Zeitglockenthurm Zwiebelngäßlein', 'Unterscen', 'Neuen brg', 'Stnber', '- bon', 'St St St', 'Wy', 'Gysenftein', 'Pruntrut Basel', 'Leinwand', 'Wein-Negot', 'Zeh', 'Witschi', 'Postgaffe', 'Portenier', 'Obstbera', 'Rscheck', 'ESq', 'Landstuhl', 'Jcughausplatz', 'Teller', 'Preußen', 'Sollberger', 'Brttelenbad', 'Jungfrau Nickt', 'Gurtest', 'Brunncngassc Nr Werk', 'Frcieiihof', 'Fankhauser', 'Trt', 'Bellmund', 'Zrich', 'Niederbaden', 'Burkhalter', 'May', 'Amsoldingen Tschaywo', 'Saignclegier Liegt', 'Das Rathhaus', 'Ruinen Bubenberg', 'St. St', 'Tramelan', 'Zweisimmcn', 'Schlnpp', 'Faivre', 'Buchbindermstr', 'Neuengaffe', 'GerechtigkeitSg', 'Hebammcnschule', 'Grbenthales', 'Aarbergerstraße', 'Guilhicr', '- lisberg', '- ring', 'Speziercrin', 'St Oder', 'Küher', 'Münchw', 'nenbrcke', 'Simmcnthal', 'Mstggüßlein', 'Blauhaus', 'Oelmühle', 'Buchwalder', 'Comp', 'Blaser', 'Vorrathskam', 'Unterschallen', 'Mattenberg', 'Bieler', 'Krebs', 'Weienburg', 'soldingcn Poleren Sennhütte', 'D.A.Delarenfrille', 'Murrenerthor', 'Aarbergerstrae', 'Postg', 'Oberhofen', '- hausen', 'St Saanen', 'Thal Ruinen', 'Bmplitz', 'Ncucnburg', 'Meier', 'Stcgmatt', 'Basellandschaft', 'Uuterthor', 'Sumiswald Langnau', 'Marktgasse Nr Wurstemberger', 'Aarbergerga', 'Schabrod', 'Kienholz', 'Kramgasse-K', 'Rathhauplatz', 'Oberstin', 'HugS', 'DasSchloß', 'Rolli', 'Nomang', 'Niedern', 'St. Lenk', 'Kolligendrittel', 'Kantost', 'Zollbrück', 'Holziger', 'Schwclldamm', 'Lehenbesteher', 'Rieb', 'Saanenland Saignelegier', 'Jndermüble', 'Rud Jak', 'Büren Saignelegier', 'Sriswyl', '- thal', 'Kaufhause', 'I4e Zeitglockenthurm', 'Baltesperger', 'Krauchthaller', 'Tribolet', 'Zudcngaffe', 'Bellcvuc', 'Obergrindelwaldgletschcr', 'Freiburg Neuenburg', 'Wicdmer', 'Clarctsack', 'Frutlgen', 'Dietiker', 'imZehen', '- bcrnkellcr', '- dorf', 'Aarbrrgergassc', 'Sleubrck', 'Brunnengrcib', '- Marktqasse', 'Schtff', 'Pruntrut Sai', 'Ncueng', 'Sennhütte Wintereck Murren Gümmclwald Reuti St Schmadribach', 'Äiel Saignclegier', 'Brandcasscnverstchcrung', 'Joh Jak', 'Oberhasli Reich', 'Rebeuvelier', 'Grünes Quartier', 'Schneidermeister Salzmagazin', 'Kirchthum', 'Denerez', 'Fridolin', 'St. Gsteig', 'Altenbcrgbrcke', 'Nnbin', 'Ant', 'GumocnS', 'Kesslerg', 'Schwarzenbach', 'Waffenmagazin', 'Rderswy', 'Das Casino', 'Carl Ebcnist', 'Grünenbcrg', 'Neuengaß', 'Hotellaude', 'Mchenbuch', 'Peunuerats', 'Zwiebelngäßl', 'Buwyl', 'Vermeille Ank', 'Lerber', 'Feuersbrunst große', 'Fllenbach', '/', 'P.Daubalder', 'Leibundgut', 'ZcughauSg', 'Maneowitz', 'Saanenland', '- talgaffe', 'ThurmeS', 'Völlige St Habstetten', 'GurnigelS', 'Brcn', 'Solo', 'Langnan', 'Stettle', 'Kfigglcin', 'Flachmalcr', 'Mlinen', 'Jegenstorf', 'Montcbcllo', 'Burgdorf Grimsel', 'Spitalkirche', 'Mnchenbuchsee', 'Draperie', 'Schloßtrümmcr', 'Kcßlergasse', 'Mohn', 'Belle-Foniaine', 'Groggenmoos', 'St Gurnigelbad St Kehl', 'Drechslermstr', 'Grering', 'Spitalgasso', 'GerechtigkcitSg', 'Judeng Nr Mitten', 'Doubs', 'Schneidermfir', 'Bauchcr', 'Hirschgrabcns', 'Kclergasse', 'Modiskc', 'Luttwyl', 'Engcpromenade', 'Pruntrur', 'czr', 'Oberstlicut', 'wallis Suleck', 'Hchstettcn', 'Pfeffingen', 'Langenthal II', 'Iunkerngassc', 'Dittinge', 'Gicbach', 'Prting', 'Schulgaffe', 'Stephan', 'Käfiggäßlein', 'Vikt', 'Saignelegicr', 'Baumwollzeugen', 'JlfiS', 'St Sonccboz', 'KSicber', 'Badwirthschaft', 'Länggaffe', 'Weinncgot', 'Nöthinger', 'Diese Vcrsorgnngs', 'Stram', 'Neü', 'Knubel', 'Tavanncs', 'Moni', 'Bencdikt', 'czr GerechtigkeitSgasse', 'Tannenbühl', 'Helisbhl', 'ViehmarktNr', '- keitsgasse', 'Bnigcn', 'Ela', '- Reitweg', 'Nu', 'Mnsterkirche', 'Unteres Kehrhciuschen', 'Literarschule', 'Weinzäpfli', 'enbura', 'Mal', 'PoitterliN', 'Kathar', 'Allmend Wnrgler Ulr', 'franz Nidau', 'BrunnerGerlach', 'Landwirth', '3ns', 'berSumis', 'Berger', 'Schlüsselwirth', 'Bethause', 'West', 'Peri', 'Niederscherli', 'Kubitz', 'Leichcnhanseru', 'Lauenthal', 'Speiebergassc', 'Schoßhaldendrittcl', 'Jmmcnhubel', 'Heinigcr', 'Choffat', 'Altenbergdrrttel', 'Adrcffcnluch', 'Klopfenstein', 'Geör', 'Lütschine', 'Spich', 'KönigSfelden', 'Schreckhörner', 'Aarwanqcn', 'Huppererdegrube', 'St Hindclbank St Mötschwyl', 'Storchcnwirth', 'Barbier', 'StefsiSburg', 'u.nrdl.Frankreich', 'Rennfluh', 'Kostgeberiii', 'Mnst', 'Weinbandlung', 'Murzelen', 'Münchenwyler', 'Snlgcnbaeb', 'NiehanS', 'Ucbersax', 'Kfigglein', 'Lans', 'Blenstein', 'Emdthal', 'Rbsaat', 'StessiSbnrg', 'Augsburg', 'Mctzg', 'Grandval', 'Gottl David', 'Bümplitz', 'Güntlisberger', 'Konr', 'Konolsingen', 'Pont', 'Zürchersees', 'Allenlüftcn', 'Brunncngasse', 'Gurowski', 'Lzelflh', 'MontierungSvorräthe', 'Zauggenried', 'St. Stllc', 'Scidclhorn', 'Untcrschlcifen', 'Vurgerrathes', 'St. Strtlingen', 'NiklauS', 'Hans', 'St Hin', 'Meinrad', 'Jnterlachen', 'Sleubrück', 'BetthLudlcrittncn', 'Mnsterthal', 'Thunerstraße', 'Todtenackcrs', 'Routen', 'Betig', 'Ekelsrücken', 'Luternau', 'Gomerkindcn', 'Brunner', 'Amtsverwcser', 'Napf', 'Könitz', 'Maser', 'Iudengafse', 'BrunngaffeNr', 'Lcngnau', 'Leiitcrsoy', 'Andr', 'Brnig', 'Mari Wittwe', 'St Sonceboz', 'Schwanden', 'Stmpcl', 'Gilgen', 'Mctzgerg', 'Vermeille', 'Burgdorf der Emme', 'Ceutiu', 'Postgaffc', 'Bcud', 'DelSberger Thal', 'Joh Sam', 'Altenbcrgbrücke', 'Modisten', 'Goldschmied', 'Salzmagaziu', 'Kstgglein', 'Jtz', 'GuggiS', 'UndervillierS', 'Bern Vermeille', 'Acbcrhard', 'AarflusseS', 'Sainncl', 'Tschingelgletschcrs', 'Domaineninspcktor Bern', 'Speziereriii', 'Streit', 'SumiSwald Nieder', 'Bheud', 'Lauven', 'Villeret', 'Mittaaliorn', 'Werrv', 'Gloggenthal', 'Brandeorps', 'Neuengassc', 'Aarzichli', 'Hnni', 'UnderSwyl', 'Rothes Quartier', 'Klösterli', 'Aarzicledrittel', 'Gerolstngen', 'Lchnkutschcr', 'SvmiSwald', 'St St Courtclary', 'Kreuz', 'senay', 'Schpfen', 'Griebach', 'Schncnbcrg', 'Straße St Bethlehem', 'Hofstetter', 'Chri', 'Rath Jun kerngasse', 'Hochgebirge', '- thor', 'Krummstab', 'Mnchenwyler', 'Gtalden', 'Kclerg', 'HaSlethal', 'Löchligut', 'Großen Rathes', 'St Krai', 'Uoutbgou', 'Grocnbaeber', 'Metzgermsir', 'Marktgasse Nr B6rard Dav Louis Hutmarchand', 'Sai', 'GercchtigkcitSg', 'St Brodhäuschcn St WimmiS', 'Dubach', 'Vgeli', 'Sebauplatzgassc', 'Lustenberg', 'Trcl', 'Oberhofcn', 'Pcuntrut', 'Lntternau', 'TodtengärteN', 'Mhlebach', 'Aargaii', 'Glutz', 'Schwarzwasserbrcke', 'Siltbrunn', 'Lnggadrittel', 'Ackermann Ank', 'Ncuenftadt', 'Montier Flecken', 'Picmont', 'Untersten St.', 'Lehenmann', 'HortiN', 'Zwingelhof', 'Kruoüstsin', 'Hirsbrunner', 'Riggisberg St Hintcrgiebelcck', 'Junkerng Nr Tscharner', 'McyclSgrund', 'Gallen', 'Neuhaus Bla', 'St Könitz', 'Meningen St St', 'Schnfrber', 'dlarbergcrgasse', 'Scheid', 'Rörswyl', 'Mchgcrgasse', 'Gartenwärterin', 'Ncllstab', 'Niederbtschel', 'Kißling', 'Glovelier St', 'Knitz', 'Tiornollaz', 'Klopfensteiu', 'Eisenhandelsmann', 'Gebrd', 'Haslerberg', 'St Ein', 'Kfichglein', 'Jenzer', 'Küblisbad St Fahrweg', 'Regierungsratb', 'St Fahrweg', 'Finsterwald', 'Bätlerkinden', 'Klaviermachcr', 'Utzlgcn', 'Menth', 'Jhi', 'französ', 'Amtsnolar', 'Pruntrut Marti', 'Grünenberg', 'Ludw Gottl', 'Sattler', 'Miocourt', 'Hrn Ostcrrieth', 'HolligcndrittelsChoisi', 'Altenbergd-rittcl', 'Zug', 'Amstutz', 'Ktzing', 'Zollikofcn DicmerSwyl', 'St Holzach St Adelboden St Reitweg', 'Ncncugasse', 'Wasen Köhler', 'Dachsfclden', 'KönigSfclden', 'Käfiggäßl', 'Moscr', 'Obcrschaffn', 'Chalomell', 'Wyden', 'Loh Em', 'Käs', '- Neuengasse', '- gaffc', 'Schoren', 'Pintenwirkh', 'Wochenmarktbuden', 'Mumatte', 'Graffenried', 'Badanstalt', 'Gerberlanbe', 'Oele', 'Gäst', 'Bärenfels', 'Schloß Wyl', 'Zähringen', 'Tromwyl', 'Obergerichtsweibel', 'Walkmhle', 'Neukom', 'Schrer', 'Klei', 'St St Bachsee', 'Sausbachbrcke', 'Kachelmarkt', 'Schreinermstr', 'Aarzieledrittel', 'Grnbcr', 'Bubenseeli', 'Schaalgäßlein', 'Saaneflu', 'Jscltwald', 'Brunnen', 'Wendelstein', 'Tuchschercr', 'Frau Lands', 'Walterswyl', 'Erlacherhof', 'Neuen', 'Haus Haus', 'Vurgdorf', 'tzi', 'Neqot', 'Sumatra', 'HandelSin', 'Drrenroth', 'Bühl', 'Pleigne', 'McchanikuS', 'Dttwylcr', 'Zofingen', 'Bleien', 'gie', 'Obcrscherli', 'Frz', 'Küfermstr', 'Columban', 'MooS', 'Acugschmied', 'Sui', 'Brandvcrlusre', 'Biimplitz', 'Schuhmachermcister', 'Daulte', 'Viescherhörner', 'Gerechtigkeirsg', 'Salstsberg', 'Sonnseite', 'Leindotter', 'Burglaucnen', 'Garnier', 'Zlarbcrgergasse', 'Lauenthal Laufen', 'Keßlergasse', 'Cornol', 'Mattcn', 'Gstcig', 'Bremgartenanlage', 'Meyer', 'St Schwarzenburg', 'Graubünden', 'Sustenpa', 'Ltschinenthal', 'Frisching', 'Buri', 'Aarziclithor', 'Wcienbach', 'Brückfeld', 'Salm Spätjahr Lachs', 'Schttepromenade', 'Aarberg Aarglet', 'Aar bergergasse', 'Musigen', 'Dnz', 'Bernschuh', 'Thunerscc Besttzt', '- kcitsgassc', 'Standcskaffier', 'Dragoncrmajor', 'Handlungsschule', 'Gwatt', 'Kiling', 'Liesberg', 'simmenthal', 'Ven', 'Gspaltenhorn', 'Postwagner', 'Rleuuiiig', 'Pastetcnbck', 'Wallnuß', 'Lebenmann', 'Belp St Heiteren', 'Kclergaffe', 'cii', 'Lcuenberger', 'Ta', 'Zyrv', 'Lauterbrunnenthals', 'Zürcher Zoh', 'Cugnotee', 'Gemeinderath', 'Neueng', 'Trb', 'Kirchdorf', 'Konolftngen', 'Fuhrmann', 'Die', 'Ksichglein', 'Oberster', 'Uarieots', 'Marmorlafcln', 'Mnster.', 'Gehaffhausen', 'ValeyrcS', 'Neuenstabt', 'Verdat', 'Bcrgelbachbrücke', 'Zcnghausgassc', 'Schöne', 'Challandes', 'Bubenbergs Weg', 'ZenghauSgasse', 'Thonen', 'Neuenstadt Joneli', 'Ainade', 'Lände', 'Schenswerther', 'Nud', 'Fabr', 'Gasthof', 'Nydcck', 'Nydegger', 'Nenengassc', 'Maimonats', 'Schiffländi', 'Weinhändlcr', 'Reuchenette', 'St Saphorin St Saphorin', 'Zziwyl', 'Breitenrain', 'Frciberg', 'Heimenhauscn', 'RathhauStcrrasse', 'SchadaU', 'Effinger', 'Ravyl Renan', 'Turnanstalt', 'Jndienncdrucker', 'Bumplitz', 'Jonquisre', 'Wettcrhorn', 'Thierspital', 'Schoohaldendrittel', 'lauralp St', 'Kblisbad', 'St. Stockhorngipfcl', 'Tschaywo', 'GroSjean', 'Hestvyl', 'Eurer Commis Junkerng', 'Wachmann', 'Mittholz', 'Steg Eggimann', 'Leichcnhäuscr', 'Gerechtigkeitsgasse Krone', 'Lolligen', 'Galgenhbeli', 'Vom Schlosse', 'Wterich', 'Fontenois', 'Sefligen', 'Grnenberg', 'Zoh Jak', 'Judengassc', 'Zweilütschencn', 'Braun', 'Spätobst Mostobst', 'Fnt', 's3i St Wyl', 'Brunnengaffe', 'St Saphorin Hudcn', 'Gcrcchtigkeitsgassc', 'Rechtsagcnt', 'Rtz', 'DiehölzerneBrückc', 'Fliickiger', 'St Kehrsatz St Ruinen Aegcrteii', 'Parts', 'Germann', 'Neuenburg Erlach', 'Zweistmmen', 'Eticnne', 'Zinngießer', 'Altcnbcrgdrittel', 'St Stockhorngipfcl St Thun St Allmendingen', 'Fellenberg', 'Leuiv', 'Kantiniäre', 'Feilcnhaucr', 'Edelhirsche', 'Welse', 'Obersimmenthal Berg', 'Nderswyl', 'Blumenstein St', 'Büren Aarbrücke', 'Grnenbcrg', 'Steiger ebendaselbst Denkstein', 'Grindelwald Fahrweg', 'Thunerstrae', 'Ruinen', 'DÜrrenroth', 'Nr Pulver Albrecht', 'RathhauSterasse', 'C.Llidw', 'Ant Ludw', 'Münsterplatz Kirchplatz', 'St. Maikirch', 'Dauben', 'Bieri', 'Naillard Negotiant', 'CarnicS', 'Lngen', 'Gchwemmetzger', 'ReconvillierS', 'Belletruche', '- burg', 'Steinern', 'Jscli', 'Bierstübli', 'Gtcinhauermstr', 'Marklgassc', 'Ferd', 'madrid', 'Bergstrom Oberland', 'Chriencn', 'Wein', 'Rud Kricdr', 'Graubnden', 'Netar', 'Ginggen', 'Siselen', 'Schwar', 'Waadtlande', 'Pieterlen', 'Niedersimmenthal', 'Stander', 'St. Thurbachbad', 'Judengaff', 'Lüsel', 'Grnen', 'Saane', 'Latterbach', 'St Peter', 'Thun Fahr', '- und Untcr', 'Oberwangen', 'Weyermannshaus WiegsaM', 'Wirth', 'Slockhornkettt', 'Zsenschmid', 'Elrichsricd', 'Lbeck', 'Lsrolss', 'Jschi', 'Artillcriehauptmanns', 'Feuerspritzenmagazin', 'Spi', 'Aspalt', 'Sveicherg', 'Nikl Frdr Beruh', 'Hegg', 'Blumen', 'Zollstätte', 'Aarbergcrga', 'Bern Stockmar', 'Frd', 'Lautcrburg', 'Gaber', 'Brcnfuh', 'Ostcrmundigcn', 'Poftgasse', 'RderSwyl', 'Jngelram', '- senay', 'MustklehreriN', 'melanDessouS St Rußille LeS Cerlatez St Saignelegier Flecken Schangnau Fuhrweg St Hcimberg St Stcffisburg Schwar', 'Jabcrg', 'Renan', 'Oberricd', 'Buntschi', 'Bnningen', 'Kdereggen', 'Lsel', 'Blankcnburg', 'Job', 'Frz LLw', 'Weibcl', 'Vicekönigs', 'Zlbraham', 'Schneidcrmstr', 'Aarbergcrgassc', 'Sinneringen', 'Grindelwald St Wergisthal St Sennhütte Alpigeln St Sennhütte Busti', 'JsenschmidBay', 'Diligence', 'Schncgg', 'Kclcrgasse', 'Reuge', 'Furenrain', 'Struchen', 'Twinghcrren', 'Jgnace', 'Spczierer', 'Rederswyl', 'Brenbcrg', 'Ublancnofstzicr', 'Geiftkirche', 'Orvim Les PrsVaillonS', 'lingen', 'Ktrchhöfli', 'Zllbrccht', 'Neichcnbach', 'Elisc', 'Gemscnflüh', 'Schncidermstr', 'Speziererili', 'Neuenegg Brücke', 'Hondrich', 'Regg', 'St. Schmadribach', 'Chasseral 4sso', 'Busti', 'Frieden', 'Nods', 'Rüderswyl', 'Bern 3voo', 'WeißenburgBad', 'Ank', 'St. Ursitz', 'Bruuncngasse', 'ZcnghauSplatz', 'Oeltrotte', 'Krähenbühl', 'Zeugbansgassc', 'St Ursitz Str St', 'Walkringcn', 'Batzen', 'Nöthlis', 'Sennhütte Chriencn', 'Konstanz', 'Ochse', 'GcrcchtigkcitSgasse', 'Weiler Deißwyl', 'Landeck', 'Unter-Wankdorf', 'Thunftetten', 'Laden', 'Rderswyl', 'Noterminirte', 'Tannerboden', 'Käfichgäß', 'Holland', 'Sommer', 'Brtschi', 'Schrcr', 'Hermeringen Bellmund Nidau', 'Triest', 'St. Zolltkofen', 'Miebael', 'Brodbck', 'EriS', 'Obcrspictz', 'Bitzius Alb', 'KornhauS', 'ILmpsrour', 'Flckiger', '- lande', 'Nydcck-Hflein', 'Thalgutbad', '/ Bad', 'DequerviN', 'teregg', 'Rütihübcli', 'Blutthurm', 'Mctzgcrg', 'Aarwangcn', 'Mont', 'Bubenbergswcg', 'Jolimont Erlach', 'Messa', 'Raps', 'Bipp', 'Seiden', 'Schmadribach Schmidwcyerbad', 'Castnoplatz', 'Harnischthurm', 'Aargauer Stalden', 'Growabcrn', 'Spcnglermstr', 'TerrassesamtPa', 'Pferret', 'Landstraße', 'Mcyringen', 'Kcnzi', 'Rothhorn Jnterlacken', 'Aarberg Frotb', 'Seignelegier', 'Grohchstetten', 'Schweinmetzger', 'Aarbcrgcrg', 'Melchenbhl', 'GercchtigkcitSgasse', 'Neinhart', 'Rubens', 'Schcrler', 'Lütschene', 'Trmmelbach', 'Guttanne', 'Gerbcrlaube', 'Rnd', 'GcrechtigkeitS', 'Schwarzes Thor', 'Kalch', 'Lozwyl', 'Krau', '- weg', 'Brunnadern', 'Zehender', '- stall', 'Leberberg Schappuis', '2rBrunngasseA', 'Bäckcrmstr', 'St Gstaad St Thurbach Thurbachbad Unterseen', 'Kir', 'Weißenburg', 'Schafalp', 'Ber', 'NüegSau', 'Oeschberg', '- wald', 'Jaggi', 'Schweizerfranke', 'Grosscnbacher', 'Schauplatzg', 'St von Meiringen', 'Allenbach', 'Elay', 'Brunnaderndrit', 'Widmcr', 'Bern.43', 'Sulgcnbach', 'Eiskeller Bern', '- bach', 'Schattseite', 'RathcS', 'Fürst Baselschen Schloß', 'Zwiebetngl', 'Metzggebaudc', 'Vorderaargletscher', 'St. Jmer', 'Altenbcrgdrittel', 'Schützenmattpromenade', 'Inner', 'Adrcsscnlttch', 'Bcnoit', 'Neußcr', 'Sennhütte', 'Schneidermstr', 'Rfli', 'Murren', 'St Vom Gipfel', 'Trach', 'Schwaab', 'St Delemont', 'Jrlet', 'Cappel', 'Kanderbrcke', 'Scheid egg', 'Bricnz', 'Häffcli', 'Aarbcrgergassc', 'madribach', 'Rath', 'Mnsingen.43', 'Joli', 'Brüttelenbad', 'Mühldorf', 'St. Minuten', 'Nikolas', 'Brienzersee Fahrweg', 'Müllerlaube', 'Trachscl', 'Lolz', 'Fcllcnberg', 'Niedcrosch', 'Solothurnerthor', 'Jnbnit', 'Tanncnneuhaus', 'Twann Äartmann', 'Diesse', 'Morgcnthal', 'Mller-Dallemagnc', 'St. Thun', 'Schweinmehger', 'Lderach', 'Fraubrunne', 'Stalden Wirthshäuser', 'Neuenburgersiraße', 'Btzberg', 'Kantonalbank', 'Lngcnberg', 'Lantcrbrunncn', 'LudwAlbr', 'Niedersimmcnthal', 'Schlosses Erguel Gpiez', 'Corgcmont', 'Oberbofen', 'Rancb', 'Angr Mcycrhöfer Gebrüder Schrcinermcister Salzmagazin', 'Mumenthaler', 'Murgcn', 'Blsch', 'Court', 'Interlaeken', 'Ebersold Elisabeth', 'Oberes Kehrhüuschen', 'St Johannes KornhauS', 'X', 'Aeckenmatt', 'Hochburg', 'Schvhaldendrittel', 'Obcrwichtrach', 'Hgli', 'Gemmi Berg St Kandersteg', 'Witkwer', 'Boret', 'Ruland', 'Dicbach', 'tNtt', 'Pfaffcrei', 'Sans', 'Gloveilliers', 'Füllenbach', 'Oeler', 'Rußland Oesterreich', 'Kostgeber', 'Grummbach', 'Joh Jak Albr', 'Elis', 'Valore', 'Salzanswger', 'Adresscnbuchs', 'St Brünig', 'Lchenmann', 'Montfaucon', 'Emmenthaleralpen', 'Schz', 'feld', 'Thunersce', 'Salpeterthüler Fahrweg', 'Schreincrmstr', 'Schoßhalden', 'Roßalp', 'Lrn.Jonquierc', 'Slübbl St Sennhütte Matten St Lauenen St St Von Lenk St', 'Gentelthal', '- stiege', 'Mhlcdorf', 'Senn', 'Kleidermagazin', 'Philosophenweg', 'Sigism', 'Hasienbach', 'Eggimann', 'Aarglet scher', 'Nicsengipfel', 'Snell', 'Neuengasse Nr Bitzius', '- lcrie', 'Rütihübeli', 'Soulce', 'Linde Elfenau', 'hausen Zürich', 'Burgdorf Luzern', 'Kien', 'Sandsche', 'Signa', 'Bubenbcrgsrein', 'Zakeb', 'Ludw Abrah', 'Bern Jmer', 'Schinznach Leuk', 'Slcrztc', 'Seedorf', 'Gypsreiber', 'Lebküchlerin', 'Nagelschmied Aug Hügney Pinlenwirth Wittwe', 'WachS', 'Mooser', 'Küentzi', 'Droz', 'St Johann', '- eigen / Plaffeyen', 'Längcnberg St Kehrsatz', 'Klosterterasse', 'Müllermstr', 'Strütlingen', 'Bierstbli', 'Freydig', 'Cafinoplatz', 'Frutiger', 'Jffwyl', 'Oberlvyl', 'Gastcrenthal', 'Hall Bernh Friedr', 'Metzgerngasse', 'Stmpfli', 'Thierstein', 'Frutigen St Nach Adel', 'SumiSwald Niedern', 'Lug', 'Mungnau', 'Dufresne', 'Zwin', 'Lithograph Kramgasse', 'Mirchel', 'Lieci', 'Alpigeln', 'St St Ueber Lauterbrunnen', 'Jak Christ', 'Oberwohlen', 'Vtzade', 'Waadt Freiburg', 'Spietz', 'Tfchaywo II', 'St Gallen', 'Ober-Wankdorf', 'Brssel', 'Thorbcrg', 'Karnen', 'Gerechtigkcitsgasse', 'Frdr', 'Alterthums', 'Graffenricd', 'St Gümmenen', 'St. Jakob', 'LouiS', 'Falkeneck', 'Bern Neuengasse', 'Sauvain', 'Aare', 'Obersteg', 'Grindelwaldgletscher', 'Mid Burgund', 'Mayen', 'WickhardSwyl', 'Brenfels', 'Burgerrath', 'St Rüscheck', 'Dotzigen', 'St Büzberg', 'Grnig', 'Frau RathSherrin tzr Junkerng', 'PolizciweibclS', '- buchsee', 'Bern Junkerng', 'Weisienburg', 'Almendingen', 'Büchl Frz', 'Südwcst', 'Freiburghaus', 'Solothurn Knuchel', 'Spitalgaffe', 'Leuziger', 'Herven', 'Jnnkcrngassc', 'Gmgnard', 'St. Saphorin', 'Schweizer', 'St. Fleury', 'Suttwyl', 'Ostermundigcn', 'Zes Bapt', 'dir', 'KnigSfclden', 'Ammerten', 'Zeughaus', 'Zweistmmcn', 'Brunngasse.', 'Neucngasse8Nr.113r.gr', 'Walperswyl', 'Krachholz', 'Jcnner', 'Schinz', 'Kanton Bern', 'Uebergangs', 'Germanus', 'Mistelberg', 'Sumiswald Alchenberger', 'Tschingelhorn', 'Walkringen', 'Mittaghor', 'Rubin', 'Lerzogenbuchsee', 'Coucy', 'Fcuz', 'ÄitziuS', 'Nebengasse', 'Thal JnterlackeN', '- thurneii', 'Säselimatt', 'Acbi', 'Moreau', 'Luzern Luttwyl', 'Trachsel', 'Zeughausgaffe', 'St. Riedburg', 'Acberhard', 'Vcrmes', 'Gansbrunnen St Cremine', 'Hak Ulr', '- genthal', 'Courrendlin Rennendorf', 'Drig Marg', 'Franz', 'BuchLndkr', 'Schneidmühle', 'Juden', 'St Sonbcval', 'Matten', 'Gerechtig', 'äLüsl', 'Wildermett', 'Weißenburg St Bad', 'Burgcrgemeindebehörden', 'Standesweibel', 'Thiele', 'Rathsherr', 'Gartcnbcsteher', 'Albert', 'Sury', 'Kanderbrgg', 'Kuliy, SLOC', 'WagnerSommer', 'St Gsteig', 'Schloß Tellenburg Mander', 'Boncourt', 'Punier', 'Salom.', 'Dägcrtschi', 'Badhaus', 'Hermeringen', 'Seftigen', 'Stadt', 'Jagdschloß Nydeck', 'Seitenstraße', 'Gcrechtig', 'Lunkerng', 'Berner Rath', 'St. Brnig', 'Acbnit', 'Gmlingen', 'Kirchthurm', 'Zollbrücke', 'Girod', 'Ringgcnberg', 'Baumgartcn', 'Ncnengasse', 'St Jmmerthal', 'imLngga', 'Wyachcngraben', 'Bätterkinden', 'Geltenbach', 'Hotelplatz', 'Asuel', 'Hioubet', 'Rußland', 'Poleren', 'Lehnkutsch', 'Bergthal', 'Klaßvorstehcrinncn', 'Rathhaus Gerber Samuel', 'PariS', 'Erguel', 'Hclisbühl', 'Salzmagazing', 'Brg', 'Aarbergerthor', 'St Thun St Gwatt Kandcrbrücke', 'Lolzmarkt', 'Brunncngassc', 'Diebach', 'Zelg', 'Mch', 'Kirchet', 'Rathhausplatz', 'Reichen', 'Wallis Freiburg', '- fee', 'Kandcr', 'Zihl', 'Solothurner ThorS', 'St Lauterbrunnen St Trümmelbach Grund Reuti Trachsellauenen Sennhütte Ammerten Sennhütte Stein', 'Wyder', 'Ncgoeiant', 'Flecke St Gstaad', 'Obersimmcnthal', 'Oberes', 'nrdl', 'Zimmlisberg', 'Mnchringen', 'Knrr', 'Miinsterplatz', 'Mctzgcrgassc', 'Wylerfcld', 'BettmacheriN', 'BrunnengrciberHandlang', 'SS', 'Merlingcn', 'Steiger Gottlieb', 'Mnchen', 'Grbe', 'Mervelier', 'Kitzlig', 'Promenade', 'Mattstetten', 'Singine', 'Lanz', 'Tschannen', 'Cgger', 'Zllner', 'St Waltrigen Huttwyl St St Langnau', 'Ruch', 'Gumoens', 'St St Ganzen Aeschi Fahrweg', 'Eybrgg', 'Müllerlanbe', 'Hahnenmöser', 'Bern Spcichcrgassc', 'Toffen', 'Spitalgasse Bern', 'Aarbcrgcrgasse', 'Standcsläufer', 'Lyssach', 'Brttclen', '- Kramgasse', 'Alpcn', 'Mtschwyl', 'Seelandes', 'LucienBorcl', 'Brunncngaffc', 'Bschlcr', 'SeigneDessus MomelonDeffus Lorette St Ursanne', 'Niederdorf', 'Bel', 'Spcichcrgasse', 'Meiringen St Tracht', 'Fliege', 'Wien', 'Huttwyl Su', 'Eichenholz', 'Cratat', 'Rentiere', 'Brodback', 'Nenengasse', 'Steinmann', 'Ratzenberg', 'MSli', 'Ill Niesen', 'A.L.Mattez', 'Kclergassc', 'Haller', '- rechtigkeitSgasse', 'St Untersccn', 'St Adelboden', 'Kirchhof', 'Flußadler', 'Ausland', 'CarlSruhe', 'Spcichcrgassc', 'Wtw.Monnier', 'Ke', '- vanneS', 'Bäckermstr', 'Rickli', 'Hngelen', 'Allenlftcn', 'Nicderhauser', 'ModisteS', 'Stadt St Matten', 'Aarbergerthore', 'Birs Nahe', 'Alterthum', 'Neuenburger-Seen', '- zogenbuchsee', 'Napoleons', 'Bern Rossignolat', 'Benoittc', 'Nohrbach', '- baum', 'EiSgebirge', 'DoubS', 'Bigler Fr', 'Ofen', 'Ablentschen', 'St. Lauterbrunnen', 'Tschug', 'Uebischisee', 'ColisseS', 'RohrmooS', 'VillarS', 'Bielersees', 'Gcrmaiu', 'Schiffslaube', 'St. Btschelcck', 'Kästchgäßlcin', 'Jegensrorf', 'Nicdcr', 'Wittigkofen', 'Aarbcrgcrgaffc', 'Bonjour', 'Lauffen', '- tigkcitsgassc', 'Portner', 'Trubschachen', 'Lenzn', 'klsrcbsnd', 'Steinhaucrmstr', 'St Strütlingen', 'Obergericht', 'Postgasse Nr Bay', 'Handelsmann', 'Jselin', 'Penstonshalter', 'Mülchi Bangerten', 'Lauterbrunnen St Zweilütschcnen St Stüllc Sausbachbrücke Lochbruck Lauterbrunnen', 'Geibhlcr', 'Eisennegot', 'Sd', 'Schrmli', 'Birs Pruntrut', 'Rtte', 'Bellevüe Aarzieledrittel', 'St Simon Tempel', 'St. Reitweg', 'Schauplatzaasse', 'Voralpen', 'Christn', 'Kornmagazin', 'Holzach', 'Holligenfchlo', 'Bzingen', 'St St Bütschelcck', 'Lnggaffe', 'Lngmauer', '- pfen', 'Neuenstadt Büren', 'Hcrbstm', 'Wieland', 'RathhausTcrasse', 'Hochaltar', 'Halbinsel', 'St Außerschwand', 'Grcllingen.41', 'Strättlingen', 'Reggis', 'KramgasseNr', 'Marti Frau gebHenzi Krämerin Marktgasse', 'Schloß Word Ganz', 'Graffcnried', 'HaSli', 'Bay Gabr Rud', 'Schloß Landshut', 'Oberlande', 'Lemairc', 'Nägelisgäßlein Metzgergasse Sonnseite', 'Aubonne', 'Zr', 'Strae', 'Gntnee', 'Thalkirche', 'Markig', 'Hintcrgiebelcck', 'Brunncngasft', 'altOberamtmann', 'Hotellaubc', 'Zumbrunnen', 'St langes Thal', 'Ogi', 'St AttiSwyl', 'Leimfabrikant', '- keitSgaffe', 'Schüpbach', 'Znsclcin', 'Althaus Jakob', 'Mnchcnbuchsee', 'Niki', 'Osterrieth', '- landes', 'Kandergrund', 'Gemmi St Gestcler', 'Golattematthor', 'Aidemajor', 'St Tavannes St Molin Brcleu Tra', 'Siebenthal Schmales', 'St Montbijou', '8udeng', 'Raubgewild', 'Pastetenbcker', 'Sticrlin', 'Speziercriii', 'Tufli', 'Neiicnstadt', 'Wildenstein', '- soldingen', '- zcnegg', 'Schnottwyl', 'Wuhlbezirk', 'Sonvilliers', 'Maulbeerbaum', 'Rohrer', 'Nvrar', 'DachSfelden', 'Obstberg', 'Burgdorf St Sommerhausbad', 'BurgerspitalS', 'Höh', 'Kästggäßleins', 'Plaffeyen', 'Weißensee', 'Mutach', 'Roms', 'Brodhuschcn', 'Brunucugaffe', 'St St Gurten Reitweg St Ueber Großwabcrn', 'Wcndelhorn', 'Metzg', 'Leuk', 'Hallcr', 'Schmcinbrunncn, ', 'Schlipfen', 'LeberbergeS', 'Lngga', 'Aarberg Aarberg', 'Bbend', 'Schoncgg', 'Vrunnengassc', 'Oberoens', 'Tra', 'Twingherrcnstreit', 'Land', 'Dampfschiff Bellevue', 'Burgerrathes', 'Gutenburg', '- fingen', 'Kirchbcrg Bürg', 'Neuenstadt Belp', 'Dällenbach', 'Berghöhe', 'Ly', 'Lolligcndrittel', 'Schiippach', 'Zabe', 'Lom', 'Buchen', 'Biktor', 'KyburgHabsburg', 'Hafner', 'Griengrube', 'Wildbolz', 'WalperSwyl', 'BernhFrdr', 'Bchsenfchmied', 'Quiquercz', 'Schtzcnmatt', 'Buchhändler', 'ZumbrunnhauS', 'Kirchg', 'Iunkerngaffe', 'Schlipfen Bay', 'Bicocca', 'Junkcrngasse8Nr.183', 'Miirrenbachs Zweilütschenen Gch madrid', 'Hammerschmied', 'Schöftland', 'Josua', 'Wstenbach', 'Luginbbl', 'Schaffhauscn', 'LeS Gene', 'Metzgergafse', 'Bren', 'Walkringen Dällenbach', 'Bergrückens', 'Joh Rud', 'Gerzensec', 'Brod', 'KnigSfelden', 'Lhelffh', 'Hcimberg', 'Oppligcn', 'Metzgcrmstr', 'Schwend', 'Langga', 'Slbbl', 'Bruunengasse', 'Thore der Stadt', 'Montebcllo', 'Unterstattbalter', 'obere Enge', 'Westindien', 'Geistkirche', 'Zumbach', 'Brunncugassc', 'Handenschild', 'Sigg', 'Kelcrg', 'Tuch', 'Brpbach', 'Bcndicht', 'Schulhaus Nr Nr Todtengräberwohnung Wylergut', 'Qeschinenthal', 'elp ensecundIi', 'Burgcrrathcs', 'Meiringen Brienz', 'Inselgasse', 'Krakau', 'Landwerksschule', 'Bögelin', 'Allmendingen', 'Berchtbold', 'Torfanstalt', 'Etienne', 'Fürsprech', 'Bei der Hochwacht', 'BätterkindeN', 'Welderen', 'Lioci', 'Riedstatt', 'St. Belpberggipfel', 'Aarzichlibad', 'Uebyngen', 'DieSbach', 'Petersinsel Bielersec', 'Wolfci', 'Couch', 'SamstMorgens', 'Häusern', 'Wangenbachs', 'Poschenried', 'Spezierer He', 'Werkmeisters Mättcli', 'Java Westindien', 'Rothhorn GebirgSstock Saanen', 'St. Zweiltschcnen', 'Nieder Peter', 'Obcrstlieut', 'Combe Franz Ebenist Meubclnmagazin Plainpied', 'Schloß Bipp', 'Unspunnen Jnterlacken', 'St St Mit Fuhrwerk St Fahrweg', 'Steiner', 'Kappelisacker', 'Morcau', 'WilderSwyl', 'St Grimsel', 'Korn', 'Sinncr', 'Khli', 'Münchenbuchsee Langhaus', 'Kirchgassc', 'Sittengericht', 'Sarbach', 'Lochbruck', 'gasse', 'Simmenthaler', 'Berg', 'DicmerSwyl', 'Gcbärhause', 'Wcycr', 'Subigen', 'Breiten', 'Zoire', 'Thcol', 'Paßbureau', 'Lehrsatz', 'Keler', 'Sybold', 'Kanton Aargau', 'Joh Negot', 'Hand', 'Kafichgchen', 'Aeschlimann', 'AugSburgcr', 'Mathys Christ', 'Vichmarkt', 'Srull', 'Lehlibad', 'Blindenbach', 'Hambühl', 'ZuckcrbäckcriN', 'Schweizern', 'Uhrenmacher Hermann', 'Graveur', 'St. Trmmelbach', 'Fayence', 'Ravylsee', 'Wvllenspimicrci', 'Leuch', 'Hochburg Byfang Belpberggipfel', 'Freiberge', 'Siebenpfeiffer', 'Martin', 'Bourrigno', 'Mllinen', 'Lütschenen', 'Valley Marg', 'Jost-Biffard', 'Brunn', 'Riedgasse', 'Wiedmer', 'Zinsmcistcr', 'Hauptparadeplatz', 'thurneii', 'Nydeckkirche', 'Brnnimann', 'iel', 'Lindenthal', 'Wasen Trllßcl', 'St. Ablentschen', '- Zoire', 'Bierbrauer', 'Untertbor', 'RüggiSberg', 'Schremer', '- gcrgasse', 'ZcugbauSplatz', 'Eggli', 'Lscher', 'Oberhasli Berg', 'Wattcnwvl', 'Stockhornkette', 'Neuenburg t3äo', 'Gticrlger', 'Joh Friedr', 'Brckfeld', 'Oberhasli Mineralbad', 'Wcibel Kunstmaler Ncnengasse Zlr 122b Wcibcl Niklaus Gypscr Salzmagazin', 'Drstetten', 'Blümlisalp', 'GrauholzeS', 'Höchstettcn', 'Kclcrgassc', 'Lutstorf', 'Gottlicb', 'lach', 'Bogen schützengcsellschaft', 'Kelergassc', 'Conr', 'Abraham', 'Rsti', '- menzind', 'Schmiedenwirth', 'Reu', 'Frci', 'St. Erlcnbach', 'Sennhütte Schwandmatt', 'SalviSberg', 'Zwiebclngäß', 'Schppach', 'Brienzersees', 'Eselinnen', 'Sommerleist', 'LanS', 'Strumpfwcbermstr', 'Gottesacker', 'Eiger', 'Bhlcr', 'Jnselein', 'Ziehlebach', 'Zlarberger', 'Burgdovf', 'Dcllcnbach', 'Landelsm', 'Faulhorngipfel', 'selwald', 'St. Hasle', 'Junkcrugasse', 'Lüttisbach', 'Barbiererin', 'Präposttus', 'Aebnit', 'Niederwangcn', 'St Petersinsel St Porrentruy', 'Wurstemberger', 'Weißenburgerbad', 'Spiralg', 'Grellin', 'Bern Sträub', 'Jucharten', 'Lemann', 'LandclSm', 'Belpberg St Großwabern Kleinwabern Lehrsatz', 'Flugbrunnen', 'Orvin', 'Lindenthal Weg', 'St Cornol Cour genay Voyebeu Porrentruy', 'Sonvillier', 'Thorberg Utzigen', 'Limpach', 'Berchtold Münsterkirche Monument', 'Reidenbach', 'Zcughansgasse', 'Schangnau St Sch madribach Reitweg St', 'Wohleyberg', 'Wicdlisbach', 'Rudrauff', 'buchsee', 'Rikcnbach', 'Münsingen', 'Altenbergstraße', 'AcgelmooS', 'Oclmhle', '- teregg', 'Handelsm', 'Schloß Riggisberg', 'Flcury', 'Schrlimli', 'Schreckhorn', 'Allimann', 'Schüttepromenade', 'Plainpied', 'Germanu', 'Untcraufseher Museum', 'Burgersvitalverwalter', 'Fubokc', '- gnelegier', 'Kcßlcrgasse', 'Lütschinen', 'Engegter', 'Aarufer', 'Bautcuaure', 'Nr Eich Joh', 'Oberamtm von Fraubrunnen', 'Duzcr', 'LaurcntiuS', 'Gcffenay', 'Lerzog', 'Wagnermstr', 'SalzbchSlcin', 'Buchmann', 'Gerstenhorn', 'Kornträger', 'Word Ober', '- mcnthal', 'Marfeldingen', 'Perront', 'Lanqnau II', 'Lchcnmann', 'Pruutrut', 'Zenghansgasse', 'Europaö', 'Klösterli Nr Eggut Schwellenmatt Vorderes Dalmatien', 'Saignclegier', 'Dav', 'EKeikofen', 'Schauplatzgasic', 'Eisenbolgen', 'St. Sdel', 'Parrat', '- berg', 'KnopfmacheriN', 'Bielersee Münster', 'Arzt', 'Bijoutiers', 'Badhaus Hornbachgraben', 'Schreiner', 'Groenbacher', 'Schpbach', 'Sulgeneck', 'St. Blumensteinkirche', 'Ntz', 'Spenglcrmstr', '- kercn', 'Weber Christ', 'Baseler', 'Canivet', 'Aarbcvgcrgassc', 'Oberbofen St Reitweg', 'Bächlcr', 'Pulver', 'RüderSwyl', 'Burgund', 'Dan', 'Frutigen Simmen', 'Klopfcnstcin', 'Oberlindcn', 'Sphtig', 'Salomea', 'Schauplagasse', 'Könij', 'Klsterli', 'Störschncider', 'St. Laupen', 'Gercchtigkcitsgasse', 'Lugenbach', 'Finsteraarhorn', 'Amtsgerichtschreiber', 'Kühlenwylcck', 'kommissür', 'Scheideck Sennhütte Wengercn Sennhütte Mettlen Schiltwald Mengen Lauterbrunnen St St Lenk', 'RusiSwald', 'Lauptmann', 'Anten', 'Gpiez', 'Win', 'Gerechtigkeitsgaffe', 'Lander Simmenthal', 'Sennhtte', 'Siebenthal', 'Aebersold', 'Wintereck', 'Oberhasle', 'Egg', 'Emmenthals', 'ZeughauS gasse', 'Badeigenthmer', 'Schweinmetzgep', 'Lura', 'Stockhorns', 'Keßlergaffe', 'Bielcrsce', '- laubc', 'Weienburg-Bad', 'Mußmatte', 'Hachen', 'Sumiswald Schwyz Paris', 'Gottl Friedr', 'Schweinmarkt', 'Schwaben', 'Eagut', 'St Ganzen St Adelboden', 'Gcbrd', 'Bärcngrabens', 'Dentenberg', 'Schaufelbhl', 'Bcrgolder', 'St St Oder', '- bergSweg', 'St Gurnigelbad', 'ThurneN', 'Niedcrbtschcl', 'St. Spietz', 'Rcggisbcrg', 'Kelcrgasse', 'Delsbcrg', 'Außcrstandcshaus', 'Gig Dorf', 'Sennhütte Buhlberg', 'Choiffcusc', 'Blonav', 'NcuhauS St Fahrweg', 'artmann', '- brunnen', 'Bildhauer czi', 'Cortcbert', 'thurner Gränze Untersten', 'Brunnq', 'Gtschmann', 'Metten', '4soo', 'Dtroit', 'Nathsherr', 'Straße St Viel St Bözingen', 'Pfd', 'Wittwe', 'Corgemont', 'St St Thurbachbad', 'Käsigthurm', '- Marktg', 'Thcurillat', 'Lder', 'Herzogen', 'Schützcnmatt', 'Georg Christ', 'Dicmtigen', 'end', 'Schuhmachermftr', 'Wiegsam', 'Büren', 'Th.', 'Weienbach', 'Kappenmacher', 'St Rieb', 'Buntschibad', 'Slarbcrgcrgaffe', 'Hochalpen', 'Montillion', 'JngelramS', 'Brnnngaffc', 'Wengernalp Schcidcck', 'Aarbergcrgassc Nr Luginbühl', 'Gemmi', 'Münsterterrasse', 'Gri', 'Berges', 'Murtc', 'Schlli', 'Leuthold', 'Untersten', 'St Grindelwald', 'Vergolden Spitalg', 'rlacken', 'Ebenist', 'Neuenstadt Freiburg', 'Freiheitsbaum', 'Luzern Messagerie', 'Kleinwabern', 'Stadtgarnison', 'Worblen', 'Seide', 'Brüggfeld', '- soldingcn', 'Krhenbhl', 'Unter', 'Tbalc', 'Privathäuscr', 'Sonbcval', 'Kädereggen', 'Teuffelen Löscher Erlach', 'Slarbergergaffe', 'Bcndlcht', 'Maria', 'Lcntulus', 'Dicbach.41', 'Montfau', 'anchPin', '- melan-DessouS', 'Balsiger', 'Burgmattcn', 'Nppcr', 'Stockhorngipfel', 'Gambach', 'Lurxsrvsrein', 'Adel', 'Gcrwer', 'Courfaivre', 'Gletscher', 'Mad', 'Sdercn', 'Biclersec', 'Güder', 'Zbinden', 'Gradey', 'ThunerseeS', '- Rosen', 'Röche', 'Vinelz', 'Kirchhoftcrrasse', 'St. Courtclary', '- lcrgasse', 'Lotterievureaux', 'Regierungsrath', 'Schohalden', '- Liese', 'Rath HandelSm', '- see', 'Sommer Peter', 'Appolloni', 'Schwab', 'Zlarbergergassc', 'Rcnhans', 'Grondonaz', 'Bomont', 'St Hondrich Mülinen St Rcichenbach Kanderbrücke Frutigen', 'St Homlisthal', 'BräterhäusliwirthiN', 'Neubrck', 'Kfichg', 'Jaselholz', 'alli', 'Keßlcrgasse', 'Hun', 'Meyringcn', 'Kehrhuschen', 'Ebersold', 'Labourg', 'Bchsenschmicd', 'Langenegger', 'Gypsermstr', 'Spitalgaffc', 'Jäggi', 'Schnt', 'Marranne', 'Länggaßdrittel', 'Aarzrclcdrittel', 'St. Sennhtte', 'Käfichgäßleindir', '- Strtlingen', 'Münster', 'Glovelier', 'Herren', 'Allhaus', 'Newa', 'Rathhause', 'Hinzugckomnien', 'Zos', 'Morgens Mes', '- ringcn', 'LangloiS', 'Sollberger Barb', 'Niedcrstmmenthal', 'Schweinmctzger', 'Krcuzg', 'Freudenreich', 'Nordost', 'Schulgasse Stöckli', 'Hunnenfluh', 'Lohnwascher', 'Strttlingerberg', 'Prntenw', 'Mctzgermstr', 'Don Krailingen', 'Dnbach', 'Lthi', 'Obcrfcld Loch', 'Mnstngen', 'Bierhbeli', 'BlmeliSalp', 'Niedcrsimmenthal', 'Aarbcrgerq', 'Altenberadrittel', '- boden', 'Ncucng', 'Kramgassc', 'Nieder', 'Knsch', 'Schauspielhaus', 'Rud Karl Gottl', '- gasse8', 'Znberbhler', 'Arm', 'Oberstekholz', 'RathhauSplatz', 'Gch', 'Stkli', 'Jmbodcn', 'Zunkern', 'Neuenschwander', 'Lloines', 'Salom', 'EselSrücken', 'KaffecwirthiN', 'Sulg', 'St. Saphorin Hudcn', 'Jnselibad', 'Grundh', 'Wüthericb', 'Nikl.Soltcrmann', 'Straacker', '- und Niedersimmcnthal', 'BüetigeN', 'Bcllcvue', 'Graffenricd Holzmarkt', 'Oeschenbach', 'Rothfarberei', 'Klapperläubli', 'Gränze', 'St Ricdstatt', 'Joh Nud', 'Bohard', 'Schlo', 'Bantiger', 'Murtensee', 'Nr Wyß Rudolf Schrcincrmcistcr Spitalgasse', 'St. Oeschbcrg', 'Zlarbergergasse', 'lisberg Lauenen St St Laupcn Stadt St Niederwangcn St Laupen St St', 'GerechtigkeirS', 'Weinnegoeiant', 'Weibel', 'Utz', '- kirch', 'Bzberg', 'Armagnakcn', 'Mhlcnlaube', 'Stockmar', 'Dürrmühlc', 'Bruchenbhl', 'Flecken Schwarzes Quartier', 'Brhli', 'Rcgierungsrath', 'Thal', 'Häbcrnbad', 'Kriedr', 'Heiligengeistkirche', 'OberWankdorf', 'St Saphorin', 'Mctzgcrgasse', 'Znterlackcn', 'St Napfgipfel', 'Brunncngaffe', 'Lciligengeisikirchc', 'Guggisbcrg', 'Hab', 'Wallis Solothurn', 'Zcngschinicd', 'Steinibach Belp', 'AmtSnokar', 'Jegenstorf Knuchel', 'große Straße', 'CourrendliN', 'IliS', 'Adreßbuchs', 'MöSli', 'Allemann', 'Bierhübeli', 'Bättwyl', 'Growabern', 'Musmatte', 'RegierungSftatthalter', 'Thal von St Länge', 'z.weienRo', 'Brodbcck', 'Casino', 'Oeschinenthal', 'Math', 'Obersttn', 'Rorhhorn', 'Nttcr', 'Gncrvain', 'Grünes Cluartier', 'Storchen Spitalgasse', 'Rathes', 'Ub Galgenhübeli', 'Ortbach', 'Erlachs', 'Trachtbach', 'Burgderf', 'Gelter', 'Durisch', 'ZeughauSgaffe', 'nrdliches', '- Teuffelen', 'Großer Rath', 'Aarbergergasse Nr Becherat Rothgerber Gerberngraben', 'Schloß Reichenbach', 'Zunkcrng', 'Mühleberg', 'Län', 'Svitzlaube', 'Jnselspital', 'Ortschwaben', 'St Gwatt St', 'Münster Eisenwerk', 'Slarbergergasse', 'Pestgasse', 'NichanS', 'Btzberger', 'GcrechtigkeitSg', 'nördl Staaten', 'Waldegg Hüdeli Schöncgg', 'Flachmaler', 'Rschcgg', 'Kc', 'Wcrren', 'St Courtelary St Cormoret Villeret St Inner', 'Dorf Eggimann', 'Rothgerber', 'Lehenmsnn', 'Grimselstrae', '- tigkcitSgasse', 'Bafel', 'GercchtigkeitSgasse', 'Bern Lcrber', 'Werth', 'G.Borel', 'Cour', 'Obmann', 'Sans Hofer', 'Gli', 'Bsvillard', 'Spychcr', 'OberhaSli', 'Großen Rath', 'Geißbühler', 'Krhcnbhl', 'Aarbergergassc', 'Rothcnbbl', 'Bantiger Berg St Völligen', 'St. Tracht', 'Schwellenmätteli', 'Lombach', 'Acschlcr', 'Uhrenmacher', 'crg', 'Epsaeh', 'Wimmis St Reitweg', 'Gcrechtigkeilsgasse', 'Balm', 'Zurbrngg', 'Wange', 'Lüzelflüh', 'UYr', 'Schloß Blankenburg', 'St. Fahrweg', 'Todtengräber', 'Das Kornhaus', 'GrimmensteiN', 'Tschiengelfclsstafel', 'Metzgern', '- gergasse', 'Mcdaillen', 'Wollentuch', 'Schoohalden', 'Neucngassc', 'Hohgant', 'Mayenwand', 'St SchulmeistcrhauS', 'Dllenbach', 'Herzpgenbuchsee', 'Konolfingcn', 'Gercchtigkcitögassc', 'Kantons Bern', 'Weiler Flugbrunnen', 'Salpeterhtte', 'Oberrichtcr', 'Zimmermann', 'Gastwirth', 'Republik Bern', 'Cormoret', 'Mehgcrngasse', 'Burgerspital', 'Andres', 'Längenberg', 'Flecken', 'Grneisen', 'Wasserbrenner', 'Fayance', 'tzolzmarkt', 'Courchavoix', 'Engemeister', 'ZeichnungSlchrcr', 'Oberstlieut', 'Blauncr', 'Wcgmühle', 'St Stephan', 'Lehenkommiffär', 'Quiqucrez', 'St. Stephan', 'Oberlandes', 'RapperSwyl', 'Stckli', 'Wergisthal', 'Oberfimmcnthal', 'Vadlaube', 'Alpengclände', 'Bern Blätter', 'tAiedcrbach', 'Mctzgcrg Nr Länggaßdrittcl', 'Unterstopf', 'GcburtShülfe', 'RathSbcrr Spitalg', 'Entlibuch', 'nrdl Staaten Ruland', 'Pintenwirtb', 'Gerzensce', 'Gerberlaube', 'Belay', 'Altcnbcrgdrittcl', 'Badewirth', 'Gclpke', 'Tesstn', 'Schlup', 'Zrchersees', 'Montcusen', 'Schlößli', 'Grner', 'Kirchthurnen Riggisberg Rütti', 'Hafnermstr', 'Kubli-Joost', 'Mctzgcrgaffe8', 'Vermes', 'Morlotlaube', 'Aarberg Nr FetscheriN', 'Amr Fraubrunnen', 'Metzgcrugassc', 'Waadt Wallis Solothurn', 'Schloß Nydeck', 'Ltschenthal', 'Thuner Almend', 'Büderich', 'Kantonsuhrenmachev', 'Oberlieut', 'Rodt', 'Zcnghausplatz', 'Niedergurzelen', 'Kelcrga', 'Hirtenland', 'Brunnengräber Aarbergcrg', 'Bichsel', 'Tellenburg', 'Rm', 'Stockhornkette Noch', 'Freibergen', 'Luzern Diligcnce', 'Grüningen', 'St Burgdorf', 'Ritzenbach', 'Burgerschreiber', 'Lutmachermstr', 'Unteres', 'Kallnach', 'Weber', 'Lüthardt', 'Eman', 'Mller', 'Grcycrz', 'Schwarz', 'See', 'Btscheleck', 'Henzi', 'Hospclmatte', 'Wildbolz-Lutz', 'St. Aarwangen', 'Joh EM', 'Rfenacht', 'Ludwig', 'Pl', 'Schwand', 'Leuenberger', 'Wallis Saignelegier', 'Büren Freiburg', 'Distelzwang', 'Simmenthales', 'Bubenbergsweg', 'Reit', 'Mumprecht', 'Thu Namens', 'Rtti', 'Rued', 'Steinalp', 'Saanen Saignelegier', 'Derselbe', 'Bötzingen', 'aiiiö Lombach', 'Rthenbach', 'Zss Gebäude', 'St von Wangen', 'BrggfeldwirthShaus', 'Gsteig Dorf', 'Kirchet-Hhe', 'Kb.gr', 'Bevillard', '- lingen', 'Olttgen', 'Regsbach', 'Jttingenau', 'BachhuSchen', 'Lnggadrtttel', 'Obcrfcld', 'St Word St Ried Großhöchstetten Zcizziwyl Steinibach Signau Langnau Flecken St St Lauenen Fahrweg St Reuti St Stalden Lauenen Reitweg', 'Schund', 'Benedikt Schwyzer', 'Kostgeberin', 'Badlaubc', 'Zrcher', 'Zürich', 'Bm', 'Mark', 'Quincallarichändl', 'Zwirg', 'Nufli', 'Belleve', 'Weltmeers', 'Oeager', 'Lsinggadrittel', 'Im Hooff', 'Wyßloch Gemeiner Sood', 'HormatSgasse', 'Rothgerbcr', 'Casinv', 'Ger', 'Lwen', 'Alex', 'Unterseen St', 'Wylcr', 'Rebert', 'Barthol', 'Schwarzhrn', 'Nagelschmicd', 'Wciermannshaus', 'Peterlingen', 'Gebrüder', 'Neubrück', 'Thierarzneischule', 'Thierarzneikunde', 'Kleinmetzgermstr', 'KornhauscS', 'Scheidegger', 'Ayrv', 'Jouxthales', 'Bernh Lud', 'Lehnkutfcher', 'Gammen', 'NamenS', 'Grningen', 'Schwarzhorn', 'Melchenbühl Wittigkofen', 'Joh Sam Christ', 'Reichenbachs', 'Zenghausgaffe', 'Jungfrau Lauterbrunnen', 'Aarau Murgenthal', 'Rosenlauibad', 'Delarenfrille', 'Schlösser Bremgarten', 'Diehi', 'Löffelkricg', 'U.b', 'Stcinhaucr', 'Stulzen', 'Annetcr', 'vanneS', 'HofstettcN', 'Obrecht', 'Auerschwand', 'Gcmeindcwesen', 'Bourguignon', 'Salzbüchslcin', 'Rüeggis berg', 'Bönigcn', '- strae', 'Spejiercr', 'Brunneugasse', 'AarflußeS', 'Mander steg', 'Treiten', 'Gerberngraben', 'Lieut', 'St. Voltigen', 'Untcr', 'Bschlin', 'Neucng', 'Ssnnseite', 'Amtsvcrweser', 'JuN', 'Hinterurweid', 'Altcnbergdrittel Lorrain', 'Delsberg Boffart', 'Bärengraben', 'Obcrthor', 'Bubenbcrgsrcin', 'Bure', 'Aellig', 'Bhmen', 'Ortschwaben St Schü', 'Spital', 'Spitalgassc', 'Berge', 'Schweingruber', 'Rothgiccr', 'Weid', 'Bönigen', 'Wettach', 'Zeitglockenthurm', 'Stcinhauermstr', 'Schluep', 'Kueren', 'Schmarrcnbach', 'Freicnhof', 'Bremgarten Mettlek', 'Krauch', 'Ke lergassc', 'Kornhäuser', 'Grundbacher', 'Neuengasse8Nr', 'HirS', 'Notar', 'Tesstn Deutschland', 'Kantor', 'Tabaknegotiant', 'Lerrenküfers', 'Kästggäßl', 'Schnenbhl', 'Schloß Susten Reitweg St Meiringcn St', 'St Urtenen', 'Bdeli', 'Btz', 'NcuhauS', 'Gypser', 'Walke', '- lauralp', 'Sulgenbachdrittcl', 'Washington', '- chenthurncn Mhlegraben', 'Schattenseite', 'Käfigthurm', 'Weißspengler', 'HundeShagen', 'Hünerwadcl', 'Schooßhaldendrittel Obstberg Nr Liebegg AcgelmooS', 'Schnster', 'Stierlgcr', 'St Sennhütte', 'Negotiant', 'Vcrqolder', 'Brechbhl', 'Tanne', 'Zninstci', 'Straberg', 'WohlcingerichtetcS Spital', 'Willimannsacker', 'Büren Paris', 'St. Kalksttten', 'Jnterlackcn', 'Blesch', 'Nolli', 'Obcrbtschcl', 'Schanzpromcnave', 'HnigerShauS', 'Brnnngasse', 'Küchlerin', 'Mttcli', 'Telsberg', 'Schone', 'Enge Läng', 'St Reidenbach', 'Wylerfeld Manövrirplatz', 'ZeughattSgasse', 'Oder Fahrweg', 'Unteraargletscher', 'Mailand', 'Georg Frdr', 'Stein', 'St Gränze St Wange', 'Genf Waadt Wallis Büren', 'Gereebtigkeitsg', 'Schloßberg', 'NidaU', 'Rmlingen', 'Tschugg', 'Runf', 'Dominikanerkloster', 'Metzgcrgassc', 'Hauptwachcn', 'St. Gstaad', 'Pfingsten', 'Znrbrugg', 'Nyfeler', 'NegierungSstatthaltervonJntcrlacken', 'Lolligcndr', 'Slraburg', 'Casino Jnselgasse Sonnseite', 'Wyloch', 'Mau', 'KantonS', 'KienerSrti', 'Lausanne Gumoens', 'Berghohe', 'Aarberg St Walperswyl', 'Metzgerngassc', 'Aarbcrgcrgassc', 'Langnau Paris', 'Utzi', 'Lobsigen', 'Salzmagazin Feld', 'Signav', 'Nydeck.1.832', 'Langnav', 'Walthard', 'Sood', 'MühlemachernndOehlcr', 'LansRubin', 'St. Langnau', 'Eine Fahrstraße', 'Rothacher', 'Deka', 'Meiringen Heid', 'St. NiklauS', 'Ncncngasse', 'Langenkhal', 'Nikolaus', 'Stalden Nr Merveilleux', 'St MettlcN', 'Krgmgasse', 'Büren Basel', 'Zwiebclng', 'Schafloch', 'Lchligut', 'Gurnigel Weißenburg', 'Schnetdermstr', 'Sommerhausbad', 'Zdinden', 'Pieren', 'Loser', 'Marktgasse Nr Champagnac Monteil Gebrüder Ncgenschirmfabrikantcn Kram', 'St. Aarberg', 'St St', 'Furka', 'Zürcher', 'Lthi Peter', 'Wilh', 'Brienzerfee.I', 'Moser Pintenwirth Slarbergergaffe Nr Mouthigtty', 'Salzmaun', 'Speichcrgasst', 'Hunkerng', 'Anknnft', 'Gürbenthales', 'Schlatt', 'Hbcrnbad', 'Brunuengasse', 'Schüpbach Oberhünigen', 'Ridau', 'Jegenstorf Jak Witschi', 'Sumiswald Schwyz', 'Durheim', 'Ortschwabcn', 'Kapp', 'Bern Derselbe', 'Zollbrcke', 'Steinhaushorn', 'Mnsters', 'Schmied', 'cNLioouUsi', 'Metzgcrngasse', 'Marktgaffc', 'St Wiedlis', 'BourgeoiS', 'Schnceberger', 'Langgaßdrittel', 'St St St Murgenthal', 'Schappuis', 'Gmmenen', 'Zeughausga', 'Felscnthors', 'Schreckhor', 'Abr Jak', 'Cerlatez', 'Zweiltschinen', '- Dicsbach', 'Alpe Winter', 'Uhrcnhändler', 'Marktgasse Nr Tessaro Dominiqne Kunsthändler Gcrechtigktsge', 'Gugger', 'Schwarzcncgq', 'ThalS', 'Schoßhaldendrirtel Aarzieledrittel', 'Jndengasse', 'Waisenhause', 'Stemhölzli', 'Rentisre', 'Hauscigcnthümcr Bern', 'Zegrich', 'Wagner', '- Brunngasse', 'Werbt Links', 'Garn', 'KostgcberiN', 'Zcugbausgasse', 'Slraßburg', 'Lrachselwald', 'Gcrechtigkeitsgasse', 'Obrccht', 'Trümpi', 'Dietrich', 'Assen', 'Saagcr', 'Milden', 'Fahrstraße', 'Jnnkerng', 'St MciringeN', 'Nicdcrhuscr', 'Nr Hürner Ank', 'Rätzligletscher', 'derFrick', 'Ncuengassc', '- undSimmcnthal', 'Stadthaus', 'Sterchi', 'Likerarschule', 'Waltri', 'Zi', 'Faulhorn Grindclwald', 'Mürsett', 'Parfümcur', 'Spitalga', 'Mnchenbuchsce', 'Ebcnist', 'Kemmeriboden', 'Wafferbrenner', 'Ncucngaffe', '- gauerstrae', 'GercchtigkeitSg', 'Saanefluß', 'berg', 'Keilbach', 'Zaugg', 'Brenzikofen', 'Jsaac', 'Howald', 'Wylergut', 'Twann Bielcrsee', 'Aarberger', 'Grindelwald 24is Gstcig', 'Weinnegotiant', 'Metzgerngaffe', 'Bigler Wrttwe', 'Rostna', 'Bleyenbach', 'Schloberg', 'Thun-Gschneit', 'Siebenbrunnen', 'Gemcindweidc', 'MooSseedorf', 'Küfer', 'lä St Kandersteg St Ocschinenbrücke', 'Drig', 'Cascrnen', 'Kirchbcrg', 'Baumgart', 'Banquier', 'Aarbcrgcrgaffe', 'Zeughausplai', 'Gottstatt', 'Lnginbnhl', 'Mhlcberg', 'Btzingen', 'Belljeau', 'Alpenseen', 'Holz', 'Konrad', 'Keltberg', '- Lauterbrunnen', 'Mstgglein', 'Schauplabgasse', 'Stiegcngang', 'Heinr', 'Aarziehli', 'Schooßhalden', 'Buren Stadt Straße', 'Bohren', 'Appclla', 'Zakob', 'Su', 'St Subigen', 'Borte', 'Bach', 'Schmiedmstr', 'Gerechtigkeilsgasse', 'Nr Steinhäusli', 'Holligendritcel', 'Gcrcchtigkeitsgasse', 'Meiringe', 'Zordan', 'Rthlisberger', 'Dießbach', 'Denkstein', 'Gipser', '- wylgrats', 'Ebenso', 'Blacken', 'Lng', 'Metzgergasse Goldene Adler', 'Viescherhörncr', 'Mittaghorn', 'Blumenstcinbad', 'Christen', 'Grempler', 'Donnerst', 'Etzelkofen', 'Rentier', 'Hchstetten', 'Mhledorf', 'Schauplapgaffe', 'BraiS', 'Münsterkirche', 'Thun Bachmanil', 'Enge', 'Steinhauermstr', 'Holzmesser', 'ZeugbauSgaffe', 'St.', 'Gerbergraben', 'Ricdstatt', 'Nicolet', 'Oberamtmann von Aarwangen', 'Dürrbach', 'Fra', 'Frick Xr', 'Stcffisburg', 'Wybach', 'Äle', 'Hufschmied', 'Pintcnschenk', 'Basel Neuenburg', 'thurn', 'Schmadribaches', 'BirS', 'Nasbaum', 'Ocschinenbrcke', 'Knigsfcldcn', 'Mllerlaube', 'Dellenbach', 'Bern Großer Rath', 'Nr Lützclflüh', 'Steiger', 'RathhausGalkrie Kramgassc', 'Lcodegari', 'Gttlich', 'Müüermstr', 'Dürrmühle', 'Napfgipfel', 'Schloffermstr', 'Bouvert', 'Brcleu', 'Gerechtigkeitgasse', 'Eggut', 'Frutigen Schertenlcib', 'Solothurncrstraßc', 'Mr', 'graben', 'dleuengasse', 'St Wattenwyl', '- sengipfcl', 'Adrcssenbnch', 'Jnnerschwand', 'rechtiqkeitsgasse', 'Thun St', 'Schiltwald', 'Oberstfeldarzt', 'Artillerielicut Schreinermstr', 'Lafnermstr', 'Ostermontag', 'Ks', 'Frz Rud', 'Mülinen', 'höhc', 'Nagelschmied', 'Mnsingen', 'Saumel', 'Elts', 'Obcrgericht', 'Billette', 'Salpeterthurm', 'Bratschi', 'Tschiffcli', 'Bern Theil', 'Brne', 'Kräm Zeughausplatz', 'Nr Hirt Lehnkutscher Marktgasse', 'Pest', 'Habstetten', 'Sauser Zwieselberg', '- ried', 'Wengercn', 'Obergurzelen', 'Jnsctgasse', 'Mhlhcim', 'Geisi Zc Hof', 'Benteli', 'SornetaN', 'Speze', 'Krämer', 'Brüssel', 'St Langnau St Trüb', 'Stauffer', 'Lang', 'Wüthrich', 'Bottigcn', 'Trogenried', 'GerbernkaubeNr.145', 'Kaffewirthin', 'yi', 'spergcr', 'Suld', 'Zo', 'Leinen', 'Zeughaus gasse', 'St St St Ueber Jscltwald', 'Burgcrspitals', 'Landjägerlicut', 'Alte Reitschule', 'Bomattschachcn', 'Zcizziwyl', 'Brcchbuhler', 'Pruntrut.', 'Steinkohlenflötz Lenk', 'Martini', 'Viande', 'Lohncr', 'Hdeli', 'Otz', 'Zwci', 'MettlcN', 'Langcnthal', 'Mllcrlaube', 'Porrentruy', 'Kirchhöflein', 'Nr Stubcr Abr Schreinermstr', 'Stern', 'Obcramtmann', 'Pintemvirth', 'Heuerlinge', 'Nägeliögäßlein', 'Kfer', 'Gabr Gottl', 'Montbenay', 'Reucr', 'Schl-fli', 'BelleRive', 'Oberjaun', 'Brnnncngaffe', 'Karl Jak Rud', 'Kappelisacker St Zolltkofen Hofwyl St Fußweg', 'HünigerS', 'Jnselhof', 'Mhliinan', 'Flhlen', 'Siehe', 'Krhenbhlleist', 'Aeschmann', 'Alpe', 'Schohaldendrittcl', 'Strättlingerberg', 'Sselimatt', 'Lnggadrittcl', 'Voyebeu', '- gasse', 'Ring', 'Frutigtuch', '- Frutigcr - Emmenthaler', 'Finot', 'Zeughansplatz', 'Ochsen', 'Marfort', 'Bnbcnbcrgs', 'Svitalg', 'Tscharner Lcisigen', 'Nlarktgassc', 'Word König', 'Wber', 'Courtetelle', 'Sitten', 'Schifflände', 'Bern St Ueber Merligcn', '- fenbach', 'Hebräer', 'Altenbergdrittcl', 'Kaukasus', 'Kirchdorf St Fahrweg', 'Braix', 'Kornamtsschaffner', 'Viel', 'Müllerlaubc', 'Thu', 'czi', 'Bossardt', 'Mebgergasse', 'Spiegelbelcger', 'Frz Gottl', 'Schoßhaldendrittel', 'Knait', 'Piqucrez', 'Oestreich', 'buchsee Kirchberg', '- thurn', 'Fuweg', 'Vincen', 'Widdenberg', 'Athen', 'Mühleberg Münchenwyler', 'Steinberg', 'Mädchenschule', 'Adler', 'Noiremont', 'Kunzlcn Sennhütte', 'Lutcrnau', 'Jungfrau', 'Lnschberg', 'v.Burg', 'Mestral', 'Schauplatza', 'Banquiers', 'Marg', 'Savoycn', 'Bellerive Tscharner', 'Duperret', 'Freiberg', 'Nasbaum St Sennhütte Haslerberg TrütliS Berghohe Trüt', 'Fricdr', 'Schmid', 'St. St. Ursannc', 'Nydcckkirche', 'ZrcherinBuchcn', 'Mohren', 'Drrmhle', 'Aarberg St Lyß', 'Sattlermstr', 'Vinelz Pfd Erlach', 'Straßburg', 'Thomann', 'Kästggäßlein', 'Narbergcrgassc', 'Sennhütte Unterwintereck St Sennhütte Oberwintereck', 'FrischingstipendiuM', 'Delsberg Hauptstraße', 'Peter', 'Grimselspital', 'Gmmclwald', 'Lütschinenthal', 'Nicsengipfel St St Oeschinenthal', 'Burgerspital Zeughausplatz', 'Lühelflüh', 'Gasel', 'St. Thuner', 'Lcga', 'Riesen', 'Salzhandlungsverwnlter', 'Kellcrhaltcr', 'Bonstettcn', 'Rhone Grindelwald', 'Schoßhaldendrittcl Nr Schläfli', 'Musikinstrunien', 'Alpen Gletscher EiSgebirge', 'Hgelland', 'St. Murgenthal', 'Staub Jak', 'Kirchhofterrasse', 'Sternen', 'Frankhauser', '- rcchtigkeitsgasse', 'Gcrechtigkeitsgaffe', 'Kinkelin', 'Merlingen', 'Roschi', 'Lebenm', 'Lindenallee', 'Tannengehölze', 'Scherlenbach', 'RcgierungSrath', 'Kerzerz', 'Giebach', 'Neuenstadt Brätst', 'Schuhmachcrmstr', 'Sumiswald Schwyz PariS', 'Zoux', 'Grimselstraße', 'Buert', 'Riggisberg', 'Hornbach', 'Js', 'Niedcrsimmenthal Pfd', 'Sam Karl', 'St Sennhütte Unterstopf', 'Heimiswyl', 'Waldegg', 'Blankenburg', 'Schlachthaus', 'Letzwyl', 'Klein Abr', 'Junkcrg', 'Sennhütte Win', 'St. Vorderurweid', 'Stolzen', 'Phärit', 'BachhüuSchen', 'Arber', 'TrtliS', 'Kirchenfeld', 'Belvedere', 'Thurbachbad', 'Münchenbuchsce', 'Mühlcdorf', 'Altcnbergdrittcl', 'Jnter', 'Bielersec', 'Bitzius Fr', 'Nenzlingcn', 'Krähenbühlleist', 'Schwarzhörn', 'Freiburg Breisgau', 'LeS Laives', 'Neschlcn', 'Urner', 'FrantzaiSbad', 'Neuengasse Nr Tillicr', 'Friedr', 'Sus', 'Untcrstatthaltcr', 'Post', 'Lbambellaii', 'Lffel', 'Lenk Reichenbach Oberhasli', 'Jnsclscheuer SalzbüchSlcin', 'Hindeibank', 'Lübeck', 'Pestalozzi', 'Judcng', 'Aimmcrmstr', 'Berner Hochlande', 'zgasse', 'Kielte', 'Solothurii', 'Saancnmöser', 'Tavcl', 'Fried', 'Diligcnce', 'Nderswylcrfcld', 'Rosengarten', 'Käfichgäßlcin', 'Gcrcchtigkcitsgasse', 'Aarberg St WalperSwyl', 'Kstggl', 'Häbcrenbad', 'Stökli', 'zogenbuchsee', 'Zollikofcn', 'Samuel', 'Frutigen Spitalgasse', 'Stistsgebäude', 'Lombardei', 'Wyachengraben', 'scN', '- genbcrg', 'Gpitqlgaffe', 'FreiburghauS', 'Saignelegier Basel', 'Jntcrlackcn Gsteig', 'Hasenbrunnen', 'Nydeck Jagdschloß', 'Büchsenschmiedmstr', 'Kernen', 'Hebräeb', 'vonFschy', 'Bödeli', 'Weißenburgbad', 'Stoo', 'Lienhardtz', 'Unterstatthaltcr', 'Blumenstein St Blumensteinkirche', 'St. Beaten berg', '- bcrg', 'Wagner Vrunnengasse', 'BuchserVe-Zurbrgg', 'Reichenbachfall', 'Ncgotiant', 'JonaS', 'Lttisbach', 'Wengernalp Scheideck', 'Pintenwirthin', 'Kandcrbrcke', 'Enggisicinbad', 'Bibcrist', 'Schafroth', 'Aarbrcke', 'GroSzean', 'Dnki', 'Gipsermstr', 'Fuhrweg', 'Ried bad', 'Bath', 'Aarburg Schwyz', 'Tschiffeli', 'Vrunng', 'Wildpret Vogel', 'Dieß', 'Breitfeld', 'Nudel', 'Ankcnlaube', 'Metzgermstr', 'StaldenhornS', 'SeftigeN', 'Biireii', 'Niederstmmenthal', 'Mädchenwaisenhauses', 'Lehnsdorf', 'Goldswyl', 'St Faulhorn', 'Guggisberg Schwarzenburg', 'Zurbrgg', 'Metzgcrg', 'G', 'Büchsenschmicd', 'Lyon Genf', 'Gentclthal', 'Zwiebelngäßlcin', 'Irrenanstalt Jnselspital', 'Weicnburg', 'Holligcndrittcl', 'Bor', 'St. Bielcrsee', 'Gicßbach', 'Sorne', 'Nffcnacht', 'St. Klus'}",4058
9119958,120644,"{'Burggasse', 'Augsburg', 'Diesbacb', 'Bellelay', 'Twann', 'Litzi', 'COagglingen', 'Rosiusplatz', 'Jolimont', 'Scbmiedengasse', 'Oelsberg', 'Freiburg', 'Pasquartallee', 'Vienne', 'Basenburg', 'Spitalgasse', 'Siel', 'Berlin', 'Sellelav', 'Lausanne', 'Ceberberg', 'Bircbe', 'Schweiz', 'Deuenstadt', 'Bidaugasse', 'Botschetta', 'ScbmieOengaffe', 'Paris', 'Baden', 'Stadholz', 'Bircbturm', 'Konstanz', 'Gawessis', 'Weihei', 'Bienne', 'Obergasse', 'Rathausgasse', 'Bern', 'Neuenstadt', 'Thorherg', 'Lomeringen', 'Dondon', 'Quellgasse', 'Oua', 'Leubringen', 'Bartstein', 'Stuttgart', 'Pasquart', 'Solothurn', 'Burgdorf', 'Bielersee', 'Bartblomebof', 'Biel', 'Scblofoberg', 'Frankreich', 'Dadretscb', 'Ridaugasse', 'Ridau', 'Pasquarttores', 'Aeuenstadt', 'Untergasse', 'Ligerz', 'Hacb', 'Aarberg', 'Erlacb', 'Marktgasse', 'Stadowe', 'Berberge', 'Aidau', 'Zelmdacb', 'Sckmiedengasse', 'Rebberg', 'Deuenburg', 'Didau', 'Sreiburg', 'Gallien', 'Freihurg', 'Lollegegasse', 'Basel', 'Ohergasse', 'Bafel', 'Zartstein', 'Weinberg', 'Deinisberg', 'Scbuigassen', 'Urhan', 'Benbicbt'}",87,"{'Deyers Wilbermett', 'DatthvsBause', 'Erguel', 'Säß', 'Kircke', 'Schloß Erguel', 'Brone', 'Der Scklotzberg', 'Raftellane', 'Batur', 'Zartstem', 'Murten', 'Ses Itillsrs', 'Fürstenhause', 'Düferlaube', 'RircbenTerraffe', 'Deyer Biet', 'Frankfurt', 'Bühl', 'Ligerz Twann', 'Oieselben', 'Diöau', 'Sürftentaaus', 'LellierBause', 'St Petersinsel', 'Gottesbausleute', 'Deinisberg Cengnau', 'Kalkofen', 'Schloße', '§ ärber Rihlaus', 'Lhor', 'Der Baumgarten Bözinger', 'Walkeplatz', 'Stddt', 'Scbürch', 'Dadstuhentürli', 'Liosters thorberg', 'jähre', 'Locbmüble', 'BeuenburgBidau', 'Münster', 'Zunflbaufes Ring Biel', 'Schütz Biei', 'Fornel', 'Rlosterturm', 'Rusdehnung', 'Sözingen', 'Grguels', 'Österreich', 'Heller', 'Ocbfenbein', 'Biel Tafel', 'Wobnbause', 'Müblebrücke', 'Estrichhoden', 'WalÖ', 'Garten Matten', 'Arckivturm', 'Zum Wald', 'Bieler Sebiet', 'Rebberges', 'Ober', 'Zunfthause', 'Seeländer Winzerhauses', 'Stabt', 'Lollege', 'IZosiusplatz', 'Seestratze', 'Dufourstroße', 'Jura Vorstadt', 'Venner Biel', 'Stratze', 'Slaser', 'Deßgern', 'Römer', 'Dühlebrücfcenplafe', 'Neuenstadt Ober', 'Detzger Engel', 'Scbaffis', 'StBenedikt', 'Dacbtelenweg', 'Wirtshause', 'Bauses', 'Dem Desitzer', 'Rircbturiu', 'Berrlihergers', 'Oherdorfe', 'KleimTwann', 'Jabrbunberte', 'Oas Innere', 'Bargenbrücke', 'Sprünglis', 'Untertor', 'Lhampagnefeld', 'Ringmauer', 'Spitalstratze', 'Jabrbunberts', 'Oescblecbts', 'Brest', 'Pasquarttor', 'Junkerngasse', 'Bingmauer', 'Bacbbem', 'Brunnquelle', 'Zeilglocksn', 'Vauffelin', 'Beuenßadt', 'Cbemilleret', 'Aare', 'Itinacb', 'Lourteiarv', 'Bargenbrügg', 'berrn', 'Mümpelgart', 'bervorjpringenö', 'Ligerz Reuenftadt', 'BIELE', 'Pulverturm', 'Jabre', 'Waltker', 'Erlacd', 'Museum 5cbwab', 'Dondons Turm', 'Römerstal', 'Belenus', 'Landstraße', 'Wildermettbause', 'Düble', 'Zürick', 'Balkofen', 'Scbulhaufe', 'finslers', 'Cmpore', 'Zürich', 'Weibel 1829 Orunörife Oes Baufes Twann', 'St Georgs', 'Cberle', 'Zeughaus Tafel', 'Verkebrsrücksicbten', 'Schädelismatthaus', 'Bargen', 'Orschinenturm', 'Meuwly Turm', 'Inbienne', 'Imerius', 'Das Aehischerhaus', 'Göttingen', 'Schloß Didau', 'Rronen', 'Slosters', 'Schulgaffe', 'Rodt Bern', 'Wallfahrtskapelle', 'Oie Säuser', 'Bellslav Bito flnf Jabrta 3unftwappen', 'IIIIII', 'Obertor', 'Obertorturm', 'BellelavZaus', 'Büren', 'Neuveville', 'Duttiturm', 'Jura, SLOC', 'Biel Mühle', 'Buttiturmes', 'Pasquarttor FinslersTurm Bidau', 'GGerßerreßau', 'Rircbe', 'Rnfange', 'Bordwest', 'Montpellier', 'Sremöe', 'Sadstubentürli', 'Oehle', 'Bartisturm', 'BIELLE', 'Rus', 'Vingelz', 'Deuenftaöt', 'Cydgrioßscbaft', 'Römerquelle', 'Bidautor', 'Boöenebr', 'Müller Stadtgraben', 'Zescboß', 'Mädchenschulhauses', 'Künftlerbanb', 'Banzlei', 'Beaune', 'Dathause', 'Vue sliöau Cöte Aarberg', 'Bözingen', 'Scbüt3enbaus', 'Sternjcben', 'Didautor § inslerturm', 'Cluny', 'Bornhause', 'Oiebeifiäche', 'Ziegelbütte', 'Sübfeite', 'Courtelary', 'Dloster Duch', 'Oasthaus', 'Verresius', 'Zaag', 'Aacböem', 'Gasse', 'Büttenherg', 'Ratbarina', 'Wyttenback', 'Saufe', 'Bofe'}",212,"{'Bieln', 'Bielna', 'Blaise', 'Cuternau', 'Landstrae', 'Schlotz', 'Oltingen', 'Zrich', 'Sis', 'Ilfingen', 'Llntergasse', 'Oher', '-', 'Zirzengraben', 'Biello', 'Blei', 'Beelna', 'Szinger', 'Landern', 'Tschampanien', 'S', 'Bcmalgasse', 'Oeschotz', 'Schwigho', 'Scklotzberg', 'Valentinian', 'Crlach', 'Cengnau', 'Dufourstroe', 'Bargen brgg', 'Rathaus', 'Dreiberg', 'Scbrch', 'Donbon', 'Petersinsel', 'Grissach', 'Gttingen', 'Sultzback', 'Heuenftat', 'Tuff', 'Bren', 'Diau', 'Bifang', 'Weih brg', 'Crlacb', 'Deuenhurg', 'Suchsee', 'lzarrweg', 'Boenebr', '- berg', 'Schmiedengasse', 'Barktgasse', 'St.', 'Obergli', 'Reuenftadt', 'Scbmieengaffe', 'Ober kurzweg', '5cbtz', 'Benz', 'Berlincourt', 'Babsburg', 'Rodt', 'Zrick', 'Bivang', 'Bafengietzi', 'Bloster', 'Zemp', 'Gloggen', 'Bttenherg', '- tor', 'Srunngasse', 'Burg', 'St.Benedikt', 'Scbulgasse', 'Port', '- turm', 'Lohsingen', 'Deuen', 'Bielno', 'Win', 'Caubfcber', 'Belna', 'Ligsrz', 'Deuenftadt', 'Dorden, ', 'Lourtelarv', 'Szingen', 'Weibel', 'Degern', 'Boxingen', 'Ben', 'Luzern', 'Wumard', 'Scblofo', 'Reh', 'Mlinen', 'Veningen', 'sterreich', 'Rettiswil', 'Sreuz', 'Rdiswil', 'Coiret', 'lTeuenburg', 'Wald', 'Sabsburg', 'Guttenberg', 'Te', 'Aacbem', 'Pasgier', 'Ouellgasse', 'Nidaugasse', 'Cbli', 'Nidau', 'Leum', 'Bzingen', 'Behberg', 'Rotherg', 'Llm', 'Bellslav', 'Bonmont', 'Brh', '- goffe', 'Loh', 'Mnster', 'Mnster-Grantelden', 'Corgemont', 'Duri', 'Tlntergasse', 'sstgrutz', 'Rosiusgasse', '5cbmiedengasse', 'Brain Aquileja', '- dern', 'Salzhaus', 'Lottstatt', '- burg', 'Rinacb', 'Maikirch', 'Biena', 'Greyerz', 'pagan', 'Jabren', 'Aberlis', 'sliau', 'Beuenstadt', 'Bernergiehel', '- strae', '- singen', 'Vikars', 'lfingen', 'Deuenftat', 'Rmerstal', 'Rurzem', '- gasse', 'Suslemont', 'Bus', 'Bauterive-Stein', 'Belena'}",158,"{'Erguel', 'Cuternau', 'Sis', 'Batur', 'Llntergasse', 'Oher', 'Ses Itillsrs', 'Fürstenhause', 'Schwigho', 'Scklotzberg', 'Kalkofen', '§ ärber Rihlaus', 'Scbürch', 'Cengnau', 'Rathaus', 'Dreiberg', 'Scbrch', 'Donbon', 'Petersinsel', 'Gttingen', 'Sözingen', 'Grguels', 'Ocbfenbein', 'Estrichhoden', 'Garten Matten', 'Bieler Sebiet', 'Seestratze', 'Lollege', 'Venner Biel', 'Stratze', 'Deßgern', 'Schmiedengasse', 'Detzger Engel', 'Benz', 'Rodt', 'Bivang', 'StBenedikt', 'Dacbtelenweg', 'Bttenherg', 'Bauses', 'Oherdorfe', 'Burg', 'Oas Innere', 'Bargenbrücke', 'Sprünglis', 'Untertor', 'Bielno', 'Jabrbunberts', 'Brest', 'Pasquarttor', 'Lourtelarv', 'Cbemilleret', 'Bargenbrügg', 'Pulverturm', 'Jabre', 'sterreich', 'Rettiswil', 'Dondons Turm', 'Rdiswil', 'Coiret', 'Wald', 'Cmpore', 'Zürich', 'Weibel 1829 Orunörife Oes Baufes Twann', 'Ouellgasse', 'Leum', 'Bzingen', 'Rotherg', 'Inbienne', 'Schloß Didau', 'Brh', 'Slosters', 'Loh', 'Mnster', 'Rosiusgasse', 'Obertorturm', 'Jura, SLOC', 'Pasquarttor FinslersTurm Bidau', 'Rircbe', 'Bordwest', 'Montpellier', 'Sadstubentürli', 'Lottstatt', 'Müller Stadtgraben', 'Boöenebr', 'Greyerz', 'Zescboß', 'Mädchenschulhauses', 'Künftlerbanb', 'Vue sliöau Cöte Aarberg', 'Bernergiehel', 'Cluny', 'Oiebeifiäche', 'Ziegelbütte', 'Sübfeite', '- strae', 'Dloster Duch', '- singen', 'Verresius', 'Zaag', 'Aacböem', 'lfingen', 'Gasse', 'Rmerstal', 'Rurzem', 'Büttenherg', 'Bingmauer', 'Deyers Wilbermett', 'Säß', 'Blaise', 'Schlotz', 'Oltingen', 'Raftellane', 'Zartstem', 'Biello', 'RircbenTerraffe', 'Deyer Biet', 'Frankfurt', 'Bühl', 'Sürftentaaus', 'Tschampanien', 'St Petersinsel', 'Deinisberg Cengnau', 'Valentinian', 'Lhor', 'Der Baumgarten Bözinger', 'Dufourstroe', 'Bargen brgg', 'jähre', 'Heller', 'Heuenftat', 'Bren', 'WalÖ', 'Zum Wald', 'Zunfthause', 'IZosiusplatz', 'Dufourstroße', 'Jura Vorstadt', 'Bifang', 'Deuenhurg', 'lzarrweg', 'Boenebr', 'Römer', 'Neuenstadt Ober', '5cbtz', 'Babsburg', 'Berlincourt', 'Bafengietzi', 'St.Benedikt', 'Scbulgasse', 'Port', 'Deuen', 'Junkerngasse', 'Ligsrz', 'Beuenßadt', 'Itinacb', 'Ben', 'Wumard', 'Scblofo', 'Reh', 'Erlacd', 'Museum 5cbwab', 'Belenus', 'Wildermettbause', 'Zürick', 'Te', 'Scbulhaufe', 'Aacbem', 'St Georgs', 'Zeughaus Tafel', 'Rronen', 'sstgrutz', 'Neuveville', '5cbmiedengasse', 'Brain Aquileja', 'Buttiturmes', 'GGerßerreßau', 'Rnfange', '- burg', 'Rinacb', 'BIELLE', 'Vingelz', 'Deuenftaöt', 'Cydgrioßscbaft', 'Römerquelle', 'Jabren', 'Banzlei', 'Beuenstadt', 'Bözingen', 'Bornhause', 'Oasthaus', 'Suslemont', 'Ratbarina', 'Wobnbause', 'Saufe', 'Bauterive-Stein', 'Bielna', 'DatthvsBause', 'Schloß Erguel', 'Landstrae', 'Brone', 'Murten', '-', 'Blei', 'Szinger', 'LellierBause', 'Bcmalgasse', 'Schloße', 'Crlach', 'Dadstuhentürli', 'Liosters thorberg', 'BeuenburgBidau', 'Zunflbaufes Ring Biel', 'Rlosterturm', 'Österreich', 'Biel Tafel', 'Sultzback', 'Rebberges', 'Ober', 'Crlacb', 'Suchsee', 'Slaser', '- berg', 'Barktgasse', 'St.', 'Reuenftadt', 'Ober kurzweg', 'Dühlebrücfcenplafe', 'Bloster', 'Zemp', 'Wirtshause', 'Dem Desitzer', 'KleimTwann', 'Jabrbunberte', '- turm', 'Lohsingen', 'Lhampagnefeld', 'Oescblecbts', 'Win', 'Belna', 'Deuenftadt', 'Dorden, ', 'Bacbbem', 'Szingen', 'Vauffelin', 'Luzern', 'berrn', 'Mümpelgart', 'Ligerz Reuenftadt', 'bervorjpringenö', 'Waltker', 'Landstraße', 'Sreuz', 'lTeuenburg', 'Sabsburg', 'finslers', 'Cberle', 'Schädelismatthaus', 'Bargen', 'Orschinenturm', 'Behberg', 'Imerius', 'Llm', 'Göttingen', '- goffe', 'Corgemont', 'Duri', 'Bellslav Bito flnf Jabrta 3unftwappen', 'Obertor', 'Büren', 'Biel Mühle', '- dern', 'Oehle', 'Maikirch', 'Sternjcben', 'Didautor § inslerturm', 'Courtelary', '- gasse', 'Belena', 'Bieln', 'Kircke', 'Der Scklotzberg', 'Zrich', 'Ilfingen', 'Zirzengraben', 'Düferlaube', 'Beelna', 'Ligerz Twann', 'Oieselben', 'Diöau', 'Landern', 'Gottesbausleute', 'S', 'Oeschotz', 'Walkeplatz', 'Stddt', 'Locbmüble', 'Münster', 'Schütz Biei', 'Grissach', 'Fornel', 'Rusdehnung', 'Tuff', 'Müblebrücke', 'Arckivturm', 'Seeländer Winzerhauses', 'Stabt', 'Diau', 'Weih brg', 'Obergli', 'Scbmieengaffe', 'Scbaffis', 'Zrick', 'Gloggen', '- tor', 'Srunngasse', 'Rircbturiu', 'Berrlihergers', 'Ringmauer', 'Spitalstratze', 'Caubfcber', 'Brunnquelle', 'Weibel', 'Zeilglocksn', 'Aare', 'Lourteiarv', 'Degern', 'Boxingen', 'Mlinen', 'BIELE', 'Veningen', 'Römerstal', 'Düble', 'Balkofen', 'Guttenberg', 'Pasgier', 'Verkebrsrücksicbten', 'Nidaugasse', 'Cbli', 'Nidau', 'Meuwly Turm', 'Das Aehischerhaus', 'Bellslav', 'Bonmont', 'Rodt Bern', 'Schulgaffe', 'Wallfahrtskapelle', 'Mnster-Grantelden', 'Oie Säuser', 'Tlntergasse', 'IIIIII', 'BellelavZaus', 'Duttiturm', 'Salzhaus', 'Sremöe', 'Bartisturm', 'Rus', 'Biena', 'Bidautor', 'pagan', 'Aberlis', 'sliau', 'Beaune', 'Dathause', 'Scbüt3enbaus', 'Vikars', 'Deuenftat', 'Wyttenback', 'Bus', 'Bofe'}",370
23306869,356339,"{'Neuengasse', 'Altenberg', 'Bellelay', 'Murten', 'Nydecklaube', 'Victoria', 'Kanada', 'Amerika', 'Kreuzweg', 'Emmenthal', 'Greisenasyl', 'Hindelbank', 'Muri', 'Burgerspital', 'Sulgenbach', 'Taunenhos', 'Frutigen', 'Map', 'Siechenhaus', 'Fr', 'Heimenschwand', 'Schweiz', 'Zeughausgasse', 'Riehen', 'Predigergasse', 'Waldau', 'Erlenbach', 'Bethesda', 'Paris', 'Rabbenthal', 'Thorberg', 'Erlach', 'Blumenberg', 'Roschiftistung', 'Tschugg', 'Bern', 'Neuenstadt', 'Wangen', 'England', 'Saignelsgier', 'Breitenrain', 'Riggisberg', 'Junkerngasse', 'Seeland', 'Aarbergergasse', 'Frienisberg', 'Npdeck', 'Brunngasse', 'Mues', 'Oberland', 'Burgdorf', 'Hofwyl', 'Bielersee', 'Kornhause', 'Frankreich', 'Genf', 'Lor', 'Witzwyl', 'Wabern', 'Bremgarten', 'Sppchergasse', 'Worb', 'Waldan', 'Lorraine', 'Postgasse', 'Liinggaffe', 'Wyler', 'Marktgasse', 'Beitenwyl', 'Thun', 'Gottesgnad', 'Deutschland', 'Hasli', 'Wartheim', 'Holligenbezirk', 'Basel', 'Salem', 'Canada', 'Kramgasse', 'Mittelland', 'Dresden'}",81,"{'Samariterverein', 'Waisenasyl', 'Weißenheim', 'geistkirch', 'Mattenhof Linde Kramgasse', 'Kinderpolikliuik', 'Könitzstraße', 'Oberaargau', 'Rothen Kreuz', 'Bümpliz Stadtbernische Gotthelfstiftung', 'Lazareths', 'Länggasse Mittelstraße', 'Könitz', 'Brückfeld', 'Münsingen', 'Münster', 'Armengut', 'Aeußern Krankenhauses', 'Hütte Chr', 'Steigerhubel', 'Nothfälle', 'Brod', 'Schoßhalde', 'KehrsatzKühlewyl', 'Murtenstraße', 'Kirchbühl', 'Marthahauses', 'Rechmckg', 'Freudenreich', 'Hasli Riggisberg', 'Bärenhösli', 'Großen Rath', 'Passantenbüreau', 'Münchenbuchsee', 'Wplergute', 'Wirthshaus', 'Nabbenthal', 'Ceutralkomite', 'Münsterkirche', 'Burgerspital Stift rc', 'Gemeinderath', 'Aeußere', 'Bürenhösli', 'Sulgeneck', 'Könitz Aarwangen', 'Marthahaus', 'Stalden Gerbern', 'Lazarethe', 'Neufeldstraße', 'Pfründer', 'Locle', 'Notharmenetat', 'Steiger', 'LänggaßBrückfeld', 'Miethzinses', 'Stratford Ontario', 'Noth', 'Nothfallstuben', 'Neuhausgutes', 'Länggaßschule', 'Weißenbühl', 'Neue Grube', 'Emmenthals', 'Räthen', 'Lorraineschänzli', 'Wichtrach', 'St Urban', 'Länggaß', 'Muttachhause', 'Aeußeres', 'Thal', 'Kapitali', 'Waisenasyls', 'Brüttelenbades', 'Kantonskasse', 'Laugnau', 'Engehalde', 'Burgerspital Bern', 'Bern Arbeiterheim', 'Krankenasyl', 'Obern Spital', 'Kühlewylgutes', 'Bern Junkerngasse', 'Nühschule', 'RisUffelmann', 'Zürich', 'Fellenbergs', 'Speyer', 'Burgerraths', 'Armenbüreau', 'Sulgenbach Marziele', 'Magdalenenasyl', 'Kreuzmatte', 'Stubenguts', 'MattenhofLinde', 'Brunnadern', 'Mischelholz', 'Blatternkranke', 'Kehl', 'Schönau', 'Haus Nr', 'Altenberghöhe', 'Notharmen', 'Haus Rychigen', 'Armengutes', 'Bern Dienst', 'Bernfserlernnng', 'Wurstemberger, SLOC', 'Elfenau', 'Jahrzehents', 'Näs Jferten', 'Hermannhanse', 'Büren', 'Ansscheidnngsvertrag', 'Standeskasse', 'Regu', 'Lazareth Weyermannshaus', 'Morija', 'Spirnls', 'Länggasse', 'MittelGerbern', 'Notharmenkasse', 'Steinhölzli', 'Jura', 'Miethpreise', 'Dominikaner Kaserne', 'NiederGerbern', 'Diakonissenhaus', 'Burgdorf Thun', 'Stubengutes', 'Mnesanstalt', 'Schloß Tschugg', 'Papiermühle', 'Wohlthat', 'Bnrgerraths', 'Werth', 'Kü', 'Bern Notharmen', 'Bern Hosxies', 'JenzerKubliStistung', 'Aarstraße', 'Rubigen', 'Mont Waadtland', 'Rüeggisberg', 'Lazareth', 'Standesrathhaus'}",146,"{'', 'Cciliatag', 'Kornhaus', 'Lan', 'Zrich', 'Morlot', 'Diebach', 'Nydeckkirche.', 'Weienbhl', '-', 'Rydeckkirche', 'Lngga', 'Thrberg', 'Gerbern', 'Alan', 'Kirchbhl', 'Mattenhof', 'Marzili', 'Linde', 'Rudolfstag', 'Maccaroni', 'Tollhaus', 'Samaritern', 'Reutlingen', 'Katharinatag', 'Wattenwyl', 'Neueuburg', 'Gens', 'Metzgergaffe', 'Sisselen', 'Ober-Gerbern', 'Sonvilier', 'Reggisberg', 'Lnggasse', 'Cts per', 'Cts', 'Mittelstrae', 'Tannenhof', 'St. Urban', 'Beirenwyl', 'Bren', 'Marziele', 'Bmplitz', 'Gwatt', 'Selhosen', 'Sulgenbach-Mattenhof', 'Ringgenberg', '- tenwyl', 'Ober', 'Ober-Gerwern', '- und Nieder-Pfistern', 'Bchtelen', '- bergs', 'Asyl', '- nenhof', 'Aarstrae', 'Marzili-Dalmazi', 'Tscharner', 'Porti', 'Bmpliz', 'Bubenberg', '- raine', 'Sara-Fonds', 'Rodt', 'Zieglerspal', '- dorf', 'Blun', 'Krippen', 'Fellen', 'Brnnen', 'Lngga-Brckfeld', 'Ems', 'St. Michael', 'Knizberg', 'Schohalde', 'Speichergasse', 'Mont', 'Knitzstrae', 'Langnan', 'Schnau', 'Metzgergasse', 'Graffenried-Legat', 'Mnsingen', 'Fellenberg-Stiftung', 'Mnchenbuchsee', 'Brau', 'St. Bmplitz', 'Sedorf', 'Kanton', 'Lanterburg Marktgasse', 'Knitz', 'Altenberghhe', 'Errata', 'Habsburg', 'Neufeldstrae', 'Wittikofen', 'Mnster', 'Tavel', 'Mhren', 'Murtenstrae', 'Nydeckkirche', 'Aarwangen', 'Berna', 'Langenthal', 'Waadtland', 'Berns', 'Mnsterkirche', 'Bnigen', 'Nidan', 'Kantons', 'Jnterlaken', 'Knitzberg', 'Breitfeld', 'Friedbhl', 'Jncharten', 'Hern', 'Linien, ', 'Seedors', 'Bei', 'delheit', 'Kern', 'Greisenaspl', 'Obstberg', 'Gerberngraben', '- gasse', 'Wevrr'}",126,"{'', 'Cciliatag', 'geistkirch', 'Weißenheim', 'Lan', 'Mattenhof Linde Kramgasse', 'Diebach', '-', 'Rydeckkirche', 'Thrberg', 'Mattenhof', 'Linde', 'Oberaargau', 'Maccaroni', 'Samaritern', 'Lazareths', 'Länggasse Mittelstraße', 'Könitz', 'Ober-Gerbern', 'Reggisberg', 'Münsingen', 'Mittelstrae', 'Tannenhof', 'Armengut', 'St. Urban', 'Hütte Chr', 'Beirenwyl', 'Steigerhubel', 'Nothfälle', 'Schoßhalde', 'Murtenstraße', 'Selhosen', 'Sulgenbach-Mattenhof', 'Rechmckg', 'Ober', 'Kirchbühl', 'Bchtelen', 'Passantenbüreau', 'Münchenbuchsee', 'Wplergute', '- bergs', 'Ceutralkomite', 'Münsterkirche', 'Marzili-Dalmazi', 'Burgerspital Stift rc', 'Aeußere', 'Porti', 'Bmpliz', 'Bubenberg', '- raine', 'Sulgeneck', 'Könitz Aarwangen', 'Sara-Fonds', 'Marthahaus', 'Lazarethe', 'Rodt', 'Neufeldstraße', 'Pfründer', 'Notharmenetat', 'Steiger', 'Krippen', 'Miethzinses', 'Noth', 'Brnnen', 'Lngga-Brckfeld', 'Ems', 'Nothfallstuben', 'Neuhausgutes', 'Weißenbühl', 'Neue Grube', 'Emmenthals', 'Räthen', 'Länggaß', 'Wichtrach', 'Mont', 'Muttachhause', 'Knitzstrae', 'Aeußeres', 'Schnau', 'Metzgergasse', 'Graffenried-Legat', 'Mnsingen', 'Fellenberg-Stiftung', 'Brau', 'Engehalde', 'Krankenasyl', 'Kühlewylgutes', 'Bern Junkerngasse', 'RisUffelmann', 'Zürich', 'St. Bmplitz', 'Fellenbergs', 'Lanterburg Marktgasse', 'Knitz', 'Stubenguts', 'Brunnadern', 'Mischelholz', 'Habsburg', 'Blatternkranke', 'Mnster', 'Schönau', 'Notharmen', 'Haus Rychigen', 'Tavel', 'Armengutes', 'Wurstemberger, SLOC', 'Berna', 'Hermannhanse', 'Büren', 'Ansscheidnngsvertrag', 'Waadtland', 'Berns', 'Standeskasse', 'Bnigen', 'Nidan', 'Kantons', 'Länggasse', 'MittelGerbern', 'Dominikaner Kaserne', 'Jura', 'NiederGerbern', 'Stubengutes', 'Mnesanstalt', 'Schloß Tschugg', 'Papiermühle', 'Wohlthat', 'Bnrgerraths', 'Jncharten', 'Hern', 'Seedors', 'Bei', 'Bern Notharmen', 'Kern', 'JenzerKubliStistung', 'Greisenaspl', 'Obstberg', 'Mont Waadtland', 'Rüeggisberg', 'Gerberngraben', '- gasse', 'Standesrathhaus', 'Samariterverein', 'Kornhaus', 'Waisenasyl', 'Zrich', 'Morlot', 'Nydeckkirche.', 'Weienbhl', 'Kinderpolikliuik', 'Lngga', 'Gerbern', 'Alan', 'Kirchbhl', 'Marzili', 'Rudolfstag', 'Könitzstraße', 'Rothen Kreuz', 'Tollhaus', 'Bümpliz Stadtbernische Gotthelfstiftung', 'Reutlingen', 'Katharinatag', 'Wattenwyl', 'Neueuburg', 'Gens', 'Metzgergaffe', 'Sisselen', 'Brückfeld', 'Sonvilier', 'Lnggasse', 'Cts per', 'Cts', 'Münster', 'Aeußern Krankenhauses', 'Bren', 'Marziele', 'Brod', 'Bmplitz', 'KehrsatzKühlewyl', 'Gwatt', '- tenwyl', 'Freudenreich', 'Ringgenberg', 'Bärenhösli', 'Marthahauses', 'Ober-Gerwern', 'Hasli Riggisberg', '- und Nieder-Pfistern', 'Großen Rath', 'Wirthshaus', 'Nabbenthal', 'Asyl', '- nenhof', 'Aarstrae', 'Tscharner', 'Gemeinderath', 'Bürenhösli', 'Stalden Gerbern', 'Zieglerspal', 'Locle', '- dorf', 'Blun', 'LänggaßBrückfeld', 'Stratford Ontario', 'Fellen', 'St. Michael', 'Knizberg', 'Länggaßschule', 'Schohalde', 'Speichergasse', 'Lorraineschänzli', 'St Urban', 'Langnan', 'Thal', 'Kapitali', 'Waisenasyls', 'Brüttelenbades', 'Kantonskasse', 'Mnchenbuchsee', 'Laugnau', 'Burgerspital Bern', 'Bern Arbeiterheim', 'Obern Spital', 'Nühschule', 'Sedorf', 'Kanton', 'Speyer', 'Burgerraths', 'Armenbüreau', 'Sulgenbach Marziele', 'Magdalenenasyl', 'Kreuzmatte', 'Altenberghhe', 'MattenhofLinde', 'Errata', 'Neufeldstrae', 'Wittikofen', 'Kehl', 'Haus Nr', 'Altenberghöhe', 'Mhren', 'Murtenstrae', 'Bern Dienst', 'Nydeckkirche', 'Bernfserlernnng', 'Elfenau', 'Jahrzehents', 'Aarwangen', 'Näs Jferten', 'Langenthal', 'Mnsterkirche', 'Regu', 'Lazareth Weyermannshaus', 'Morija', 'Spirnls', 'Notharmenkasse', 'Jnterlaken', 'Steinhölzli', 'Miethpreise', 'Knitzberg', 'Breitfeld', 'Diakonissenhaus', 'Burgdorf Thun', 'Friedbhl', 'Werth', 'Linien, ', 'Kü', 'delheit', 'Bern Hosxies', 'Aarstraße', 'Rubigen', 'Lazareth', 'Wevrr'}",272
11136199,107875,"{'Siebenthal', 'Waadt', 'Gunten', 'Habsburgs', 'Murten', 'Neuenegg', 'Biideli', 'Thal', 'Giessbacli', 'Paris', 'Simme', 'Spiez', 'Oberlioferstrasse', 'Justisthal', 'Thun', 'Merlinen', 'Frankreich', 'Thunersee', 'Waterloo', 'Weissenau', 'Xidau', 'Doldenhorn', 'Ralligthurm', 'Rothhorns', 'Burgund', 'Scliarnachthal', 'Neuhaus', 'Freienhof', 'Bern', 'Neuseeland', 'Scharnachthai', 'Villa Beata', 'Sigriswil', 'Aarethal', 'Beatenberg', 'Villmergen', 'Laucherhorn', 'Bliimlisalp', 'Oberhofen', 'Giessbach', 'Eschenbach', 'Langgasse', 'Wallis', 'Aarebassin', 'Beateuberg'}",45,"{'Die Lerau', 'Tlnmersee', 'Interlaken', 'Hohenegg Rothenegg', 'Ralligthurmes', 'Rothliorn', 'Beatus Hotel', 'Füssen', 'Thunersees, SLOC', 'Hünegg Das Schloss', 'Thun Schlosses', 'Schloss Spiez', 'Klause', 'Ivohleren', 'Jung unAlti', 'Rothhorn', 'Katar', 'ScherzligerBrücke', 'Oberhofens', 'NeuRüttli', 'Hilterfingen', 'Bergli', 'Sigriswiler Grates', 'Alpenkette', 'Hilterfingen Der Weg', 'Frutiger Oberhofen', 'Blumenfeld', 'Chartreuse', 'Aesehi', 'St Beat', 'Tlieil', 'Fluh Fluh', 'Santa Clara', 'Thun Fuss', 'Aeschi', 'Göttibach', 'Bannwald', 'Hotel Bellevue', 'HabsburgLaufenburg', 'Dezennien', 'Karthause', 'Hessen', 'Scharnachtlial', 'Siechenwäldli', 'V3v', 'Aare', 'Thun Thun', 'Israels', 'Rigi', 'Spiez Oberhofen', 'Buchenwald', 'Hünibach', 'Hegau', 'Vierwaldstättersee', 'SclierzligerBrücke', 'Tliuuerscestrasse', 'Schadau', 'Ivyburgs', 'Strättligen', 'Thalsoole', 'Unthier', 'Kirchtlmrni Sigriswil', 'Stammburg', 'Kiesen', 'Morgenberghorn', 'Grüsisberg', 'Bödeli', 'Schioss Oberhofen', 'Frutiger Strasse', 'Thuner Kirchhof', 'Seftigen', 'Säckingen', 'HiinibacliWald Hohleren', 'Villa Bcata', 'Heatenbach', 'Balligen', 'Zähringen', 'WieHagenbach', 'Hagenbach', 'IlabsburgOesterreicli', 'Tieche', 'Simmenthal', 'Schloss Hün', 'Bergli Schafloch'}",84,"{'Hochburgund', 'Scherzi', 'Lerau', 'Merligen', 'Mattland', 'Gttibach', 'Neu-Rttli', '- strasse', 'Eindorf', 'Beata', 'Fiesen', 'Horneggern', 'Alensclien', 'Brugg', 'Strttlingen', 'Balm', 'Amstutz', '-', 'Berna', 'Gras', 'Blm', 'St. Jakobstag', 'Schwaben', 'Esclienbacli', 'Alemanien', 'Sckingen, ', 'Hohenegg', 'Pourtales', 'Karls', 'HiinibacliWald', 'Oesterreich', 'Hombergern', 'Rougemont', 'Thorberg', 'Erlach', 'Sclierzliger-Brcke', 'Bellevue', 'Rothenegg', 'Hbsch', 'Fuss', 'Beatenbach', 'Scherzliger-Brcke', 'Hnibach', '- lisalp', 'Zhringen', 'Xancy', 'Hnegg', 'Schar', 'burg', 'Kirch', 'Hohleren', 'Ilochalpen', 'Flachland', 'Bdeli', '- nachthal', 'Habsburg-Laufenburg', 'Faidhorn', 'Grsisberg', 'Felsenburgen', '- tisthal', 'Siechenwldli', 'Preussen', 'Scharnaclithal'}",63,"{'Lerau', 'Merligen', 'Balm', 'Interlaken', '-', 'Rothliorn', 'Esclienbacli', 'Sckingen, ', 'Füssen', 'Thunersees, SLOC', 'Hünegg Das Schloss', 'Rothhorn', 'ScherzligerBrücke', 'Hnegg', 'Oberhofens', 'NeuRüttli', 'Faidhorn', 'Gttibach', 'Hilterfingen', 'Neu-Rttli', 'Bergli', 'St. Jakobstag', 'Sigriswiler Grates', 'Alpenkette', 'Blumenfeld', 'Aesehi', 'Tlieil', 'Erlach', 'Fluh Fluh', 'Santa Clara', 'Thun Fuss', 'Zhringen', 'Xancy', 'Flachland', '- nachthal', 'Dezennien', 'Fiesen', 'Thun Thun', 'Schwaben', 'Hohenegg', 'Buchenwald', 'Sclierzliger-Brcke', 'Hegau', 'Ivyburgs', 'Kirch', 'Strättligen', 'Thalsoole', 'Grsisberg', 'Kirchtlmrni Sigriswil', 'Stammburg', 'Kiesen', 'Eindorf', 'Grüsisberg', 'Berna', 'Amstutz', 'Pourtales', 'HiinibacliWald Hohleren', 'Villa Bcata', 'Heatenbach', 'Balligen', '- lisalp', 'Zähringen', 'Schar', 'IlabsburgOesterreicli', 'Tieche', 'burg', 'Habsburg-Laufenburg', 'Simmenthal', 'Schloss Hün', 'Felsenburgen', 'Scherzi', 'Die Lerau', 'Beata', 'Tlnmersee', 'Brugg', 'Strttlingen', 'Hohenegg Rothenegg', 'Ralligthurmes', 'Beatus Hotel', 'Alemanien', 'HiinibacliWald', 'Thun Schlosses', 'Schloss Spiez', 'Klause', 'Ivohleren', 'Jung unAlti', 'Beatenbach', 'Scherzliger-Brcke', 'Katar', 'Ilochalpen', 'Bdeli', 'Preussen', 'Mattland', 'Blm', 'Hilterfingen Der Weg', 'Frutiger Oberhofen', 'Chartreuse', 'St Beat', 'Thorberg', 'Bellevue', 'Rothenegg', 'Hbsch', 'Hnibach', 'Aeschi', 'Göttibach', 'Hohleren', 'Bannwald', 'Hotel Bellevue', 'HabsburgLaufenburg', 'Hessen', 'Karthause', 'Scharnachtlial', 'Siechenwäldli', 'V3v', 'Aare', 'Alensclien', 'Gras', 'Israels', 'Rigi', 'Spiez Oberhofen', 'Karls', 'Rougemont', 'Hünibach', 'Vierwaldstättersee', 'Fuss', 'SclierzligerBrücke', 'Tliuuerscestrasse', 'Schadau', 'Unthier', 'Scharnaclithal', 'Hochburgund', '- strasse', 'Morgenberghorn', 'Bödeli', 'Horneggern', 'Schioss Oberhofen', 'Frutiger Strasse', 'Thuner Kirchhof', 'Oesterreich', 'Hombergern', 'Seftigen', 'Säckingen', 'WieHagenbach', 'Hagenbach', '- tisthal', 'Siechenwldli', 'Bergli Schafloch'}",147
9279581,53021,"{'Pfandersmatt', 'Schenkenberg', 'Schweiz', 'Selhosen', 'Konolfingen', 'Aare', 'Belpaue', 'Steinbach', 'Mvntenach', 'Belp', 'Savoyen', 'Zihl', 'Belps', 'Freiburg', 'Thnnersee', 'Hohbnrg', 'Thun', 'Ungarn', 'Jura', 'Montagny', 'Muri', 'Vizaula', 'Deutschland', 'Englisberg', 'Thunersee', 'Seftigen', 'Mon', 'Luternau', 'Schwarzenburg', 'Zimmerwald', 'Hvhburg', 'Burgund', 'Bern', 'Wabern', 'Mnri', 'Steruenberg', 'Montenach', 'Kaufdorf', 'Alpen', 'Lausanne', 'Habsburg', 'Chillon', 'Kramburg', 'Saane', 'Riggisberg', 'Kiburg', 'Belpberg', 'Peterlingen'}",48,"{'Pandora', 'Stammburg', 'Feste Belp', 'Gex', 'Dornbühl', 'Kehrsatz Selhofen', 'Georgen Spring', 'Niedermuhlern', 'Län', 'Römerzeit', 'Schloßgut', 'Schützensahr', 'Thal', 'Kander', 'Glclschcrpcriode', 'Stockhornkette', 'Riviera', 'Längenberges', 'Arner PestalozzisLienhard', 'Köniz', 'Römer', 'Tulla', 'Helvetier', 'Jnterlaken', 'Bern, SLOC', 'Siechenhause', 'Belp Kram', 'KirchcZ', 'Gürbenthales', 'Östfranken', 'Alemanne', 'Leutkirche', 'Mittelmeer', 'Siechenhaus Siechen', 'Längenberg', 'Zähringen', 'Rhonegletscher', 'Belpbergcs', 'Englisberg Kühlewyl', 'Gürbenthal', 'Schloßgutes', 'Buchegg', 'Aarethal', 'Münsingen', 'Strättligen', 'Gürbethal', 'Guggisbergs', 'Aare Mittelfranken', 'Wohlhausen', 'Kühlewyl', 'Deutsche Reich', 'Weißenburg', 'Rüeggisberg', 'Aarebett', 'Schloß Belp', 'Siechenhaus', 'Chillon Mendrisio'}",57,"{'Ln', '-', 'Khlewyl', 'Seelhofen', 'Grbe', 'Gerzensee', 'Wattenwyl', 'Selhofen', 'Weienburg', 'Tos fen', 'Toffen', 'Reggisberg', 'Grbethal', 'Donder', 'Lotzwyl', 'Aareufer', 'Vechigcn', 'Turme', 'Dornbhl', 'Em', 'Walo', 'Belpsee', 'Kniz', 'Ober', 'Mhledorf', 'Kien', 'Peter', 'Brgg', 'Grbethal, ', 'Stffis', '- berg', 'Kirchdorf', 'Nieder', 'Stein', 'Bttikon', 'Sumpflandes', 'Zhringen', '- genberg', 'Nikl', 'Bend', 'Bnrgistein', 'Oberblacken', '- porkirche', 'Tuffen', 'Bannmoos', 'Guggisberg', 'Lngenberg', 'Mnsingen', 'Grbenthal', '- stein', 'Pest', '- wangen', 'Rmligen', 'Jan', 'Jnkwyl', 'Mllinen', 'Giematt', 'Groaffoltern', 'Hof', 'Sniswyb', 'Berns', 'Geri', 'Bruig', 'Monteuach', 'Oesterreich', '- burg', 'Amsoldingen', 'Lohugut', 'Obermuhlern', 'Burgistein', 'Belpmoos', 'Klliwyl', 'Kram', 'Montenachs', '- tenach', 'Balsiger', 'Wimmis', 'Roten'}",78,"{'Pandora', 'Ln', '-', 'Kander', 'Khlewyl', 'Längenberges', 'Arner PestalozzisLienhard', 'Köniz', 'Seelhofen', 'Grbe', 'Gerzensee', 'Wattenwyl', 'Alemanne', 'Selhofen', 'Längenberg', 'Tos fen', 'Weienburg', 'Schloßgutes', 'Toffen', 'Reggisberg', 'Münsingen', 'Grbethal', 'Donder', 'Lotzwyl', 'Aareufer', 'Wohlhausen', 'Vechigcn', 'Turme', 'Siechenhaus', 'Dornbhl', 'Em', 'Walo', 'Belpsee', 'Feste Belp', 'Kniz', 'Dornbühl', 'Ober', 'Mhledorf', 'Kien', 'Peter', 'Brgg', 'Grbethal, ', 'Stffis', '- berg', 'Kirchdorf', 'Römer', 'Tulla', 'Nieder', 'Belp Kram', 'Stein', 'Bttikon', 'Siechenhaus Siechen', 'Sumpflandes', 'Zhringen', '- genberg', 'Buchegg', 'Aarethal', 'Guggisbergs', 'Schloß Belp', 'Nikl', 'Bend', 'Gex', 'Bnrgistein', 'Georgen Spring', 'Oberblacken', '- porkirche', 'Tuffen', 'Römerzeit', 'Bannmoos', 'Schloßgut', 'Schützensahr', 'Thal', 'Guggisberg', 'Lngenberg', 'Mnsingen', 'Helvetier', 'Grbenthal', 'Bern, SLOC', 'Siechenhause', '- stein', 'Pest', 'Gürbenthales', 'Östfranken', 'Leutkirche', '- wangen', 'Mittelmeer', 'Rmligen', 'Gürbenthal', 'Strättligen', 'Jan', 'Aare Mittelfranken', 'Weißenburg', 'Jnkwyl', 'Mllinen', 'Stammburg', 'Kehrsatz Selhofen', 'Giematt', 'Niedermuhlern', 'Groaffoltern', 'Hof', 'Län', 'Sniswyb', 'Berns', 'Geri', 'Bruig', 'Glclschcrpcriode', 'Stockhornkette', 'Riviera', 'Monteuach', 'Oesterreich', '- burg', 'Amsoldingen', 'Lohugut', 'Jnterlaken', 'Obermuhlern', 'Burgistein', 'KirchcZ', 'Belpmoos', 'Zähringen', 'Klliwyl', 'Rhonegletscher', 'Belpbergcs', 'Kram', 'Montenachs', 'Englisberg Kühlewyl', 'Gürbethal', '- tenach', 'Balsiger', 'Wimmis', 'Kühlewyl', 'Deutsche Reich', 'Roten', 'Rüeggisberg', 'Aarebett', 'Chillon Mendrisio'}",135
11218655,17451,"{'Diessbach', 'Schweiz', 'Breenberg', 'Paris', 'Wattenwyl', 'Aegypten', 'Olivenberg', 'Luternau', 'Bielersee', 'Basel', 'Bredaei', 'Biel', 'Bern'}",13,"{'Bredaei Schlachtenbild', 'Fr', 'Ecole espagnole Christ', 'Pferderast', 'Figurenbild', 'Caravaggio Magdalenenkopf', 'Spanische', 'Nain Nativite', 'Portrait Manuel', 'Französische Schule Apparition Christ', 'Schultheiss Manuel', 'Böhlen', 'Ferd RothFehr Rurgdorf', 'Schloss Reichenbach', 'Byss Blumen', 'Melanchton', 'Jesuskind Murillo', 'Titian Flucht Egypten', 'Holländische Schule', 'Solimena Johannes des Täufers', 'Hartmann Landschaft Jura', 'Tizian StJeröme', 'Diessbach, SLOC', 'Magnus', 'Herodes', 'Graff Frauenbildniss', 'Schloss Schule', 'Artois Jacob Landschaft RembrandSchule', 'Dolce Carlo Santa Lucia', 'Hussards', 'Kunstmuseum Bern', 'König Familienbild', 'Cignani Betende Magdalena', 'Muralt Largilliere', 'Cuyp Kühe', 'Fräulein lohanna Schnell Burgdorf', 'Haller Privatier', 'Damenbildniss', 'Madonnakopf', 'Kuine', 'Krafft', 'Alte Frau', 'Gross', 'Magdalena', 'Eise Leibundgut', 'Cariani Krippe Bethlehem', 'Alte Siebenthalerin', 'Spanische Schule Studienkopf', 'Schule des Francia Madonna', 'Canaletto Vue Venise', 'Münster', 'Schultheiss Manuels Frau', 'HopfManuel', 'Proi Dr Lotmar'}",54,"{'Brunnen', 'Wouwermann', 'Roos', 'Ecole', 'Orleans', 'Magran', 'Interlaken', 'Venise', '-', 'Fische', 'Wurstemberger', 'Blumen', 'Brunner-Abys', 'Cantarini', 'Markt', 'Ins', 'Lazaroni', 'Christ', 'Ebersold', 'lloll', 'Jenner', 'Rieter', 'Modena', 'Copie', 'Murillo', 'Muristalden', 'Diessbach, ', 'Simone', 'Diesbach', 'Oatharina', 'Reisinger', 'Fyt', 'Christi', 'Cauw Alb', 'Obergerwern', 'Michau', 'Kneipe', 'Fluss', 'Patricien', 'Tscbarner', 'Lilie', 'Zeerleder', 'Oelenhainz', 'Grtz', 'Jesuskind', 'Saxe', 'Caval', 'Innocenzo', 'Watzdorf', 'Goumoens-Wurstemberger', 'Rusca', 'Holl', 'Paradies', 'Prmttaitz', 'Kranach', 'Gross-Trevelin', 'Mntach', 'Cariani', 'Molenaer', 'Rurgdorf', 'Poussin', 'Canaletto', 'Mnch', 'Rodt', 'Barnabas', 'Fischer', 'Madonna', 'Biissende', 'Steiger', 'Capello', 'Madonnenkopf', 'Niederlndisch', 'Thurm', 'Glutz-Blozheim', 'Tevella', 'Aug', 'Seeland', 'Sarburg', 'Gross-Marcuard', 'Aberli', 'Knyff', 'Lerber', 'Tulpen', 'Wegmhle', 'Indenuca', 'Windmhle', 'Stillleben', 'Pietro', 'Luzern', 'Ducros', 'Dilnz', 'FranWcucci', 'Cranach-Schule', 'Mlinen', 'Schloss', 'Burgdorf', 'Gruber', 'Diesbacli', 'Tomyris', 'Reichenbach', 'bernois', 'Wyitenbach', 'Genf', 'Raffael', 'Pesaro', 'Rembrand-Schule', 'Fossano', 'Werner', 'Heilige', 'Rubens', 'Egypten', 'Brisot', 'Piazetta', 'Drr', 'Italienisch', 'Mnster', 'Tavel', 'Muralt', 'Wber-Lindt', 'Werdt', 'Gardelle', 'Bethlehem', 'Roth-Fehr', 'Mola', 'Chiens', 'Primaticcio', 'lay-Thormann', 'Niki', 'Jura', 'Thunersee', 'Klaes', 'Ferd', 'Leman-Bollag', 'Luini-Schule', 'Paolo', 'Sndenfall', 'Grenus-Bridel', 'Jeune', 'Veronese', 'Bourguignon', 'Cyrus', 'Cuyp', 'Boucher', 'Diogg', 'Marmor', 'Krippe', 'Wyss', 'Montespan', 'Brouwer', 'Ltschg', 'Paysage', 'Molyn', 'Holbein'}",153,"{'Brunnen', 'Bredaei Schlachtenbild', 'Wouwermann', 'Figurenbild', 'Paysage', 'Roos', 'Ecole', 'Orleans', 'Magran', 'Interlaken', '-', 'Venise', 'Jesuskind Murillo', 'Fische', 'Wurstemberger', 'Blumen', 'Brunner-Abys', 'Cantarini', 'Markt', 'Solimena Johannes des Täufers', 'Ins', 'Tizian StJeröme', 'Diessbach, SLOC', 'Lazaroni', 'Christ', 'Ebersold', 'lloll', 'Jenner', 'Rieter', 'Copie', 'Murillo', 'Haller Privatier', 'Muristalden', 'Diessbach, ', 'Simone', 'Magdalena', 'Diesbach', 'Oatharina', 'Reisinger', 'Eise Leibundgut', 'Spanische Schule Studienkopf', 'Canaletto Vue Venise', 'Fyt', 'Christi', 'Münster', 'Cauw Alb', 'Obergerwern', 'Michau', 'Kneipe', 'Fluss', 'Patricien', 'Tscbarner', 'Lilie', 'Zeerleder', 'Fr', 'Pferderast', 'Ecole espagnole Christ', 'Oelenhainz', 'Spanische', 'Portrait Manuel', 'Schultheiss Manuel', 'Grtz', 'Jesuskind', 'Schloss Reichenbach', 'Saxe', 'Caval', 'Innocenzo', 'Watzdorf', 'Goumoens-Wurstemberger', 'Rusca', 'Holl', 'Paradies', 'Prmttaitz', 'Kranach', 'Gross-Trevelin', 'Mntach', 'Cariani', 'Molenaer', 'Rurgdorf', 'Poussin', 'Canaletto', 'Graff Frauenbildniss', 'Mnch', 'Rodt', 'Artois Jacob Landschaft RembrandSchule', 'Hussards', 'Barnabas', 'Muralt Largilliere', 'Fischer', 'Damenbildniss', 'Kuine', 'Biissende', 'Madonna', 'Steiger', 'Capello', 'Alte Frau', 'Madonnenkopf', 'Niederlndisch', 'Gross', 'Schule des Francia Madonna', 'Thurm', 'Glutz-Blozheim', 'Tevella', 'Aug', 'Seeland', 'Sarburg', 'Caravaggio Magdalenenkopf', 'Gross-Marcuard', 'Aberli', 'Knyff', 'Lerber', 'Tulpen', 'Französische Schule Apparition Christ', 'Wegmhle', 'Indenuca', 'Windmhle', 'Melanchton', 'Stillleben', 'Pietro', 'Luzern', 'Ducros', 'Dilnz', 'FranWcucci', 'Cranach-Schule', 'Mlinen', 'Schloss', 'Burgdorf', 'Gruber', 'Hartmann Landschaft Jura', 'Diesbacli', 'Magnus', 'Herodes', 'Tomyris', 'Reichenbach', 'bernois', 'Schloss Schule', 'Wyitenbach', 'Genf', 'Raffael', 'Dolce Carlo Santa Lucia', 'Pesaro', 'Rembrand-Schule', 'Fossano', 'Werner', 'Heilige', 'Rubens', 'Egypten', 'Brisot', 'Piazetta', 'Cariani Krippe Bethlehem', 'Alte Siebenthalerin', 'Drr', 'HopfManuel', 'Italienisch', 'Mnster', 'Proi Dr Lotmar', 'Tavel', 'Muralt', 'Wber-Lindt', 'Werdt', 'Gardelle', 'Bethlehem', 'Nain Nativite', 'Roth-Fehr', 'Böhlen', 'Ferd RothFehr Rurgdorf', 'Byss Blumen', 'Titian Flucht Egypten', 'Mola', 'Chiens', 'Holländische Schule', 'Primaticcio', 'lay-Thormann', 'Niki', 'Jura', 'Thunersee', 'Klaes', 'Ferd', 'Leman-Bollag', 'Luini-Schule', 'Kunstmuseum Bern', 'König Familienbild', 'Cignani Betende Magdalena', 'Fräulein lohanna Schnell Burgdorf', 'Cuyp Kühe', 'Paolo', 'Sndenfall', 'Grenus-Bridel', 'Jeune', 'Veronese', 'Bourguignon', 'Cyrus', 'Cuyp', 'Boucher', 'Madonnakopf', 'Krafft', 'Diogg', 'Marmor', 'Schultheiss Manuels Frau', 'Krippe', 'Wyss', 'Montespan', 'Brouwer', 'Ltschg', 'Modena', 'Molyn', 'Holbein'}",207
13805570,450596,"{'Pfandersmatt', 'Lauenberg', 'Tschingelgrabens', 'Gsteig', 'Palpia', 'OImux', 'Murten', 'Kyburg', 'Uetendors', 'Kauffdorf', 'Gerzensees', 'Paperne', 'Thur', 'Blumenstein', 'Riggisperg', 'Zentralasien', 'Aarbach', 'Vechigen', 'Zofingen', 'Freiburg', 'Oberdorf', 'Jaberg', 'Karlsruhe', 'Scherst', 'Kleinburgund', 'Europa', 'Muri', 'Hellenberg', 'Gerzensee', 'Mainz', 'Hauliftal', 'Giebelegg', 'Wattenwyl', 'Aarebett', 'Luternau', 'Schwarzenburg', 'Selhofen', 'Lohnstorf', 'Pneggisberg', 'Schweden', 'Elisried', 'Jcgenstorf', 'Selzach', 'Clugnp', 'Sestigen', 'Kirchberg', 'Balmegg', 'Schwanden', 'Diesbach', 'Niedermuhleren', 'Kehrsatz', 'Aareufer', 'Wattenivil', 'Burgisteins', 'Lausanne', 'Chillon', 'Kramburg', 'SternenLerg', 'Helgisried', 'Bennewyl', 'Nordamerika', 'Ulinitz', 'Schweiz', 'Scherlibach', 'Ober', 'Wien', 'Friesenberg', 'Riedberg', 'Ratzenberg', 'Westschweiz', 'Neuenburg', 'Mettlen', 'Hermis', 'Schwarzwaldes', 'Bayern', 'Amsoldingeu', 'Bennenwyl', 'Simmental', 'schweiz', 'Baden', 'Heidelberg', 'Laupen', 'Kirchdorf', 'Kirchweg', 'Bubenberg', 'Nieder', 'Wattemvyl', 'Erlach', 'Konstanz', 'Englisberg', 'Bellevue', 'Haulistal', 'Gertzensebb', 'Uttigen', 'Buchsee', 'Zimmerwald', 'Niedergurzelen', 'Burgund', 'Gurnigels', 'Tofsen', 'Wattenwil', 'Bern', 'Tellenburg', 'Holland', 'Lohnstors', 'Wangen', 'Twing', 'England', 'Schlesien', 'Aargau', 'Montaguy', 'Hnnziken', 'Riggisberg', 'Rothenbach', 'Sempach', 'Montblanc', 'Thnrnen', 'Blankenburg', 'Schwand', 'Persien', 'Thierachern', 'Pfrundland', 'Bernerlandes', 'Gravclingen', 'Gelterfingen', 'Konolfingen', 'Scharnachtal', 'Schlingmoos', 'Sternenberg', 'Aare', 'Rain', 'Neuenegg', 'Grafenried', 'Wichtrach', 'Savoyen', 'Pfanders', 'Luzern', 'Zwieselberg', 'Hettiswil', 'Sumiswald', 'Oberland', 'Sursee', 'Bennewil', 'Burgdorf', 'Solothurn', 'Hohliebe', 'Riggis', 'Kanfdorf', 'Bielersee', 'Englis', 'Biel', 'Wattenwpl', 'Torfbach', 'Bellinzona', 'Frankreich', 'Sestigon', 'Genf', 'Obergurzelen', 'Kpburg', 'Gurnigcl', 'Aaretal', 'Ried', 'Voralpen', 'Uri', 'Wabern', 'Zim', 'Klaps', 'Simmen', 'Thunersecs', 'Bremgarten', 'Wandt', 'Fallbach', 'Metten', 'Reitnau', 'Kaufdorf', 'Burgi', 'Winzenried', 'Alpen', 'Lombardei', 'Habsburg', 'Gurzelen', 'Rohrbach', 'Kiburg', 'Kaufdors', 'Belpberg', 'Spanien', 'Kiesen', 'Lenzburg', 'Berghalde', 'llctendorf', 'Werdt', 'Gelter', 'Kehrsah', 'Thurnen', 'Belp', 'Noslen', 'Gurnigel', 'Winlisburg', 'Kiggisberg', 'Oberbalm', 'Uetendorf', 'Wattenrvyl', 'Endlis', 'Oesterreich', 'Thun', 'Heimberg', 'Amsoldingen', 'Jura', 'Uttingen', 'Deutschland', 'Kehr', 'Unterwalden', 'Thunersee', 'Obermuhlern', 'Berner', 'Hasli', 'HohlV', 'Gerzen', 'Burgistein', 'Seftigen', 'Gislikon', 'Felsenburg', 'Klostergasse', 'Haide', 'Utah', 'Muriboden', 'Sommerau', 'Gnrtental', 'Jagdberg', 'Avignon', 'Burgiwyl', 'Montenach', 'Lhurnen', 'Belpberges', 'Elbschen', 'Waldshut', 'Villmergen', 'Aarau', 'Niederwangen', 'Eichberg', 'Wimmis', 'Moosleerau', 'Wallis', 'Saane', 'Ehevilly', 'Steinbach', 'Marly'}",247,"{'Fultigen', 'Schübelmatte', 'Dorfbaches', 'Gurnigelbad', 'Pruntrut', 'Elsaß', 'Siirbe', 'Oberaargau', 'Seftigcn', 'Rüti Thalgut', 'Haus Kramburg', 'Mattstetten', 'Gürbetalbahn', 'Birrwil Hallwilersee', 'Riggisberg Lramburg', 'KehrsatzRüeggisberg', 'Alemanne', 'Alpenkranze', 'Gclterfingen', 'Uttigen Schönegg', 'Jordans', 'Lötschenpaß', 'Dorfbach', 'Längenberg', 'BernLand', 'Blumenstein Schönegg', 'Rüggisberg Ober', 'Riggisberg Kirche von Thurnen', 'Zihl Bern', 'Reutigen', 'Sckale', 'Rümligen', 'Bern Rümligen', 'Thun Beide', 'Uins', 'Belpberg Jmihubel', 'BernBelpstraße', 'Kühlewil', 'Bütschelcgg', 'Amsoldingen Thier', 'Rüschegg', 'Steiger Frisching', 'Gurnigelbade', 'Dornbühl', 'Schausel', 'Riggisberg Rüti', 'Mühledorf Kirchdorf', 'Moränensnmpses', 'Niedersimmental', 'America', 'Dünkirchen', 'Jmihubel Belpberg Belpberg', 'Niedermuhlern Belp', 'LaanZstsour', 'Boralpen', 'Mühledorf', 'Zentner Glockenerz', 'Seftigen Wenden', 'BurgisteinWattenwil', 'Nauion', 'WattenwilThun', 'Berge Breit', 'Kirchentnrnen', 'Gümmenen', 'Haulis', 'Glirbetalbahil', 'Broyebrücke', 'Münsingcn', 'Ganterisch', 'Nüwenegg', 'Nünenensluh', 'Bnrgistein', 'Weißenbühl', 'Dießenberg', 'Giebelegg Dieser', 'Amleten', 'Dörflein', 'Seftiger Landgerichtes', 'Rohrbachtal', 'Alles Land', 'Meuron', 'Seftigen Hofstätten', 'Römerstraße', 'Nvrdabhange', 'Rentigen', 'Seftigen Ganz', 'Mühlebach', 'Rutschhalde', 'Belp Länge', 'Strättligen', 'Slumensteinbrücke', 'Beste Burgistein', 'Rüggisberg', 'Emmentalerkäse', 'Festigen', 'Balz', 'Weber Bern', 'Nüggisberg', 'Kühlewil Hier', 'Aubonne', 'Grünenberg', 'BelpMontenach', 'Kienersrütti', 'Brünig', 'Hauptstraße', 'Mühlethurnen', 'Spiez', 'ThnrnenSeftigen', 'Burgistein Ober', 'Riggisberg Rüeggisberg', 'Aarcgletschers', 'Übersdors', 'Rattenholzist', 'Kreuzwege', 'Thunstetten', 'Verdun', 'UnterGurzelenft', 'Bodenzinse', 'Trvingen', 'Zähringen', 'RümligenBach', 'Niedermnhlern', 'Gürbetales', 'Nagclfluh', 'BernThunBahn', 'Seftigen Riggisberg', 'Düsseldorf', 'RiggisbergSchwarzenburg', 'Chillon Mendrisio', 'Belpbergs', 'Gürbetal Was', 'Seftigen Platz', 'Bütschel', 'Münsterturm', 'Alpenlandes', 'Entlebuch', 'Hohli', 'Hübet', 'Bühl', 'Längenberges', 'Englisberg Englisberg', 'Kloster', 'Jordan', 'Kaufdorf Mühlebach', 'Schultheiß', 'Gurnigelberges', 'Montenach Lehen', 'Gurnigelbades', 'Schulhausbauw', 'Läugenberg', 'Leftige', 'Rümligcn', 'Kandertal', 'OberSchönegg', 'Geltersingen', 'Wattcnwil', 'Belp Zimmcrwald Gerzensee Kirchdorf', 'Feste Belp', 'Grimsel', 'Sträßchen', 'Mtthlern', 'birg', 'Fraubrunnen', 'Kramburgfluh', 'Römer', 'Schweizerfranken', 'Grafsenried', 'Rüthi Loosgrund Stuß', 'Rüeg', 'Kirchdorf Kirchdorf', 'Buchegg', 'Tracä', 'Hindelbank Schvftland', 'Gingins', 'Bachmühle', 'Wattenwgl', 'Wattennust', 'Haargarten', 'Wald Wiese', 'Kirchdorf Mer', 'Belp Kehrsatz Wabern', 'Gürbetal', 'Frienisberg', 'Einwvhnergemeindcn', 'Römerzeit', 'Ramisburg Ried', 'Brügglen', 'Rath Bern', 'Bütschelmoos', 'FilialKirchlein', 'Emmentals', 'BernWattenwil', 'MontenachBelp', 'Rümligen Muri', 'Plötsch', 'London', 'Aaretales', 'Leutkirche', 'Rüggisberg Riggisberg', 'SchwarzenburgStraße', 'Kehrsatz Oberried', 'Schadau', 'Belp Riggisberg', 'Lohnstorf Burgistein', 'Zelg Belp', 'SeMgen', 'Ostfranken', 'Landstuhl Bänke', 'Lohnstorf Noslen', 'Oberbütschel', 'Hinterfultigen', 'Münsters Bern', 'BernThun', 'Englisberg Zimmerwald', 'Stockhornkette', 'Seftigen Dynasten', 'Zähringer Felde', 'Lettner', 'Wer Ohren Haff', 'Tromwil', 'Felsenkette', 'Türrbach', 'KehrsatzBelpToffen', 'Brünigbahn', 'Jnterlaken', 'BelpTitelbild', 'Grablegung Christi', 'SüdOst', 'mihe', 'Rüetschi Aarau', 'Belp Montenach', 'Thürmen', 'Belpberg Jmihubel Geologisches Stellen', 'Amman Rümligen', 'Schloß Belp73', 'Oberümtern Schwarzenburg', 'Gerzensee Thalgut Hunzikenbrücke', 'RüeggisbergerErsparniskasse', 'Lmie', 'Ijskli', 'Rebgut Engelberg', 'Zur Linken', 'RiggisbergGurnigel', 'Meienriet', 'Belp Riggisberg Amsoldingen', 'Schloß Gerzensee', 'Palpins', 'Berner Oberlandes', 'Sefiigen', 'Wurstemberger', 'Seftigen, SLOC', 'Heimberg Brudern', 'BernBelp', 'Bennenwile', 'Schwarzwasser', 'Köniz Bis', 'Längenbergs', 'Geographisches berg', 'Burgistein Wattenwpl Kirchdorf Gerzensee', 'Kühliwpl', 'Entlcbuch', 'Noflen', 'Friedhos', 'Gürbetalstraße', 'Hvlz', 'Münsingen', 'Rütti', 'Schloß Riggisberg', 'Kirchdorf Seftigen', 'Tornbül', 'KirchdorfSeftigen', 'Entlebuchs', 'Schloß Thun', 'Schoßhalde', 'Rümligen Thurnen', 'lisberg', 'Schneeberge', 'Dorfstraße', 'Gelterfingen Rümligen', 'Meierlsllgrabens', 'BernMün', 'Münchenbuchsee', 'NiederSimmental', 'Bon Biel', 'Firn Krone Krone', 'RiggisbergBurgistein', 'Münsterkirche', 'Hügelzng', 'Thurnen Oberbild', 'Konolfingeramt', 'Freiweibels', 'Kastvogteibezirks', 'Twingherren', 'Sandstein', 'achern', 'Poststraße', 'Kirchdorfe Gurzelen', 'RüggisbergStraße', 'Söftingcn', 'Wtigeii', 'Belp Unlpiu villa Tuffen', 'Vennergericht Thurnen', 'Kntenmurcdel', 'Uebrigens', 'Reutigen Burg', 'Bütschelegg', 'satzStraße', 'Pfaffenloch', 'Querstraße', 'Bern Zürich', 'Seftigen Schindelhelm', 'Scherlibachs', 'Gex', 'OberGurzelen', 'iingenThun', 'Venner Pfistern', 'Belpberg Burgistein', 'Alp Tschingel', 'Seftigen Halde', 'Seftigen Bern', 'Rüeggis', 'Schloß Rümlingen', 'Jmihubel', 'Rüggisbergstraße', 'Jini', 'Serrenree Kirchdorf', 'ObergurzelenMoos Obergurzelen', '6ezam1anr cin von Selp 8MMK', 'Landstraße', 'Gürbetalbahu', 'Oberried', 'Seftigen Könizberg', 'Tannwald', 'Uttigen Hermis', 'Gaucha Guggisberg', 'Gerzensew', 'Strätlingen', 'Bern Telle', 'Rümlingen', 'Alpcngebirge', 'Estavayer', 'Deftigem', 'NeucnburgNidau', 'Weißenburg', 'Zähringerstadt', 'RiggisbergWißlisaustraße', 'Kirchdorf Mühledorf', 'Stammburg', 'Seftigen Kaufdorf', 'Bethlehem', 'Niedermuhlern', 'Besan', 'Strättliger Hügel', 'Harz Wunn', 'Muriboden Muri', 'Ruskin', 'Wattenwil Länge', 'Der RiggisbergRohrbach', 'Stvckhornkette', 'Aar', 'Scherli', 'Stolze Bnrgzinnen', 'Grauholz', 'Lüngenberges', 'Clnniacenser', 'RüggisbergEgg', 'PfandersmattThun', 'Bümpliz', 'Kienersrüti', 'Kühlewyl', 'Mättewyl Tromwyl', 'Mittelfranken', 'Bütschelgschneit', 'Rüeggisberg', 'Seftigen Falken', 'Holzweidli', 'Schloß Rümligen', 'Belp Gerzensee Kirchdorf', 'ForstThierachern', 'MusguetierKvmpagnie', 'Tal Berg', 'Bütschelbaches', 'Stockhornkctte', 'Bennewyl Ohin', 'Uammmurcftel', 'Aus der Ferne', 'Schloßgut Tuffen', 'WattenwilBelp', 'Köniz', 'Haus Rümligen', 'Schinznach', 'Niederbütschel Banmgarten', 'KuliKahn', 'Hulistall', 'Kastelle', 'Niederbütschel', 'RöthenbachWürzbrunnen', 'Wattenwilbrücke', 'Thun von Kehr', 'Riggisberg Burgistein', 'Belp Kreuz', 'Gwärbs', 'Cugy', 'Gurzelcn Näsle Kirchdorf', 'Münster', 'Frutigen', 'Ztalienweg', 'Drunten', 'Rüeggisperg', 'Rütti Wattenivil Forst', 'WeißenbühlWabernKehrsatz', 'Straßburg', 'Lötschberg', 'Seftigen Laube', 'Schloß Burgistein', 'Falkenfluh', 'Gotteshausgut', 'Belp Hohliebe Mühle', 'Eigenm', 'Lütold', 'Lohnstorf Mühle', 'Surbe', 'Fallbach von Blumenstein', 'Christus Kreuz', 'Bourbakiarmee', 'BelpGerzensce', 'Der zirka', 'EnglisbcrgZimmerwald', 'Längmoos', 'Wiler Man', 'KchrsatzWatten', 'Weyerbodcn', 'AareGürbeMoos', 'GeltersingenKirchdorf', 'Ingen', 'Gotha', 'Rüggisberg Rellstab', 'Jnter', 'RüttiTal', 'ckaIOwck', 'Brügglen Ober', 'Niedergurzelens', 'ScherstBelp', 'Schloß Toffen Das Schloß', 'Gurtzalen', 'Gürbe', 'Tonnerbühl', 'Berner Oberland', 'Admini', 'BernKehrsatzThurnen', 'Schönegg', 'Toffen See', 'Noflen Hub', 'Zeftigen', 'Gurnigelsaison', 'Pilatus', 'Köniz Gnrtental', 'Ligerz', 'Bcrgberges', 'Amman Burgistein', 'Wattenwil Lohnstorf', 'Aarwangen', 'RiggisbergRüttistraße', 'Wattenwyl Westen', 'Belp Rüeggisberg Thurnen', 'Scftigen', 'Thunstraße', 'WattenwilTierachernstraße', 'Dinkel', 'Kirchenthurnen', 'Kilcherslehn', 'Kercenze', 'Kappelen Forst', 'WkecHkupfek', 'BernPsandersmatt', 'RüggisbergZimmerwald', 'Alpengebirges', 'Seelibühl', 'TuffenRiggisbergstraße', 'Haüse', 'Rußland'}",481,"{'Schnegg', 'Diebach', 'Urnengrab', 'Riggisberg Rti', 'Zihl', 'Btschel', 'Bern-Mn', 'Oberbtschel', 'Bern-Kehrsatz-Thurnen', 'Thalgut', 'Tours', 'Grbe', 'Engelberg', 'Ansoltingen', 'Ulm Freibnrg', 'Toffen', 'Brnig', 'Reggisberg', 'Tiesbach', 'Gurnigelberg', 'Gurnigelalp', 'Aare-Grbe-Moos', 'Stu', '- Kramburg', 'Brgg', 'Winterthur', 'Riggisberg-Gurnigel', 'Elsa', 'Rodt', 'Kreuz', '- Wattenwil', 'Mhledors', 'Neucnburg-Nidau', 'Mhleturnen', 'Tofien', '- iingen-Thun', 'Links', 'Rm', 'Piket', 'Montenach-Belp', 'Vivis', '- dors', 'Burg', 'Belpern', 'Bernbiet', 'Kilchdorf', 'Oberblacken', 'Stutz', 'Mhlebach', 'Rtti', 'Loosgrund', '- Vorder', 'Teilkes', 'Wolligen', '- lingen', 'Vincenzen-Stift', 'Sulgenbaches', 'Wald', 'Amsoldingcn', 'Ormonttal', 'Scherst-Belp', 'Cie', 'Niederbtschel', 'Villa', 'Knitz', 'Murtensces', '- ligcn', 'Lramburg', 'Nieder-Simmental', 'Sftingcn', 'Mnster', '- land', 'Reggis', 'Whlern', 'Grbedamm', 'Pfandersinatt', '- ivil', 'Dnkirchen', 'Rggisberg-Zimmerwald', 'Erentagwan', 'Slichting', 'Rellstab', 'Helvetien', 'Wiese', '- gurzelen', 'Rud', 'Brnigbahn', '- tenlach', 'Cesta', 'Blumenhof', 'Brgglen', 'Galactina', 'Leuenberg', 'Mhlethurnen', 'Greyerz', 'Graffenried', 'Kappelen', 'Burgisteiu', 'Cluny', 'Btschelcgg', 'Belp.73', 'Khlewil', 'Tromwyl', 'Ltschberg', 'Thurnensee', 'Montenachs', '- und Nieder-Schnegg', 'Mnsingcn-Zimmerwald', 'Geltersingen-Kirchdorf', 'Belp-Montenach', 'Riggisberg-Wilisaustrae', 'Thurnen.', 'Zhringern', 'Meien', 'chtland', 'Krauchthal', 'Retschi', 'Kastvogt', 'Neuen', 'Strttlingen', 'Grni', 'Weid', 'Varrira.', 'Haberhaus', 'Gurzelcn', 'Rtti-Tal', 'Gyrizensee', 'Lngenbergern', 'aufdorf', 'Chronburc', 'Esche', 'Gysenstein', 'Zolli', 'Bdeli', 'Hallwyl', 'Speper', 'Slumensteinbrcke', 'Fridingen', 'Dornbhl', 'Nwenegg', 'Belpsee', 'Seftigon', 'Ober-Gurzelen', 'Obermuhleren', '- cka-IOwck ^ kwolo', 'Tilliers', 'Safen', 'Tscharner', 'Zhringerstadt', 'Stffis', 'Selp', 'Trb', 'Kehrsatz-Reggisberg', 'Reggisberg.270', 'Gerstensee', '- Ztalienweg', 'Allmendingen', '- steinbrcke', 'Frciburg', 'Rotenburg', 'Bernern', 'Riggisbcrg', 'Rmlingen', 'Chumli', 'Waldberg', 'Tarumb', 'Blonap', 'Reggisperg', 'Riggisberg-Schwarzenburg', 'Fallenbach', 'tzaiAnelgicm', 'Knizberg', 'Ohin', '- bnrg', 'Unterdorf', 'Schweizerland', 'Grbetal', 'Salz', 'Gerzensee, ', 'Kienersrtti', 'Lngenberg', 'Banmgarten', '- tal', 'Berg', 'Neumattbrcke', 'Pltsch', 'Grnenberg', 'Neon', 'Thier', 'Lngenbergs', 'Ltry', 'Martinstag', 'Rmligen', 'Ramisburg', 'Schwarzen', 'Borland', 'Erlach-Wappen', 'Mnsters', 'Querstrae', 'Hochburgund', 'Gmmenen', 'Pfandersmatt-Thun', '- wpl', 'Bern-Belp', 'Belps', 'Wattenwil-Blumenstein-Thun', '- egg', 'Lngen', 'Grbeschlucht', '- burg', 'Tort', 'Alt', 'Bann', 'Rggisberg', '- Thurnen', 'Jnnoccnz', 'Bonstetten', 'Sftingen', 'Newenburg', 'Tuffen-Riggisbergstrae', 'Tschingel', 'Hase', 'Wattenwil-Tierachernstrae', 'Mhle', 'Landstrae', '- wil', 'Zimmcrwald', '-', 'Reggisberg.112', 'Khlewyl', 'ArSH-r', 'Bisanz 8o8anc ttn', 'Bund', 'Belp-Gerzensce', 'Blumen', 'Hindelbank', '- Seip', 'Gaucha', 'Ursusstist', '- und Nieder', 'Zimmerivald', 'Watten', 'Sd-Ost', 'Kerzaz', 'Straburg', 'Mttewyl', 'Riggisberg-Rohrbach', 'Leuenberg.25', 'Blacken', 'Freien', 'Thalberg', 'Rmligcn', 'Torfmoor', 'Oesch', 'Wunn', 'Rutschhalden', 'Bern-Thun', 'Mhledorf', 'Tarnen', 'Stecklikrieg', 'Thrmen', 'Rmligen-Bach', '- berg', 'Bmpliz', 'St.', 'Aareuscr', 'Ncnencgg', 'Weienbhl-Pfandersmatt', 'Talsper', 'Rggisberg-Egg', 'Btschelmoos', 'Wdiswpl', 'Steiger', 'Zhringen', 'Rti Thalgut', 'Tornbl', 'Dies', 'Sestingen', 'Mer', 'Bern-Psandersmatt', 'Riggisberg-Rttistrae', 'Mnsingen', 'Grbetalbahn', 'Sense', 'Gelterfingen-Lohnstorf', 'Burgistein-Wattenwil', 'Pest', 'Wattenwpl.9', 'Msche', '- muhleren', '- Thun', 'Grasburg', 'Oberrmligen', 'Hoho', 'Strttligen', 'Neeser', 'Kirch', 'Wattenwil-Belp', '- Riggisberg-Burgistein', 'Burgdors', 'Riggisberg.81', '- und Niedergurzelen', 'Halde', 'Reg', '- mersloch', 'Groaffoltern', 'End', 'Martini', 'Rschegg', 'Berns', '- bach', 'Ober-Ulmiz', 'Blankenburg.289', 'Gemmi', 'Kantons', 'Ober-Schnegg', 'Englisbcrg-Zimmerwald', '- satz-Strae', 'Thunstrae', 'Syben', 'Dieenberg', 'Lugenberg', 'Nggisberg', 'Burgiwpl', 'Maria', 'Murgraben', 'Wy', 'Knoblauchs', 'Bern-Land', 'Thunerseeufer', 'Tonnerbhl', 'HirekSork', 'Seftigcn berges', 'Savoien', 'Kvniz', 'KIrckliorf', 'Oesterreichs', 'Zrich', 'Wattenwilbrcke', 'Weienbhl', 'Silgi', 'Jnkivil', '- see', '- berges', '- lisberg', 'Kauf', 'Prtz', '- bergcs', 'Ober - und Ilnter-Elbschen', 'Ruland', 'Gum', '- Rggisberg-Strae', 'Ringoltingen', 'Weienburg', 'Bern-Belpstrae', 'Bruggenms', 'Christi', 'Bern-Thun-Bahn', 'Senn', 'Bmplitz', 'Meierisligraben', 'Kniz', 'Liev', 'Bern-Wattenwil', 'Burgistein.88', 'Urloub', 'Hnni Beruh', '- merwald', 'Peter', 'Kien', 's', 'Morsee', 'Gasel', '- birg', 'Chraun', 'Nnenenberg', 'Kaltbachgraben', 'Simplon', 'Dsseldorf', 'Hgelland', 'Bttikon', 'Forst', 'Treiberg', 'Neubau', '- kofen', 'Jabergbrcke', 'Broyebrcke', 'Belpermoos', 'lletendorf', 'Mnsingcn', 'Vlligen', 'Tuffen', 'Khliwpl', 'Clung', 'Rthenbach-Wrzbrunnen', 'Ursenstift', 'Guggisberg', 'Ltschenpa', 'Grnt Rohrbachtal', 'Jegenstorf', 'Tijon', 'Tal', 'Mnchenbuchsee', 'Reggisberg.12', 'Gtlisperg', '- stein', 'Grasenried', 'Kanton', 'Gerzensee.17', '- tuffen', 'Buecher', 'Belp.19', 'bersdors', 'Amsoldiugen', '- Schwarzenburg-Strae', 'Oerzeiisee', 'Torf', 'Thanwald', 'Hub', 'Matten', 'Rovrsa', 'Wattenwil-Thun', '- thurnen', '- btschel', 'Bhl', 'Speichingen', 'Rggisbergstrae', 'Btschelegg', 'Kilchdorfs', '- gisberg', 'Celte', 'Seftigen merwald', 'Nord', 'Alisa', 'Domodossola', 'Schvftland'}",436,"{'Schnegg', 'Diebach', 'Riggisberg Rti', 'Urnengrab', 'Fultigen', 'Zihl', 'Schübelmatte', 'Btschel', 'Bern-Mn', 'Oberbtschel', 'Dorfbaches', 'Gurnigelbad', 'Pruntrut', 'Elsaß', 'Bern-Kehrsatz-Thurnen', 'Siirbe', 'Thalgut', 'Oberaargau', 'Seftigcn', 'Tours', 'Rüti Thalgut', 'Grbe', 'Haus Kramburg', 'Mattstetten', 'Gürbetalbahn', 'Birrwil Hallwilersee', 'Riggisberg Lramburg', 'Engelberg', 'KehrsatzRüeggisberg', 'Alemanne', 'Alpenkranze', 'Ansoltingen', 'Jordans', 'Gclterfingen', 'Uttigen Schönegg', 'Lötschenpaß', 'Dorfbach', 'Längenberg', 'Ulm Freibnrg', 'BernLand', 'Blumenstein Schönegg', 'Toffen', 'Brnig', 'Reggisberg', 'Rüggisberg Ober', 'Riggisberg Kirche von Thurnen', 'Zihl Bern', 'Reutigen', 'Sckale', 'Rümligen', 'Bern Rümligen', 'Uins', 'Tiesbach', 'Belpberg Jmihubel', 'Gurnigelberg', 'BernBelpstraße', 'Thun Beide', 'Kühlewil', 'Bütschelcgg', 'Amsoldingen Thier', 'Rüschegg', 'Gurnigelalp', 'Steiger Frisching', 'Gurnigelbade', 'Dornbühl', 'Schausel', 'Riggisberg Rüti', 'Mühledorf Kirchdorf', 'Aare-Grbe-Moos', 'Moränensnmpses', 'Stu', '- Kramburg', 'Niedersimmental', 'Brgg', 'America', 'Dünkirchen', 'Jmihubel Belpberg Belpberg', 'Niedermuhlern Belp', 'Winterthur', 'LaanZstsour', 'Boralpen', 'Riggisberg-Gurnigel', 'Mühledorf', 'Zentner Glockenerz', 'Seftigen Wenden', 'BurgisteinWattenwil', 'Elsa', 'Rodt', 'Kreuz', '- Wattenwil', 'Mhledors', 'Neucnburg-Nidau', 'Mhleturnen', 'Nauion', 'WattenwilThun', 'Berge Breit', 'Tofien', '- iingen-Thun', 'Links', 'Rm', 'Kirchentnrnen', 'Gümmenen', 'Haulis', 'Piket', 'Glirbetalbahil', 'Montenach-Belp', 'Vivis', '- dors', 'Broyebrücke', 'Burg', 'Münsingcn', 'Ganterisch', 'Kilchdorf', 'Belpern', 'Bernbiet', 'Nüwenegg', 'Nünenensluh', 'Bnrgistein', 'Weißenbühl', 'Oberblacken', 'Dießenberg', 'Amleten', 'Giebelegg Dieser', 'Dörflein', 'Stutz', 'Mhlebach', 'Seftiger Landgerichtes', 'Rtti', 'Rohrbachtal', 'Alles Land', 'Loosgrund', 'Meuron', '- Vorder', 'Seftigen Hofstätten', 'Teilkes', 'Wolligen', '- lingen', 'Vincenzen-Stift', 'Römerstraße', 'Sulgenbaches', 'Wald', 'Nvrdabhange', 'Rentigen', 'Seftigen Ganz', 'Mühlebach', 'Rutschhalde', 'Amsoldingcn', 'Ormonttal', 'Scherst-Belp', 'Cie', 'Niederbtschel', 'Belp Länge', 'Villa', 'Knitz', 'Murtensces', 'Strättligen', '- ligcn', 'Niedermnhlern', 'Slumensteinbrücke', 'Beste Burgistein', 'Lramburg', 'Rüggisberg', 'Nieder-Simmental', 'Sftingcn', '- land', 'Mnster', 'Emmentalerkäse', 'Festigen', 'Balz', 'Reggis', 'Weber Bern', 'Whlern', 'Grbedamm', 'Pfandersinatt', '- ivil', 'Nüggisberg', 'Kühlewil Hier', 'Aubonne', 'Grünenberg', 'BelpMontenach', 'Dnkirchen', 'Rggisberg-Zimmerwald', 'Erentagwan', 'Slichting', 'Kienersrütti', 'Brünig', 'Hauptstraße', 'Mühlethurnen', 'Rellstab', 'Helvetien', 'Wiese', '- gurzelen', 'Rud', 'Brnigbahn', 'Spiez', 'ThnrnenSeftigen', '- tenlach', 'Cesta', 'Burgistein Ober', 'Riggisberg Rüeggisberg', 'Blumenhof', 'Aarcgletschers', 'Übersdors', 'Rattenholzist', 'Brgglen', 'Galactina', 'Leuenberg', 'Kreuzwege', 'Mhlethurnen', 'Thunstetten', 'Greyerz', 'Graffenried', 'Kappelen', 'Burgisteiu', 'Verdun', 'UnterGurzelenft', 'Cluny', 'Btschelcgg', 'Bodenzinse', 'Belp.73', 'Trvingen', 'Zähringen', 'Khlewil', 'Tromwyl', 'Ltschberg', 'Thurnensee', 'Montenachs', '- und Nieder-Schnegg', 'RümligenBach', 'Mnsingcn-Zimmerwald', 'Geltersingen-Kirchdorf', 'Belp-Montenach', 'Gürbetales', 'Nagclfluh', 'BernThunBahn', 'Seftigen Riggisberg', 'Riggisberg-Wilisaustrae', 'Düsseldorf', 'RiggisbergSchwarzenburg', 'Thurnen.', 'Zhringern', 'Chillon Mendrisio', 'Belpbergs', 'Meien', 'chtland', 'Krauchthal', 'Gürbetal Was', 'Retschi', 'Kastvogt', 'Seftigen Platz', 'Bütschel', 'Münsterturm', 'Alpenlandes', 'Neuen', 'Strttlingen', 'Entlebuch', 'Hohli', 'Grni', 'Hübet', 'Bühl', 'Englisberg Englisberg', 'Weid', 'Längenberges', 'Kloster', 'Varrira.', 'Jordan', 'Kaufdorf Mühlebach', 'Schultheiß', 'Gurnigelberges', 'Haberhaus', 'Gurzelcn', 'Montenach Lehen', 'Rtti-Tal', 'Gyrizensee', 'Gurnigelbades', 'Schulhausbauw', 'Läugenberg', 'Lngenbergern', 'aufdorf', 'Chronburc', 'Esche', 'Leftige', 'Gysenstein', 'Rümligcn', 'Kandertal', 'Zolli', 'Bdeli', 'Hallwyl', 'OberSchönegg', 'Speper', 'Geltersingen', 'Slumensteinbrcke', 'Wattcnwil', 'Belp Zimmcrwald Gerzensee Kirchdorf', 'Fridingen', 'Dornbhl', 'Nwenegg', 'Belpsee', 'Feste Belp', 'Grimsel', 'Seftigon', 'Ober-Gurzelen', 'Sträßchen', 'Obermuhleren', '- cka-IOwck ^ kwolo', 'Mtthlern', 'Tilliers', 'birg', 'Fraubrunnen', 'Safen', 'Kramburgfluh', 'Tscharner', 'Zhringerstadt', 'Stffis', 'Selp', 'Trb', 'Kehrsatz-Reggisberg', 'Römer', 'Reggisberg.270', 'Schweizerfranken', 'Gerstensee', '- Ztalienweg', 'Allmendingen', '- steinbrcke', 'Frciburg', 'Rotenburg', 'Bernern', 'Riggisbcrg', 'Rmlingen', 'Chumli', 'Grafsenried', 'Rüthi Loosgrund Stuß', 'Waldberg', 'Tarumb', 'Blonap', 'Rüeg', 'Kirchdorf Kirchdorf', 'Buchegg', 'Tracä', 'Reggisperg', 'Riggisberg-Schwarzenburg', 'Hindelbank Schvftland', 'Fallenbach', 'tzaiAnelgicm', 'Gingins', 'Bachmühle', 'Wattenwgl', 'Wattennust', 'Haargarten', 'Wald Wiese', 'Kirchdorf Mer', 'Knizberg', 'Ohin', 'Belp Kehrsatz Wabern', '- bnrg', 'Gürbetal', 'Frienisberg', 'Unterdorf', 'Schweizerland', 'Einwvhnergemeindcn', 'Römerzeit', 'Grbetal', 'Ramisburg Ried', 'Salz', 'Gerzensee, ', 'Brügglen', 'Rath Bern', 'Bütschelmoos', 'FilialKirchlein', 'Kienersrtti', 'Lngenberg', 'Banmgarten', '- tal', 'Berg', 'Neumattbrcke', 'Emmentals', 'Pltsch', 'BernWattenwil', 'Grnenberg', 'MontenachBelp', 'Neon', 'Rümligen Muri', 'Thier', 'Plötsch', 'London', 'Aaretales', 'Lngenbergs', 'Leutkirche', 'Ltry', 'Martinstag', 'Rüggisberg Riggisberg', 'Rmligen', 'SchwarzenburgStraße', 'Kehrsatz Oberried', 'Schadau', 'Ramisburg', 'Schwarzen', 'Belp Riggisberg', 'Lohnstorf Burgistein', 'Zelg Belp', 'SeMgen', 'Borland', 'Ostfranken', 'Erlach-Wappen', 'Mnsters', 'Querstrae', 'Landstuhl Bänke', 'Lohnstorf Noslen', 'Hochburgund', 'Oberbütschel', 'Hinterfultigen', 'Münsters Bern', 'BernThun', 'Gmmenen', 'Pfandersmatt-Thun', 'Englisberg Zimmerwald', '- wpl', 'Bern-Belp', 'Stockhornkette', 'Belps', 'Wattenwil-Blumenstein-Thun', 'Seftigen Dynasten', 'Zähringer Felde', 'Lettner', 'Wer Ohren Haff', 'Tromwil', 'Felsenkette', '- egg', 'Lngen', 'Türrbach', 'Grbeschlucht', 'KehrsatzBelpToffen', '- burg', 'Brünigbahn', 'Jnterlaken', 'Tort', 'Alt', 'BelpTitelbild', 'Grablegung Christi', 'SüdOst', 'mihe', 'Bann', 'Rggisberg', 'Rüetschi Aarau', 'Belp Montenach', 'Thürmen', 'Belpberg Jmihubel Geologisches Stellen', 'Amman Rümligen', 'Schloß Belp73', 'Oberümtern Schwarzenburg', '- Thurnen', 'Jnnoccnz', 'Bonstetten', 'Gerzensee Thalgut Hunzikenbrücke', 'Sftingen', 'RüeggisbergerErsparniskasse', 'Lmie', 'Ijskli', 'Rebgut Engelberg', 'Zur Linken', 'Newenburg', 'Tuffen-Riggisbergstrae', 'Tschingel', 'Hase', 'Wattenwil-Tierachernstrae', 'RiggisbergGurnigel', 'Mhle', 'Landstrae', 'Meienriet', '- wil', 'Zimmcrwald', '-', 'Belp Riggisberg Amsoldingen', 'Reggisberg.112', 'Schloß Gerzensee', 'Palpins', 'Khlewyl', 'Berner Oberlandes', 'ArSH-r', 'Bisanz 8o8anc ttn', 'Bund', 'Belp-Gerzensce', 'Sefiigen', 'Blumen', 'Wurstemberger', 'Seftigen, SLOC', 'Hindelbank', '- Seip', 'Heimberg Brudern', 'BernBelp', 'Bennenwile', 'Schwarzwasser', 'Köniz Bis', 'Längenbergs', 'Geographisches berg', 'Burgistein Wattenwpl Kirchdorf Gerzensee', 'Kühliwpl', 'Entlcbuch', 'Noflen', 'Gaucha', 'Friedhos', 'Gürbetalstraße', 'Ursusstist', '- und Nieder', 'Hvlz', 'Zimmerivald', 'Münsingen', 'Rütti', 'Schloß Riggisberg', 'Watten', 'Tornbül', 'Kirchdorf Seftigen', 'Entlebuchs', 'Sd-Ost', 'Kerzaz', 'KirchdorfSeftigen', 'Straburg', 'Schloß Thun', 'Schoßhalde', 'Rümligen Thurnen', 'Mttewyl', 'Riggisberg-Rohrbach', 'Leuenberg.25', 'lisberg', 'Schneeberge', 'Blacken', 'Freien', 'Dorfstraße', 'Thalberg', 'Rmligcn', 'Torfmoor', 'Oesch', 'Wunn', 'Gelterfingen Rümligen', 'Meierlsllgrabens', 'BernMün', 'Münchenbuchsee', 'NiederSimmental', 'Rutschhalden', 'Bon Biel', 'Bern-Thun', 'Mhledorf', 'Tarnen', 'Stecklikrieg', 'Firn Krone Krone', 'RiggisbergBurgistein', 'Münsterkirche', 'Hügelzng', 'Thurnen Oberbild', 'Konolfingeramt', 'Thrmen', 'Rmligen-Bach', '- berg', 'Bmpliz', 'Freiweibels', 'St.', 'Kastvogteibezirks', 'Aareuscr', 'Ncnencgg', 'Weienbhl-Pfandersmatt', 'Talsper', 'Twingherren', 'Sandstein', 'achern', 'Rggisberg-Egg', 'Poststraße', 'Kirchdorfe Gurzelen', 'RüggisbergStraße', 'Btschelmoos', 'Wdiswpl', 'Steiger', 'Zhringen', 'Söftingcn', 'Wtigeii', 'Rti Thalgut', 'Belp Unlpiu villa Tuffen', 'Vennergericht Thurnen', 'Kntenmurcdel', 'Uebrigens', 'Tornbl', 'Reutigen Burg', 'Bütschelegg', 'satzStraße', 'Pfaffenloch', 'Querstraße', 'Bern Zürich', 'Seftigen Schindelhelm', 'Dies', 'Scherlibachs', 'Gex', 'OberGurzelen', 'iingenThun', 'Sestingen', 'Mer', 'Venner Pfistern', 'Belpberg Burgistein', 'Bern-Psandersmatt', 'Alp Tschingel', 'Riggisberg-Rttistrae', 'Seftigen Halde', 'Schloß Rümlingen', 'Seftigen Bern', 'Rüeggis', 'Jmihubel', 'Rüggisbergstraße', 'Mnsingen', 'Grbetalbahn', 'Jini', 'Serrenree Kirchdorf', 'Sense', 'ObergurzelenMoos Obergurzelen', '6ezam1anr cin von Selp 8MMK', 'Landstraße', 'Gelterfingen-Lohnstorf', 'Gürbetalbahu', 'Oberried', 'Seftigen Könizberg', 'Burgistein-Wattenwil', 'Tannwald', 'Uttigen Hermis', 'Pest', 'Gaucha Guggisberg', 'Wattenwpl.9', 'Gerzensew', 'Strätlingen', 'Msche', '- muhleren', '- Thun', 'Bern Telle', 'Grasburg', 'Oberrmligen', 'Rümlingen', 'Hoho', 'Strttligen', 'Neeser', 'Alpcngebirge', 'Estavayer', 'Kirch', '- Riggisberg-Burgistein', 'Wattenwil-Belp', 'Deftigem', 'Burgdors', 'Riggisberg.81', 'NeucnburgNidau', 'Weißenburg', 'Zähringerstadt', 'RiggisbergWißlisaustraße', '- und Niedergurzelen', 'Halde', 'Kirchdorf Mühledorf', 'Reg', '- mersloch', 'Stammburg', 'Seftigen Kaufdorf', 'Bethlehem', 'Niedermuhlern', 'Groaffoltern', 'Besan', 'Strättliger Hügel', 'End', 'Harz Wunn', 'Muriboden Muri', 'Ruskin', 'Martini', 'Rschegg', 'Wattenwil Länge', 'Der RiggisbergRohrbach', 'Berns', 'Stvckhornkette', '- bach', 'Ober-Ulmiz', 'Blankenburg.289', 'Aar', 'Scherli', 'Gemmi', 'Stolze Bnrgzinnen', 'Kantons', 'Ober-Schnegg', 'Grauholz', 'Lüngenberges', 'Englisbcrg-Zimmerwald', '- satz-Strae', 'Clnniacenser', 'Thunstrae', 'Syben', 'RüggisbergEgg', 'Dieenberg', 'Lugenberg', 'Nggisberg', 'Burgiwpl', 'PfandersmattThun', 'Maria', 'Bümpliz', 'Murgraben', 'Wy', 'Knoblauchs', 'Kienersrüti', 'Bern-Land', 'Tonnerbhl', 'HirekSork', 'Seftigcn berges', 'Savoien', 'Thunerseeufer', 'Kühlewyl', 'Mättewyl Tromwyl', 'Mittelfranken', 'Bütschelgschneit', 'Rüeggisberg', 'Seftigen Falken', 'Belp Gerzensee Kirchdorf', 'Holzweidli', 'Schloß Rümligen', 'Kvniz', 'KIrckliorf', 'ForstThierachern', 'MusguetierKvmpagnie', 'Tal Berg', 'Bütschelbaches', 'Stockhornkctte', 'Oesterreichs', 'Zrich', 'Bennewyl Ohin', 'Wattenwilbrcke', 'Weienbhl', 'Uammmurcftel', 'Silgi', 'Aus der Ferne', 'Jnkivil', '- see', 'Schloßgut Tuffen', '- berges', 'WattenwilBelp', '- lisberg', 'Köniz', 'Haus Rümligen', 'Schinznach', 'Niederbütschel Banmgarten', 'KuliKahn', 'Kauf', 'Prtz', 'Hulistall', 'Kastelle', '- bergcs', 'Wattenwilbrücke', 'Niederbütschel', 'Ober - und Ilnter-Elbschen', 'Ruland', 'RöthenbachWürzbrunnen', 'Thun von Kehr', 'Riggisberg Burgistein', 'Gum', '- Rggisberg-Strae', 'Ringoltingen', 'Belp Kreuz', 'Gwärbs', 'Weienburg', 'Cugy', 'Gurzelcn Näsle Kirchdorf', 'Bern-Belpstrae', 'Bruggenms', 'Münster', 'Christi', 'Frutigen', 'Bern-Thun-Bahn', 'Ztalienweg', 'Senn', 'Drunten', 'Bmplitz', 'Meierisligraben', 'Kniz', 'Rüeggisperg', 'Rütti Wattenivil Forst', 'Liev', 'Bern-Wattenwil', 'Burgistein.88', 'WeißenbühlWabernKehrsatz', 'Straßburg', 'Lötschberg', 'Urloub', 'Seftigen Laube', 'Schloß Burgistein', 'Falkenfluh', 'Gotteshausgut', 'Belp Hohliebe Mühle', 'Hnni Beruh', '- merwald', 'Peter', 'Kien', 's', 'Eigenm', 'Morsee', 'Gasel', 'Lütold', 'Lohnstorf Mühle', 'Surbe', '- birg', 'Chraun', 'Fallbach von Blumenstein', 'Nnenenberg', 'Christus Kreuz', 'Kaltbachgraben', 'Simplon', 'Bourbakiarmee', 'BelpGerzensce', 'Der zirka', 'Dsseldorf', 'Hgelland', 'EnglisbcrgZimmerwald', 'Längmoos', 'Bttikon', 'Forst', 'Treiberg', 'Wiler Man', 'KchrsatzWatten', 'Weyerbodcn', 'Neubau', '- kofen', 'Jabergbrcke', 'Broyebrcke', 'Belpermoos', 'AareGürbeMoos', 'GeltersingenKirchdorf', 'Ingen', 'Gotha', 'lletendorf', 'Mnsingcn', 'Vlligen', 'Tuffen', 'Rüggisberg Rellstab', 'Khliwpl', 'Clung', 'Rthenbach-Wrzbrunnen', 'Jnter', 'RüttiTal', 'Ursenstift', 'Guggisberg', 'ckaIOwck', 'Ltschenpa', 'Grnt Rohrbachtal', 'Jegenstorf', 'Tijon', 'Tal', 'Mnchenbuchsee', 'Reggisberg.12', 'Brügglen Ober', 'Niedergurzelens', 'ScherstBelp', 'Schloß Toffen Das Schloß', 'Gtlisperg', '- stein', 'Grasenried', 'Kanton', 'Gerzensee.17', 'Gurtzalen', 'Gürbe', 'Tonnerbühl', '- tuffen', 'Buecher', 'Belp.19', 'Berner Oberland', 'Admini', 'BernKehrsatzThurnen', 'Schönegg', 'bersdors', 'Toffen See', 'Amsoldiugen', '- Schwarzenburg-Strae', 'Noflen Hub', 'Zeftigen', 'Gurnigelsaison', 'Pilatus', 'Oerzeiisee', 'Köniz Gnrtental', 'Ligerz', 'Bcrgberges', 'Amman Burgistein', 'Wattenwil Lohnstorf', 'Aarwangen', 'Torf', 'RiggisbergRüttistraße', 'Thanwald', 'Wattenwyl Westen', 'Hub', 'Matten', 'Belp Rüeggisberg Thurnen', 'Scftigen', 'Rovrsa', 'Thunstraße', 'Wattenwil-Thun', 'WattenwilTierachernstraße', 'Dinkel', '- thurnen', '- btschel', 'Kirchenthurnen', 'Bhl', 'Speichingen', 'Kilcherslehn', 'Kercenze', 'Kappelen Forst', 'WkecHkupfek', 'BernPsandersmatt', 'Rggisbergstrae', 'RüggisbergZimmerwald', 'Btschelegg', 'Kilchdorfs', '- gisberg', 'Alpengebirges', 'Seelibühl', 'TuffenRiggisbergstraße', 'Haüse', 'Seftigen merwald', 'Celte', 'Nord', 'Rußland', 'Alisa', 'Domodossola', 'Schvftland'}",917
22562653,37430,"{'Bucbeggberg', 'Solvthurn', 'Waadt', 'Aare', 'Aarberg', 'Dotzigen', 'Zihl', 'Sckeuren', 'Solothurn', 'Freiburg', 'Handeck', 'Bielersee', 'Attisholz', 'Jura', 'Schwadernau', 'Walperswyl', 'Bargen', 'Siselen', 'Meyenried', 'Bern', 'Nidau', 'Buren', 'Murtensee', 'Pfeidwald'}",24,"{'Brügg', 'Senenwande', 'GraSbau', 'Kubikniß', 'Daö', 'Bachmatt Altreu', 'Slarberg', 'Läußligen', 'AarbergBielerfeeKanal', 'Saane', 'Läußligm', 'Büren', 'Mooses, SLOC'}",13,"{'Weidorn', 'Schwarzdorn', 'Attisholz.2657682', 'Mooses, ', 'Jen', 'Brgg', 'brg', 'Grien', 'Altreu', 'Moosgegendcn', 'Lieschgras', 'Bachmatt', 'Aarberg-Bielerfee-Kanal', 'Moos', 'Nicca', 'Vielersee', 'Kanton', 'Moosland', 'Aarufers', 'Kiesdamm', 'Grope-Moos', 'KieS', 'Aarebett', 'Bren'}",24,"{'Brügg', 'Senenwande', 'Daö', 'Weidorn', 'Attisholz.2657682', 'Schwarzdorn', 'GraSbau', 'Mooses, ', 'Büren', 'Jen', 'Brgg', 'brg', 'Grien', 'Altreu', 'Läußligen', 'Moosgegendcn', 'AarbergBielerfeeKanal', 'Lieschgras', 'Läußligm', 'Bachmatt', 'Aarberg-Bielerfee-Kanal', 'Moos', 'Nicca', 'Vielersee', 'Kanton', 'Moosland', 'Aarufers', 'Bachmatt Altreu', 'Kiesdamm', 'Grope-Moos', 'Kubikniß', 'KieS', 'Saane', 'Aarebett', 'Bren', 'Slarberg', 'Mooses, SLOC'}",37
23149274,218574,"{'Delsberg', 'Bern', 'Neapel', 'Brod'}",4,"{'Ruthen', 'Schenkhäuser', 'Großen Rathe', 'Uebrigens', 'Republik Bern', 'Kitts', 'Wohlthat, SLOC', 'Hochverrath', 'Rom'}",9,"{'Schweiz', 'Ausland', 'Bernern', 'Kanton', 'Venedig', 'Seufzerbrcke', 'Bern, '}",7,"{'Schweiz', 'Rom', 'Ruthen', 'Großen Rathe', 'Ausland', 'Kitts', 'Venedig', 'Bernern', 'Kanton', 'Republik Bern', 'Seufzerbrcke', 'Hochverrath', 'Bern, ', 'Schenkhäuser', 'Uebrigens', 'Wohlthat, SLOC'}",16
6800516,89844,"{'Galgenfeld', 'Altenberg', 'Mannenberg', 'Viererfeld', 'Postgasse', 'Leerlever', 'Kirchenfeld', 'Schattrein', 'Wylerfeld', 'Siechenfeld', 'Brunngasse', 'Metzgergasse', 'Wankdorffeld', 'Murifeld', 'Engewald', 'Neufeld', 'Kirchen', 'Maas', 'Bern', 'Neuenstadt', 'Bremgarten', 'Schermenholz', 'Lindenfeld'}",23,"{'Brunn', 'Wochenmarkts', 'Astecuranz', 'Winkelmühle', 'Vaiia', 'Miethzinse', 'Murtenstraß', 'Schatzungs', 'AußerLölisberg', 'Aare', 'Bannwarts', 'Mädchenschul', 'BorderDahlrein', 'Miethziuse', 'Erlacherhof', 'Gäßlcin', 'Beischnß', 'Vierergebäude', 'Liv Inländische Capitalien', 'Mushafensond', 'Kleinen Stadtrathes', 'Spinnmeisters', 'Kochcrhaus', 'Langmauer', 'Bern MnHgHH', 'Neuhaus Juchart', 'CentralStadtCasse', 'Geistkirche', 'AußerDählrein', 'Mieth', 'StadtBibliothek', 'Jlluminations', 'Schlachthause', 'Capitalien', 'Nählehrerin', 'HinterEngefeld', 'Brunngaßhalde', 'Könizberg', 'Jllnminalionsfonds', 'Köniz', 'BanamtKornhans', 'Forsthüter Gschick', 'Vodeuziusen', 'Bern, SLOC', 'ErtraLöhne', 'Landstuhlweidli', 'Rodt', 'Mushafens', 'Dählhölzli', 'Stadtrathe', 'Twann Rebland', 'Liv Angewandte Capitalien', 'Forst', 'Mannw', 'Burgerspital', 'Bodenzinse', 'Rosengarten', 'DeposttoCassa', 'Das Hans', 'Viererschopf', 'PatentWirthschasts', 'DepositoCassa', 'Engehalden', 'Lehenzinsen', 'Stämpflihaus', 'Mushafen', 'Münster', 'MushafenFundits', 'Eckholz Sädelbach', 'Marchnugen', 'Geißlernwald', 'Thunholz', 'CentralStadtcasse', 'Wyler Sandgrube', 'Kühlewylwald', 'Lonto'}",76,"{'Wicki', 'Auer-Llisberg', 'Knizberg', 'Mattland', 'Thnnhol', 'Ruestwald', 'Kniz', 'Griengrnbe', 'Brunnbaus', 'Rebland', 'Poudeille', 'Flor', 'Mtt', 'Murimsli', 'Dhlhlzli', 'Wyler', 'Possac', 'Border-Dahlrein', 'Ehgrben', '-', 'Ms', 'Gras', 'Marktgaffe', 'Mhlestein.', 'Wymtteli', 'Murtenstra', 'Aufreinholz', 'Freiburg', 'MSlein', 'Burgdorfholz', 'Dalmatienacker', 'Bachtelen', 'Dinkel', 'Jucharten', 'Mnhlekorn', 'Auer-Dhlrein', 'Gasscnqras', 'Mhlekorn', 'Detresi', 'Steinrieseten', 'Mnristalden-Reine', 'Knizberg.Z.611', 'Khlewylwald', 'Spitalackerfeld', 'Schoshaldenholz', 'Dhlholz', 'Obcrbeundenfeld', 'Aargauer', 'Eckholz', 'Sulgenbach', 'Kirchreben', 'Gricngrnbe', 'Tschugg', 'Jthgraben', 'Nelernholz', 'Bern, ', 'Harnischbergwald', 'Burgerholz', 'Hinter-Engefeld', 'Wylerholz', 'Harnischwald', 'Brunngahalde', 'Canton', 'Schermelz', 'Btz', 'Schttehalden', 'Beundenfeld', 'Sdelbach', 'Geilernwald'}",69,"{'Winkelmühle', 'Ruestwald', 'Rebland', 'Mtt', 'Liv Inländische Capitalien', '-', 'Langmauer', 'Neuhaus Juchart', 'Freiburg', 'Dalmatienacker', 'Bachtelen', 'Jllnminalionsfonds', 'Jucharten', 'Khlewylwald', 'Burgerspital', 'DeposttoCassa', 'Kühlewylwald', 'Wicki', 'Auer-Llisberg', 'Poudeille', 'Murimsli', 'Dhlhlzli', 'Gäßlcin', 'Beischnß', 'Ms', 'Marktgaffe', 'HinterEngefeld', 'Detresi', 'Landstuhlweidli', 'Rodt', 'Schoshaldenholz', 'Liv Angewandte Capitalien', 'Gricngrnbe', 'Das Hans', 'Viererschopf', 'Harnischbergwald', 'Brunngahalde', 'MushafenFundits', 'Beundenfeld', 'Thnnhol', 'AußerLölisberg', 'Brunnbaus', 'Vierergebäude', 'Spinnmeisters', 'Kochcrhaus', 'StadtBibliothek', 'Schlachthause', 'Nählehrerin', 'Auer-Dhlrein', 'Gasscnqras', 'Steinrieseten', 'Mnristalden-Reine', 'Forsthüter Gschick', 'PatentWirthschasts', 'Wylerholz', 'CentralStadtcasse', 'Sdelbach', 'Flor', 'Bannwarts', 'Astecuranz', 'Mädchenschul', 'Wyler', 'Bern MnHgHH', 'AußerDählrein', 'Burgdorfholz', 'Könizberg', 'Bodenzinse', 'Eckholz', 'Harnischwald', 'Schermelz', 'Geißlernwald', 'Miethziuse', 'Wochenmarkts', 'Murtenstraß', 'Erlacherhof', 'Mushafensond', 'Mieth', 'Wymtteli', 'MSlein', 'Köniz', 'ErtraLöhne', 'Spitalackerfeld', 'Mushafens', 'Dählhölzli', 'Sulgenbach', 'Kirchreben', 'Hinter-Engefeld', 'Münster', 'Eckholz Sädelbach', 'Btz', 'Geilernwald', 'Lonto', 'Mattland', 'Kniz', 'Miethzinse', 'Schatzungs', 'Geistkirche', 'Aufreinholz', 'Brunngaßhalde', 'Twann Rebland', 'Obcrbeundenfeld', 'Forst', 'Tschugg', 'Engehalden', 'Stämpflihaus', 'Thunholz', 'Knizberg', 'Vaiia', 'Aare', 'Ehgrben', 'Gras', 'CentralStadtCasse', 'Jlluminations', 'Capitalien', 'Mnhlekorn', 'BanamtKornhans', 'Bern, SLOC', 'Vodeuziusen', 'Stadtrathe', 'Mannw', 'Aargauer', 'Rosengarten', 'Nelernholz', 'Canton', 'Mushafen', 'Schttehalden', 'Wyler Sandgrube', 'Brunn', 'Griengrnbe', 'Possac', 'Kleinen Stadtrathes', 'Border-Dahlrein', 'Mhlestein.', 'Murtenstra', 'Dinkel', 'Mhlekorn', 'Knizberg.Z.611', 'Dhlholz', 'Jthgraben', 'DepositoCassa', 'Bern, ', 'Lehenzinsen', 'Burgerholz', 'Marchnugen', 'BorderDahlrein'}",145
15026503,67159,"{'EmmenthalS', 'Jericho', 'Paris', 'Leberberg', 'London', 'Hamburg', 'Schwarzenburg', 'Mittelland', 'OberaargauS', 'Bern', 'Deutschland', 'Oberaarga'}",12,"{'Iudenthuin', 'Kühcr', 'BettelS', 'Oberlande', 'Bciqqesen, SLOC', '4auS', 'Oberland', 'MittellaudeS', 'Münster', 'Predigtamtc', 'Wien Berlin', 'Seeland'}",12,"{'Em', 'Berlin', 'Kanton, ', '- menthal', 'Affoltern', 'Wien', 'Christi', 'Kanton', 'Mnster'}",9,"{'Em', 'BettelS', 'Oberlande', 'Bciqqesen, SLOC', 'Kanton, ', '4auS', 'MittellaudeS', 'Wien', 'Kanton', 'Wien Berlin', 'Iudenthuin', 'Kühcr', 'Berlin', '- menthal', 'Affoltern', 'Oberland', 'Münster', 'Predigtamtc', 'Christi', 'Mnster', 'Seeland'}",21
22543408,45034,"{'Yverdon', 'Bielersees', 'Neuenburgersee', 'Schweiz', 'Waadt', 'Aare', 'Willihof', 'Murten', 'Neuenburg', 'Aarberg', 'Zihl', 'Solothurn', 'Freiburg', 'Cosandey', 'Grosschiffahrtsstrasse', 'Nennigkofen', 'Bielersee', 'Broye', 'Attisholz', 'Genf', 'Staugrenze', 'Aareebene', 'Luterbach', 'Bern', 'Nidau', 'Niederwasser', 'Witzwil', 'Aargau', 'Murtensee'}",29,"{'Bern, SLOC', 'Aarestrecke', 'RhoneRhein', 'Rorschach', 'NidauAttisholz', 'BürenWillihof', 'Nicca Tiefstes', 'Wasserpiegel', 'NidauBürenKanal', 'NidauWillihof', 'BürenKanal', 'AttisholzBielersee', 'Lausanne', 'NidauBürenKanals', 'SolothurnWillihof', 'BürenAttisholz', 'BürenSolothurn'}",17,"{'Nidau-Attisholz', 'Basel-Land', 'Deluz', 'bern', 'Staukote', 'Nidau-Willihof', 'Baden', 'Arch', 'Devis', 'Nicca', 'Basel-Stadt', 'Kanton', 'Bren-Willihof', 'Aareebene Bren-Solothurn', 'Bern, ', 'Bren-Attisholz', 'Bren-Solothurn', 'Nidau-Bren-Kanals', 'Solothurn-Willihof', 'Bodenart', 'Rssens', 'Rhone-Rhein'}",22,"{'Nidau-Attisholz', 'Rorschach', 'Nicca Tiefstes', 'Wasserpiegel', 'Basel-Land', 'Deluz', 'bern', 'BürenSolothurn', 'Staukote', 'BürenWillihof', 'Baden', 'NidauBürenKanal', 'Arch', 'Devis', 'Bern, SLOC', 'RhoneRhein', 'Rssens', 'Nicca', 'NidauWillihof', 'Basel-Stadt', 'Kanton', 'NidauBürenKanals', 'Bren-Willihof', 'Aareebene Bren-Solothurn', 'BürenAttisholz', 'Bern, ', 'Bren-Attisholz', 'Aarestrecke', 'NidauAttisholz', 'Bren-Solothurn', 'BürenKanal', 'AttisholzBielersee', 'Nidau-Bren-Kanals', 'Solothurn-Willihof', 'Bodenart', 'Lausanne', 'Nidau-Willihof', 'SolothurnWillihof', 'Rhone-Rhein'}",39
22562442,155929,"{'Yverdon', 'Neuenburgersees', 'Neuenburgersee', 'Hagnek', 'Schweiz', 'Waadt', 'Konolfingen', 'Molos', 'Aare', 'Iverdon', 'Murten', 'Meyenriev', 'Nidaukanal', 'Neuenburg', 'Aarberg', 'Solothurnergrenze', 'Zihl', 'Luzern', 'Aarburg', 'Steinbrugg', 'Scheuren', 'Solothurn', 'Freiburg', 'Oberland', 'Brope', 'Bruttelen', 'Bielersee', 'Epsach', 'Arch', 'Thun', 'Ouchp', 'Wiflisburg', 'Merzlingermoos', 'Broye', 'Jura', 'Frelburg', 'Moos', 'Stein', 'Leng', 'Meienried', 'Walperswyl', 'Basel', 'Bargen', 'Siselen', 'Dotzingen', 'Bern', 'Yyerdon', 'Nidau', 'Leuzingen', 'Meinisberg', 'Murtensees', 'Sugp', 'Aargau', 'Cudrefin', 'Hagneck', 'Meyen', 'Mepenried', 'Buren', 'Hauenstein', 'Murtensee', 'Orbe', 'Peterlingen'}",62,"{'SOLOTHURN', 'Port Alban', 'Moulins Salavaux', 'Aar von BürenSolothurn', 'Aarberg Brügg', 'Großen Rathe', 'Iverdon St Johann', 'Bühl', 'Marais Tausselen Bretiège', 'Große Moos', 'Tjr wS llivirlcs', 'Donau', 'Zihl Bielersee', 'St Johannsenbrücke', 'Vsooo', 'Mühlau', 'OrbeMoos', 'Marais Cudrefin Terrain ville Yverdun', 'Portofreihei', 'Neuenburg Solothurn', 'Port Alban Wein', 'Nidau Büren', 'burgersee', 'AarbergHagnek', 'Cudrefin Moos Orbe', 'Murtensees Meßtischblättern', 'Großen Mooses', 'Fr', 'MerzligenMooses', 'Brügg', 'Aargebiet', 'Neuenburg Waàren', 'MoloBauten', 'Schädeli', 'Großen Moose', 'Buron', 'Tulla', 'nauPieterlen Mooses', 'Nidau Aegerten', 'AarbergHagnekKanals', 'OrbeMooses', 'Broye Orbe', 'Aarberg Kappelen', 'Marais Ypsach', 'PrivatPraris', 'Blotzheim', 'Nidau Terrains sur Ile St Pierre Chaussées', 'NidauBüren', 'Moos Moos', 'Cressier', 'Broye Holz', 'Annexe Beilage Nro', 'Ivedon', 'Marais sur Thièle', 'Cudrefin Moos', 'Bielersees', 'Broye der Zihl', 'Solothurn Waadt', 'Farbwaaren', 'Pieterlenmoos, SLOC', 'rochesMooses', 'Bern Solothurn', 'Marais Merzlingen', 'Brope der Orbe', 'Fernern', 'Osterwald', 'LeußlingenKanals', 'EntrerochesMooses', 'Ouer', 'Waadt Neuenburgersee', 'St Blaise', 'Großen Moos', 'Schad', 'Walperswylerbast', 'Büren', 'Marais Pieterlen', 'lothurn', 'AarbergHagnekKanal', 'JuchartenJnhalt', 'OrbeMoose', 'St Johannsen', 'Marchsteine', 'V2000', 'BroyeKanals', 'Chars', 'Marais Griesach', 'Kanton Frei', 'Pieterlen', 'Aarberg Büren', 'Büetigen', 'Bonstetten', 'Sous Saillon', 'Aar von Aarberg', 'Neuenburg Neuenburgersee', 'Saane', 'Marais Walperswyl'}",96,"{'Meien', 'Briate', 'ZihI', 'Laadt', 'Neuen', 'Epargniers', '-', '- lothurn', 'Zsverdon', 'Sugy', 'Cent', 'BERN', 'Ly', 'Johann', '- burgersee', 'Nicca', '- sen', 'Broye-Mser', 'Spengelz', 'Moose', 'Bren-Solothurn', 'Alban', 'Grissach', 'Lelewels', 'Bren', 'Peters Insel', 'Orbe-Mooses', 'Yinelz', 'Aarberg-Hagnek-Kanal', 'Marima', 'St. Blaise', 'Ipsach', 'Fraubrunnen', 'Brgg', 'St.', 'Ctr', 'Merian', 'NEUENBURG', 'Neuchtel', 'Johannsenbrcke', 'Entreroches', 'Bienne', 'Hagnek-Brcke', 'Frnburg', 'Ive.don', 'Nidau-Bren-Kanals', 'Sees', '- roches-Mooses', 'Juch', 'Seeland', 'Effig', 'Iver', 'Entre', '- roches', 'Zohannsen', 'Glutz', 'Donau Moos', '- nau-Pieterlen', 'Bron', 'Frei', 'Brttelen', 'Mhlau', '- berg-Hagnek-Kanale', '- ried', 'Neuenburger', 'lten', 'Mooses', 'Kanton', 'Landeron', 'Msern', 'Entreroche', 'Averdon', 'Aar-Rieser', 'Meyenried', 'Perimetermoos', 'Errata', 'Plan', 'Sgy', '- don', 'Nidau-Bren', 'Most', 'obern Zihl', 'Sousaillon', 'Mscr', 'Torf', 'Aarberg-Hagnek', 'Aar', 'Estavaper', 'Briatte, ', 'Mser', 'Tableau', 'So', '- burg', 'Orbe-Moos', 'Bhl', 'Freiburger-Alpen', 'Vrai', '- burger', '- moos', 'Soleure', 'St. Johannsen', 'Zlverdon-Grandson', 'Rhone', 'Merzlingen', 'Yverdonsee', 'Wallis'}",106,"{'Meien', 'SOLOTHURN', 'Port Alban', 'Moulins Salavaux', 'Aar von BürenSolothurn', 'Briate', 'ZihI', 'Neuen', 'Laadt', 'Epargniers', 'Aarberg Brügg', '-', 'Zsverdon', '- lothurn', 'Großen Rathe', 'Iverdon St Johann', 'Bühl', 'Sugy', 'Marais Tausselen Bretiège', 'Große Moos', 'Tjr wS llivirlcs', 'Donau', 'Cent', 'BERN', 'Zihl Bielersee', 'St Johannsenbrücke', 'Vsooo', 'Mühlau', 'Ly', 'Johann', '- burgersee', 'Nicca', 'OrbeMoos', 'Marais Cudrefin Terrain ville Yverdun', '- sen', 'Broye-Mser', 'Spengelz', 'Portofreihei', 'Neuenburg Solothurn', 'Port Alban Wein', 'Moose', 'Nidau Büren', 'Bren-Solothurn', 'Alban', 'Grissach', 'Lelewels', 'burgersee', 'AarbergHagnek', 'Cudrefin Moos Orbe', 'Bren', 'Murtensees Meßtischblättern', 'Großen Mooses', 'Peters Insel', 'Orbe-Mooses', 'Fr', 'Yinelz', 'Aarberg-Hagnek-Kanal', 'Marima', 'MerzligenMooses', 'Brügg', 'Neuenburg Waàren', 'Aargebiet', 'St. Blaise', 'MoloBauten', 'Ipsach', 'Schädeli', 'Fraubrunnen', 'Brgg', 'Großen Moose', 'St.', 'Buron', 'Tulla', 'nauPieterlen Mooses', 'Nidau Aegerten', 'Ctr', 'Merian', 'AarbergHagnekKanals', 'NEUENBURG', 'Johannsenbrcke', 'Neuchtel', 'OrbeMooses', 'Broye Orbe', 'Entreroches', 'Bienne', 'Hagnek-Brcke', 'Aarberg Kappelen', 'Frnburg', 'Marais Ypsach', 'PrivatPraris', 'Blotzheim', 'Nidau Terrains sur Ile St Pierre Chaussées', 'NidauBüren', 'Moos Moos', 'Ive.don', 'Cressier', 'Nidau-Bren-Kanals', 'Broye Holz', 'Sees', 'Annexe Beilage Nro', 'Ivedon', '- roches-Mooses', 'Juch', 'Cudrefin Moos', 'Seeland', 'Marais sur Thièle', 'Effig', 'Iver', 'Bielersees', 'Broye der Zihl', 'Entre', 'Solothurn Waadt', '- roches', 'Farbwaaren', 'Zohannsen', 'Pieterlenmoos, SLOC', 'Glutz', 'rochesMooses', 'Bern Solothurn', 'Marais Merzlingen', 'Donau Moos', '- nau-Pieterlen', 'Brope der Orbe', 'Fernern', 'Bron', 'Frei', 'Brttelen', 'Mhlau', '- berg-Hagnek-Kanale', '- ried', 'Neuenburger', 'lten', 'Mooses', 'Kanton', 'Landeron', 'Msern', 'Entreroche', 'Averdon', 'Aar-Rieser', 'Meyenried', 'Osterwald', 'Perimetermoos', 'LeußlingenKanals', 'Errata', 'Plan', 'Sgy', '- don', 'EntrerochesMooses', 'Ouer', 'Nidau-Bren', 'Most', 'obern Zihl', 'Sousaillon', 'Waadt Neuenburgersee', 'St Blaise', 'Großen Moos', 'Schad', 'Walperswylerbast', 'Mscr', 'Torf', 'Aarberg-Hagnek', 'Büren', 'Aar', 'Marais Pieterlen', 'Estavaper', 'lothurn', 'AarbergHagnekKanal', 'JuchartenJnhalt', 'OrbeMoose', 'St Johannsen', 'Briatte, ', 'Mser', 'Tableau', 'So', '- burg', 'Marchsteine', 'V2000', 'Orbe-Moos', 'BroyeKanals', 'Bhl', 'Freiburger-Alpen', 'Chars', 'Vrai', '- burger', '- moos', 'Soleure', 'Marais Griesach', 'Kanton Frei', 'Pieterlen', 'St. Johannsen', 'Aarberg Büren', 'Zlverdon-Grandson', 'Büetigen', 'Bonstetten', 'Sous Saillon', 'Aar von Aarberg', 'Neuenburg Neuenburgersee', 'Rhone', 'Merzlingen', 'Yverdonsee', 'Wallis', 'Saane', 'Marais Walperswyl'}",202
22677170,66521,"{'Neuenburgersee', 'Schweiz', 'Venoge', 'Waadt', 'Aare', 'Valencia', 'Neuenburg', 'Mnrtensee', 'Aarberg', 'Zihl', 'Sulpice', 'schweiz', 'Aargaus', 'Solothurn', 'Freiburg', 'Jferten', 'Bielersee', 'Thun', 'Genfersee', 'Broye', 'Attisholz', 'Thunersee', 'Rhein', 'Nordsee', 'Biberen', 'Meyenried', 'Bern', 'Staad', 'Nidau', 'Toulon', 'Mehenried', 'Murtensees', 'Emme', 'Aargau', 'Iensberg', 'Hagneck', 'Saane', 'Buren', 'Murtensee'}",39,"{'Bielersees', 'Fr', 'AarbergHageneckKanal', 'Linth', 'JfertenGenfersee', 'GümmenenMurtensee', 'AarbergHageneck', 'Murtenseeö', 'Büren', 'Dozzigen', 'Bundessubsidie', 'NidauBürenKanal', 'Juraseen', 'SuchardChallandes', 'Aare Bern', 'Murtner', 'Hageneck', 'SaaneKanals', 'Neuenburg, SLOC', 'Aarebettes', 'JsertenEntrerochesGenfersee', 'Mittelmeer', 'Bern Freiburg', 'BürenAttisholz', 'Gümmenen', 'AarbergHageneckKanals', 'Bnndesrath', 'St Gallen', 'Schachtruthe'}",29,"{'Broye-Kanal', 'Oberer Zihl-Kanal', 'Gensersees', 'Gmmenen', '- Bren', '-', 'Suchard-Challandes', '- see', 'Aarberg-Hageneck-Kanal', 'Nidan-Bren-Kanal', 'Bund', 'Jferten-Genfersee', 'Neuenburg, ', 'Gmmenen-Murtensee', 'Nidau-Bren-Kanal', 'Aarberg-Hageneck-Kanals', 'Brienzer', 'Moos', 'Neuenburger', 'Alpenstraen', 'Nicca', 'Hageneck-Kanal', '- burger', 'Niccaschen', 'Su', 'Hgniseld', 'Bieler', 'Wyleroltigen', 'Jserten-Entreroches-Genfersee', 'St. Gallen', 'Nidau-Bren-Kanals', '- chard-Challandes', 'Letten', 'Nidau-Bren', 'Aarebett', 'Bren', 'Aarberg-Hageneck', 'Wiflisburg'}",38,"{'Bielersees', 'Linth', 'Broye-Kanal', 'JfertenGenfersee', 'GümmenenMurtensee', 'Murtenseeö', '-', 'Suchard-Challandes', '- see', 'Aarberg-Hageneck-Kanal', 'Nidan-Bren-Kanal', 'Bund', 'Jferten-Genfersee', 'Bundessubsidie', 'Neuenburg, ', 'NidauBürenKanal', 'Schachtruthe', 'Nidau-Bren-Kanal', 'Hageneck', 'Neuenburger', 'Neuenburg, SLOC', 'Alpenstraen', 'Nicca', 'Hageneck-Kanal', 'Aarebettes', 'JsertenEntrerochesGenfersee', 'Mittelmeer', 'Su', 'Bieler', 'Wyleroltigen', '- chard-Challandes', 'Letten', 'Nidau-Bren', 'Bren', 'Fr', 'AarbergHageneckKanal', 'Oberer Zihl-Kanal', 'Gensersees', 'Gmmenen', '- Bren', 'AarbergHageneck', 'Büren', 'Dozzigen', 'Juraseen', 'SuchardChallandes', 'Gmmenen-Murtensee', 'Aare Bern', 'Murtner', 'Aarberg-Hageneck-Kanals', 'Brienzer', 'SaaneKanals', 'Moos', '- burger', 'Niccaschen', 'Bern Freiburg', 'Hgniseld', 'BürenAttisholz', 'Gümmenen', 'Jserten-Entreroches-Genfersee', 'AarbergHageneckKanals', 'Bnndesrath', 'St. Gallen', 'Nidau-Bren-Kanals', 'Aarebett', 'St Gallen', 'Aarberg-Hageneck', 'Wiflisburg'}",67
22660670,64014,"{'Neuenburgersee', 'Neuenburgersees', 'Linth', 'Schweiz', 'Waadt', 'Aare', 'Valencia', 'Murten', 'Neuenburg', 'Aarberg', 'Zihl', 'Solothurn', 'Freiburg', 'Bielersee', 'Thun', 'Broye', 'Erlach', 'Nirca', 'Thunersee', 'Rhein', 'Nicca', 'Meyenried', 'Bern', 'Wallensee', 'Nidau', 'Toulon', 'Murtensees', 'Hagneck', 'Buren', 'Murtensee'}",30,"{'Bielersees', 'Fr', 'AarbergHageneckKanal', 'Attishölz', 'Solothurn Waadt', 'AarbergHageneck', 'Aaregegendeu', 'Büren', 'Dozzigen', 'Ligerz Twann', 'Bundessubsidie', 'NidauBürenKanal', 'Aare Bern', 'Grnnd', 'SuchardChallan', 'Jura', 'Basel, SLOC', 'HageneekMoose', 'Aarebettes', 'Glarner Hochgebirges', 'NhodeWehren', 'Möser', 'NidauBüren', 'Stäfsis', 'Saane', 'St Gallen', 'Glarus', 'Schachtruthe', 'BürenAttishotz'}",29,"{'Ligerz', 'Brvye-Mser', 'Bren-Attishotz', '-', 'Hanv', 'Aarberg-Hageneck-Kanal', 'Bund', 'Mevenried', 'Attishlz', 'Wallensees', 'F-reiburg', 'Freibtirg', 'Nidau-Bren-Kanal', 'Stehlin', 'Aarberg-Hageneck-Kanals', 'Brienzer', 'Moos', 'Neuenburger', 'Genf', 'Nieeccks', 'Alpenstraen', 'Hageneck-Kanal', 'Basel, ', 'Neueuburgersees', 'Hgniseld', 'Mooslandes', 'St. Gallen', 'Nidau-Bren-Kanals', 'Letten', 'Nidau-Bren', 'Vren', 'Aarebett', 'Bren', 'Aarberg-Hageneck'}",34,"{'Bielersees', 'Attishölz', 'Solothurn Waadt', 'Brvye-Mser', '-', 'Hanv', 'Aarberg-Hageneck-Kanal', 'Bund', 'Ligerz Twann', 'Mevenried', 'Attishlz', 'Bundessubsidie', 'NidauBürenKanal', 'Schachtruthe', 'Nidau-Bren-Kanal', 'Grnnd', 'SuchardChallan', 'Basel, SLOC', 'Neuenburger', 'Genf', 'Nieeccks', 'Alpenstraen', 'Hageneck-Kanal', 'Aarebettes', 'Basel, ', 'Neueuburgersees', 'Mooslandes', 'Letten', 'Nidau-Bren', 'Vren', 'Bren', 'Glarus', 'BürenAttishotz', 'Fr', 'Ligerz', 'AarbergHageneckKanal', 'Aaregegendeu', 'AarbergHageneck', 'Bren-Attishotz', 'Büren', 'Dozzigen', 'F-reiburg', 'Wallensees', 'Freibtirg', 'Aare Bern', 'Stehlin', 'Aarberg-Hageneck-Kanals', 'Jura', 'Brienzer', 'Moos', 'HageneekMoose', 'Glarner Hochgebirges', 'Hgniseld', 'NhodeWehren', 'Möser', 'St. Gallen', 'Stäfsis', 'NidauBüren', 'Nidau-Bren-Kanals', 'Saane', 'Aarebett', 'St Gallen', 'Aarberg-Hageneck'}",63
9044148,34557,"{'Schaffhausen', 'Frankreichs', 'Schweiz', 'Paris', 'Genf', 'Spaniens', 'Italiens', 'Lausanne', 'Montpellier', 'Edinburg', 'Libanon', 'Bafel', 'Italien', 'Bern', 'Europa', 'Dublin'}",16,"{'Heerstraße', 'St Petcrsinscl', 'Kasthofer', 'Neufchatel', 'Brem', 'Diervilla 8arnhneus', 'Berüek', 'Chur', 'Zürich', 'gartenstraße', 'Fagus Fontanesia Fotlicrgilla Fraxinus, ELOC', 'Rosaceen', 'Legn', 'Arnen'}",14,"{'Prunus', 'Zrich', 'Linne', 'Cratse', 'Populi, ', 'Berns', 'St. Petcrsinscl', 'West', 'Robinie', '- ditschia', 'Graffenried', 'Caraganrc', 'Rhododendren', 'Viburnum', 'Gle', 'Persica', 'Oornus', 'Gleditschien', 'Amygdalus', 'Schwczingen'}",20,"{'Kasthofer', 'Prunus', 'Diervilla 8arnhneus', 'Zrich', 'Linne', 'gartenstraße', 'Rosaceen', 'Arnen', 'Cratse', 'Populi, ', 'Berns', 'St Petcrsinscl', 'Brem', 'St. Petcrsinscl', 'Fagus Fontanesia Fotlicrgilla Fraxinus, ELOC', 'West', 'Heerstraße', 'Robinie', '- ditschia', 'Berüek', 'Graffenried', 'Caraganrc', 'Zürich', 'Rhododendren', 'Viburnum', 'Gle', 'Neufchatel', 'Persica', 'Oornus', 'Chur', 'Gleditschien', 'Amygdalus', 'Schwczingen', 'Legn'}",34
15916292,50383,"{'Neuengasse', 'Altenberg', 'Herrengasse', 'Berns', 'Metzgergasse', 'Schliem', 'Postgasse', 'Mattenhof', 'Zeughausgasse', 'Solothurn', 'Gasei', 'Basel', 'Sulgenbach', 'Bern'}",14,"{'Senklöchcr', 'Aarbergergasse Speichergasse', 'Kesslergasso', '3JSffausrr', 'Käfichgässchens', 'Länggasse', 'Gaselwasscr', 'Gasdirektors', 'München Sondershausen', 'Schosshalde', 'Gasolwasser', 'Gasetnoasser', 'Staldens', 'Bremgarten', 'ScJud, SLOC', 'Rothes', 'Brunnadern', 'TyphusEpidemie', 'Breitenrain', 'Athmungsluft', 'Sdurarz', 'JUies', 'Könitzberg', 'Rothenbach', 'MarzieleIfof', 'Altenberghöhe', 'Lorraine'}",27,"{'Aarbergergasse', 'Schliern', 'Schweiz', 'Nov', 'Pelikan', 'Speichergasse', 'Typhus', 'Schcim', 'Lebendon', 'Mnchen', 'Knitzberg', 'Matte', 'intra muros', 'Aarnfer', 'Fuss', 'Bern, ', 'Altenberghhe', 'Lnggasse', 'Sondershausen', 'Knitzborge', 'Molasse', 'Torfmoos'}",22,"{'Aarbergergasse', 'Senklöchcr', 'Schliern', 'Schweiz', 'Pelikan', 'Nov', 'Aarbergergasse Speichergasse', 'Kesslergasso', 'Speichergasse', '3JSffausrr', 'Käfichgässchens', 'Typhus', 'Schcim', 'Lebendon', 'Länggasse', 'Mnchen', 'Gaselwasscr', 'Knitzberg', 'Matte', 'Gasdirektors', 'intra muros', 'Aarnfer', 'München Sondershausen', 'Fuss', 'Gasolwasser', 'Schosshalde', 'Gasetnoasser', 'Bern, ', 'Staldens', 'Bremgarten', 'ScJud, SLOC', 'MarzieleIfof', 'Altenberghhe', 'Rothes', 'Lnggasse', 'Brunnadern', 'Sondershausen', 'Knitzborge', 'TyphusEpidemie', 'Breitenrain', 'Molasse', 'Athmungsluft', 'Sdurarz', 'JUies', 'Könitzberg', 'Rothenbach', 'Torfmoos', 'Altenberghöhe', 'Lorraine'}",49
22562760,26379,"{'Neuenburgersee', 'Waadt', 'Aare', 'Murten', 'Neuenburg', 'Aarberg', 'Dotzigen', 'Solothurn', 'Bielersee', 'Attisholz', 'Solothurns', 'Wili', 'Meienried', 'Emmen', 'Moosland', 'Wilihof', 'Solothurri', 'Bern', 'Staad', 'Nidau', 'Mooslandes', 'Aarebene', 'Buren', 'Murtensee', 'Orbe', 'Peterlingen'}",26,"{'Fr', 'Solothurn, SLOC', 'Zürich', 'Rappensluh', 'Broye', 'Büren', 'Zihl'}",7,"{'- holz', '- hof', 'Emmenholz', 'Moos', 'Solothurn, ', 'Nicca', 'Murtnersee', 'Altreu', 'Murt', 'Mser', 'Aarebett', 'Bren', '- nersee'}",13,"{'Fr', 'Emmenholz', '- hof', 'Rappensluh', 'Büren', 'Zihl', 'Murtnersee', 'Altreu', 'Mser', 'Broye', 'Moos', 'Solothurn, ', 'Nicca', 'Zürich', '- nersee', '- holz', 'Solothurn, SLOC', 'Murt', 'Aarebett', 'Bren'}",20
22742131,140093,"{'Lyss', 'Main', 'Neuenburgersee', 'Emmenholz', 'Lauterbach', 'Linth', 'Werngart', 'Mannheim', 'Aare', 'Neuenburg', 'Aarberg', 'Zihl', 'Dotzigen', 'Riedli', 'Sugy', 'Attishokz', 'Solothurn', 'SolotHurn', 'Rappenfluh', 'Bielersee', 'Altreu', 'Tulla', 'Hageneck', 'Broye', 'Attisholz', 'Aarbcrg', 'Bachmatt', 'Moos', 'Rhein', 'Mooses', 'Meienried', 'Murgenthal', 'Rheins', 'Svlothurn', 'Walperswyl', 'Landeron', 'Bargen', 'Bern', 'Pfeitwald', 'Nidau', 'Neuenburgcr', 'Wangen', 'Emme', 'Hagneck', 'Solothnrn', 'Rhone', 'Saane', 'Buren', 'Murtensee', 'Pfeidwald'}",50,"{'Broye VIII', 'Bielersees', 'Pont Arherg', 'Brügg', 'Nidauer Kanal', 'Großen Moos', 'Dozigen', 'Murten', 'Bußwyl', 'Büren', 'Aarufcr', 'Castiglione Toskana', 'Broye Thièle', 'Aarkanals', 'Aar', 'Pegelscale', 'Bern Bern', 'Arch Bachmatt', 'Pegelhöhe', 'Pronysschen', 'Oeffnungen', 'Roßmarkt Arberg', 'Aarbergerkanal', 'Staad Arch Bachmatt Altreu Leussli', 'Querdamm', 'Zrnggen der Zehnerscheuer Thoune Aar intérieur Sur digue transversale depuis Zinggen jusqu grange Zehner Thun Aeußere Aare Zwischen Scherzligen', 'Aarberg VIII', 'Aar Bachmatt', 'Zihlbrücke', 'TäuffelenMooses', 'Péri', 'Thièle', 'Neuenburgcr See', 'Meienried Aarberg', 'Landquart', 'Aare Zihl', 'AltreuJnsel', 'Bienne', 'Krondicke', 'Wassermaffe', 'Hinterdämme', 'Büren Taf', 'Solothurnbrücke', 'NidauSee', 'Rothhaus', 'BielerSee', 'Hängni', 'Aarberg Brücke', 'Berne Largeur moyenne Profondeur moyenne Contenance Surface', 'Bern Fuß', 'Broye Zihl', 'Meienried Büren', 'Höchst Wst', 'TäufelenMoose', 'Aarberg Büren', 'Täuffelen', 'Ombrone', 'Hagen Seite', 'Längenprosil', 'Juragewa', 'Thun Innere Aare', 'Tal XIl', 'Uebrigens', 'Büren Bachmatt', 'Zihl Beim Pfeidwald Près Pfeidwald, ELOC', 'AarKanals', 'Graubünden Bern', 'Großen Mooses'}",68,"{'Meien', '-', '- see', 'Mett', 'Schwelle', 'Altisholz', 'Freiburg', 'Noms', 'Romarkt', 'Ins', 'Thalgut', 'Priphrie', 'Ly', '- burgersee', 'Nidauer', 'Chap', 'Taf', 'Bieler', 'Wallensee', 'Veau', 'Zihlbrcke', 'nouvelle', 'Anleg.d.Brcke', 'Zrhl', 'Bieler-See', 'Prs', 'Seelandes', 'Bren', 'Dure', 'Pegels', 'Waadt', 'Zucharten', 'Pegel', 'Fehlbaum', 'Brgg', 'Juchart', '- bette', 'Rappen', 'Aaro', 'Kies', 'Erlach', 'Allmein', 'Graubndten', 'Scherzligen', 'Morgentbal', 'Molasse', 'Reiben', 'Schzenmatt', 'Lelewel', 'Arherg', 'Prony', 'Buwyl', 'Solo', '- thurnerbrcke', 'Aar-Kanals', 'Arch', 'Eitelwein', 'Brttelen', 'Pieterlen-Moos', 'Hagen', '- ried', 'Skala', 'Kanton', 'Bonstettens', 'Thalqut', 'Solothurnerbrcke', 'Plan', 'Moosland.Zucharten', 'Pfeidwald, ', 'Vren', 'Castiglione', 'Arberg', 'Aarwangen', 'Ancien', 'Toskana', 'Solothurnbrcke', 'Brope', 'Ly.', '- Moos', 'Thun', 'Nidau-See', 'Solotburn', 'Murren', 'Siena', 'Graubnden', 'Emmerich', '- lothurnerbrcke', 'Bernfu'}",88,"{'Meien', 'Nidauer Kanal', 'Murten', '-', 'Aarufcr', '- see', 'Mett', 'Schwelle', 'Bern Bern', 'Altisholz', 'Freiburg', 'Noms', 'Romarkt', 'Ins', 'Thalgut', 'Querdamm', 'Zrnggen der Zehnerscheuer Thoune Aar intérieur Sur digue transversale depuis Zinggen jusqu grange Zehner Thun Aeußere Aare Zwischen Scherzligen', 'Aarberg VIII', 'Aar Bachmatt', 'Priphrie', 'Zihlbrücke', 'Ly', '- burgersee', 'Nidauer', 'Chap', 'Meienried Aarberg', 'AltreuJnsel', 'Taf', 'Bieler', 'Wallensee', 'NidauSee', 'Veau', 'Rothhaus', 'Aarberg Brücke', 'Zihlbrcke', 'Ombrone', 'nouvelle', 'Hagen Seite', 'Längenprosil', 'Thun Innere Aare', 'Tal XIl', 'Anleg.d.Brcke', 'Zrhl', 'Bieler-See', 'Seelandes', 'Bren', 'Prs', 'Graubünden Bern', 'Großen Mooses', 'Dure', 'Brügg', 'Pegels', 'Waadt', 'Dozigen', 'Zucharten', 'Pegel', 'Castiglione Toskana', 'Fehlbaum', 'Brgg', 'Juchart', 'Pronysschen', 'Oeffnungen', '- bette', 'Rappen', 'Aaro', 'Kies', 'Erlach', 'Allmein', 'Neuenburgcr See', 'Landquart', 'Aare Zihl', 'Bienne', 'Graubndten', 'Scherzligen', 'Berne Largeur moyenne Profondeur moyenne Contenance Surface', 'Bern Fuß', 'Broye Zihl', 'Morgentbal', 'Uebrigens', 'Molasse', 'Reiben', 'Büren Bachmatt', 'Schzenmatt', 'Zihl Beim Pfeidwald Près Pfeidwald, ELOC', 'Lelewel', 'Broye VIII', 'Bielersees', 'Pont Arherg', 'Arherg', 'Buwyl', 'Prony', 'Bußwyl', 'Solo', 'Broye Thièle', '- thurnerbrcke', 'Aar-Kanals', 'Pegelscale', 'Aarbergerkanal', 'Arch', 'Eitelwein', 'Brttelen', 'Pieterlen-Moos', 'Hagen', '- ried', 'Skala', 'Krondicke', 'Kanton', 'Wassermaffe', 'Bonstettens', 'BielerSee', 'Hängni', 'Meienried Büren', 'Höchst Wst', 'Thalqut', 'TäufelenMoose', 'Solothurnerbrcke', 'Plan', 'Moosland.Zucharten', 'Pfeidwald, ', 'Vren', 'AarKanals', 'Castiglione', 'Großen Moos', 'Arberg', 'Aarwangen', 'Büren', 'Aarkanals', 'Ancien', 'Toskana', 'Aar', 'Solothurnbrcke', 'Arch Bachmatt', 'Brope', 'Pegelhöhe', 'Ly.', 'Roßmarkt Arberg', '- Moos', 'Staad Arch Bachmatt Altreu Leussli', 'Thun', 'Nidau-See', 'Solotburn', 'TäuffelenMooses', 'Péri', 'Thièle', 'Murren', 'Siena', 'Büren Taf', 'Hinterdämme', 'Graubnden', 'Solothurnbrücke', 'Aarberg Büren', 'Emmerich', '- lothurnerbrcke', 'Juragewa', 'Bernfu', 'Täuffelen'}",156
9507941,301441,"{'Drontheim', 'Hormannsgasse', 'Neuengasse', 'Krauchthal', 'Lombach', 'Lauseneggbad', 'Nlarktgasse', 'Altenberg', 'Ularktgasse', 'Hauptgasse', 'Augsburg', 'Nvdeck', 'Speickergaffe', 'Nvdeckj', 'Klein', 'Dusour', 'Norwegen', 'Lizi', 'Murten', 'Alarktgasse', 'Diinz', 'Gundelfingen', 'Wurstembergerthurm', 'Gloggnerstbor', 'Lindenhof', 'Monrepos', 'Frankfurt', 'Stetten', 'Reichsburg', 'Bollnr', 'Freiburg', 'Schweitzerlands', 'Marzili', 'Elsenau', 'Rabbenthals', 'Kvburg', 'Aramgasse', 'Iunkerngasse', 'Stalden', 'Tiesenau', 'ostgasse', 'Gerbernlaube', 'Europa', 'Muri', 'Ryburg', 'Spitalgasse', 'Airchlindach', 'Echwarzenburg', 'Gandegg', 'Altorf', 'Langnau', 'Biedermann', 'Zwingclhof', 'Burgerspital', 'Muristalden', 'Oberthor', 'Lyon', 'Sulgenbach', 'Neapel', 'Nydeckgasse', 'waldau', 'Bedeck', 'Etaldens', 'Hirschenhalde', 'Berlin', 'Bernerhos', 'Diesbach', 'Egerten', 'Bernschuh', 'Lausanne', 'Iuselgasse', 'Mnnsterthurinj', 'Lhamberp', 'Ilmenau', 'Herrengasse', 'Golatenmattgassenthor', 'Trlach', 'Schweiz', 'Baumgarten', 'Ienner', 'Zeughausgasse', 'Wien', 'Gerechtigkeitsgasse', 'Thristossel', 'Alpenpanorama', 'Italien', 'Waldau', 'Neuenburg', 'Gstermontag', 'Mesten', 'Aabbenthal', 'Dolder', 'Hirschengraben', 'Paris', 'Kirchhof', 'Baden', 'Grnnegg', 'Lorraiue', 'Botelgasse', 'Rov', 'Baun', 'Verona', 'Bubenberg', 'Araingasse', 'Franenthurm', 'Kreuzgasse', 'Thorberg', 'Erlach', 'Nranienburg', 'Inselgasse', 'Bellevue', 'Konstanz', 'Brunngasfe', 'Sulgeneck', 'Bundesrain', 'Hreiburg', 'Hriedli', 'Btalden', 'Altenbergs', 'Ivaiseuhausplatz', 'Burgund', 'Haspelweg', 'Holzschoxf', 'Aistler', 'Bern', 'Neuenstadt', 'Holland', 'Staldens', 'Novara', 'Bmnuree', 'Tillierthurm', 'Abeille', 'Wangen', 'Aarethal', 'Alanenthal', 'England', 'Aarberqer', 'Rramgasse', 'Junkerngasse', 'Amsterdam', 'Breisgau', 'Aarbergergasse', 'Bollanden', 'Kircheufeld', 'Frienisberg', 'Aare', 'Berneralpen', 'Lortz', 'Airchgasse', 'Reims', 'Speichergasse', 'Aosta', 'Rreuzgasse', 'Golata', 'Savoyen', 'Oranienburg', 'Savohen', 'Mont', 'Alb Kauw', 'Erlenhof', 'Brunngasse', 'Gstseite', 'Metzgergasse', 'Bubenbergsthiirli', 'Hettiswil', 'Burgdorf', 'Golatenmatt', 'Harnischthurm', 'Wattenwvlj', 'Albanien', 'Venedig', 'Biel', 'Strerlitburnr', 'Frankreich', 'Gerbergasse', 'Marziliiveg', 'Stralsnnd', 'Lrlach', 'Schweitz', 'Aletzgergasse', 'Kistler', 'Benteli', 'Rrauchthal', 'Kirchgasse', 'Eandrain', 'hormannsgasse', 'Bremgarten', 'Keelhofen', 'Thristosfelthurm', 'Liebenau', 'Brunnadern', 'Areuzgasse', 'Nerns', 'Savoven', 'Alpen', 'Hallerhaus', 'Habsburg', 'Inseli', 'Bregenz', 'Aegidius', 'Altenrys', 'Lorraine', 'Ningol', 'Tngi', 'Lombachthurm', 'Brunn', 'Belgien', 'Spanien', 'Salvisberg', 'Marseille', 'Nydeckkirche', 'Postgasse', 'Nrdeckkirche', 'Fizi', 'Basino', 'Passau', 'Gryphen', 'Golatenmattgasse', 'Predigerthurm', 'Bremgartenwald', 'Westei', 'Nydeck', 'Marktgasse', 'Berns', 'Tgerdon', 'Berngrub', 'Europas', 'Belgrad', 'Bundesgasse', 'Kistlcr', 'Badgasse', 'Thun', 'Rainseyerloch', 'Grassenried', 'Grindelwald', 'Helvetiens', 'Plepp', 'Maikirch', 'Bormannsgasse', 'Thunstetten', 'Illurtenthor', 'Mattenhos', 'Marzilithor', 'Burgistein', 'Liebegg', 'Viktoria', 'Versailles', 'Hotelgasse', 'Felsenburg', 'Tonrad', 'Basel', 'Schntzcnlaube', 'Sarergut', 'Sxitalgasse', 'Dunker', 'Aiegelthurm', 'Amthausgasse', 'Bubenbergsrain', 'Rlarsili', 'Bonstetten', 'Kramgasse', 'Bollin', 'Obstberg', 'Gasse', 'Obstbergs', 'Manuel', 'Stadtbach', 'Dalinatien', 'Stettler'}",269,"{'Rathhauses', 'Röniz', 'Nr Mattenenge', 'Der Münsterthurm', 'Bümplitz', 'Vorblen', 'Unteres Mar Bärengraben', 'Auttelthurm', 'Gesellschaftshaus Museum', 'Interlaken', 'Haspelmatte', 'Den Lombachthurm', 'Äalden', 'Äaldens', 'Staldons', 'Aargauerstalden', 'Nvin', 'Zieglerischen Prospektensammlung', 'Lhristoffelthunn', 'Rvdeckkirche', 'waisenhausstraße', 'Gerbergesellschast', 'Iakobsspital', 'Kantonsschul', 'AelbiLhntteZyt', 'Gracht Line', 'AN Dorn Gerberngraben', 'EgertenGasse', 'Antonierhaus', 'Fr', 'Äadtrath', 'Brügg', 'Lnrsche', 'R49', 'Lopoßraiiliisjns', 'Thorbogens', 'Kehrhüsi', 'Waschhaus Holz', 'Nüeggisberg', 'Hrienisbergerhaus', 'Nr Hirschengraben', 'Herzogenbuchsee', 'Rehsues', 'Kurze Gasse', 'Orlev', 'Wattenwvl', 'Waisenhausstraße', 'Störcklin Basel', 'Hinan', 'Walds, SLOC', 'Klösterli', 'Gorge Line', 'Münsters Münsterplatz', 'Savoyen Lothringen', 'Gerberngrabens', 'Nr Bärenplatz Bärengraben', 'Oberes lllarzilithor', 'Gberthor', 'Nr Keßlergasse Niedermetzgern', 'Schauplatzgasie', 'Breissach', 'Links', 'Austaus', 'Tschisteli', 'IBiedermann', 'Pallisaden', 'Großen Rathes', 'Jähringen', 'Bpdeckbrücke', 'Aäfigthurm', 'Thüring', 'Wattenwzl 1702', 'Aonüo', 'Nydeckbrücke', 'Weißenbühl', 'Antonierkapelle', 'Lehrgotte Nr der Brunngasse', 'Nvffli', 'Rathhausterrasse', 'Äraßenstnck', 'Nürnberg', 'Kiellaslis', 'Derselbe', 'Lhorhause', 'Laubeckstraße', 'Allmend', 'Zeughaushof Todtenacker Zeughausgasse Ovrj tlnrüs Zeughausplatz Schweinmarkt Golatenmatt', 'Salzmagazin', 'Grünenbergs', 'Merkbos', 'Bärenhöfli', 'Schöps', 'Engistraße', 'Heide', 'Etrecki', 'Zürich', 'Narktuasse', 'tadt Lehen', 'Bäthe', 'Tngistraße', 'Iohanneskirche', 'Wattenwrl', 'Beundenfeld Erbaut', 'Das Tommerrienhaus', 'Lorrainestraße', 'Ringstraße', 'Rvdeek', 'Hriedhose', 'Der Stalden', 'Mißbuw', 'Tchattseite', 'Frankfurt Bern', 'Hauptstraße', 'Marmortafel', 'Thorthurme', 'Lchafsners', 'R93', 'Klösterliwirthshauses', 'Thurmes', 'Weißenstein', 'Tidche Lggimann', 'Polländerthurm', 'Osterrieth', 'Linden', 'Blatt sxSK', 'Muristraße', 'Rlarzili', 'Nr Gerechtigkeitsgasse', 'Leutkirche33 Lizi Loinbachthurm', 'Balligen', 'Zähringen', 'Taubenstraße', 'Alte Däuser', 'Läuserplah', 'Tramwavgesellschast', 'R89', 'Münsterplatz', 'Küpser', 'Fallbrücke', 'Trämelhaus', 'Thurm Banse', 'Lsaus', 'Das Ober', 'Karls VIII von Frankreich', 'Effinger von Aarburg', 'Bärengraben', 'Erlacherhof', 'Rathhaus', 'Judengasse', 'NeuenburgLchanzs', 'Donnerbühl', 'Lrlacherhofes', 'Mußhasen', 'Amdlisresserbrunneu', 'Spital', 'Aeitglockenthurme', 'Zeitglockenthurm', 'Als Korn', 'Rüwenthal', 'Gäßchens', 'Aäfigthurnr Bern', 'Schultheiß', 'Lkristoffelthurnr', 'Gberspital', 'Alpeuxauorama Bern', 'Nxdeck', 'Burghof', 'Rainseherloch', 'Keßlergasse', 'Bathhauses Graben', 'Schlößlistraße', 'Arrnäluttg', 'Baspelgäßli', 'Aaths', 'IVärterhaus', 'Oorps', 'Lhristosfelthurms', 'Bärn', 'Aieiiisberghaus', 'München', 'Gurtens', '2lare', 'Käfigthurm', 'Brod', 'Hintere Stöck', 'Beinzmann', 'Aargauerftaldens', 'Ehors', 'Aargauerstaldens', 'Bärenhösli', 'Etadttheil', 'Allüsli Bad', 'Trachselwald', 'Räthe', 'Wirthshaus', 'Toubhüsli', 'Echützenhaus', 'Lpitalkirche', 'St Johannser', 'Fraubrunnen', 'Münsters', 'Tschisfelibesitzg Hinteres Haus', 'Aasinogarten', 'Blichelisthürli', 'Brunngaßhalde', 'Aare Bern', 'Acbischlößli Altenberg', 'Kleine Bär', 'Airchenfeld', 'Thristosselthurm', 'WWrX Christoffeltburm', 'Kupferhammer', 'BernerLhronik', 'Rlapperläubli', 'Rcünsterthurines', 'Straßei', 'Hanz', 'Rlarcellus', 'Thurmes Mohnenden', 'Äügenbach', 'Akosesbrunnen', 'Eommerlaube', 'Eprüngli', 'Inselisteg', 'Breitenrain', 'Dalinazi', 'Hüttengraben', 'Eüden', 'Luntenthurm', 'Berner Kunstmusemu', 'Bern Uchtland', 'Hossratt', 'Thierspital', 'Eommercienhaus', 'I8b3', 'Graden Streckithurni Oberes Marzilithor Weinberg', 'Äadt', 'Aarenthurin', 'Ziegler', 'Rreuzes', 'Brodschaal', 'Echandpsahle', 'Gstermundigen', 'Alapperläubli', 'Bathsmanuals', 'Den Stadtgraben', 'Epitalkirche', 'Etadt Bern', 'Alorlotläubleins', 'Dalp Bern', 'Münsterthurmes', 'Heiliggeist', 'Patrontasche', 'Leutkirche', 'Schweinestäüe', 'Ilvrnmnni', 'Nr Miinzrain', 'Äadtbach', 'Könizstraße', 'Mosesbrunnen', 'Lergangenheit', 'Manches', 'Awiebelgäßcheii', 'Bohliebischanzs', 'UMM', 'Deutschordenshaus', 'Haus Nr', 'Dundeshäuscr', 'Danske', 'Freiburgstraße', 'Bandelsmanns', 'ötadt Bern', 'Historische Museum', 'Der olländerlbur', 'Könizbergwald', 'Bym Bütsche', 'Albrecht ', 'Haus Itt', 'Krne', 'Ranton Bern', 'Schloß Holligcn', 'Ritters Tonrad', 'Lrlachdenkmal', 'Trianon', 'Nr 2tz', 'Mittellande', 'Hausen', 'Mohnenden', 'Ichburg', 'Bathhauses', 'Luisenstraße', 'Assen', 'Kathhaus', 'Münsterbauhütte', 'Rodt von  87Z 878', 'Frienisbergerhaus', 'Bern Lourad Tiirst', 'Nr Zeughaus', 'IuraÄmplon', 'Bestimmuna', 'Diesbachhaus', 'Hofstatt', 'Erker Thurme', 'Marsilien', 'Münzthor', 'Tremouille', 'Hotel lLnropo', 'Gryphenhübeli', 'Aarstraße', 'Grvphenhübeliweg', 'Ankenmärit', 'Lngi', 'Aiegelhütte', 'Weißenheim', 'Räsigthurm', 'Tschisseli', 'Aeußeres Golatenmattgaßthor', 'Dietrichshaus', 'Räth', 'Waiseichausstraße', 'Hricktreppe', 'Lenbrunnens', 'Salzmagazin Dahinter', 'Deutschen Orden', 'Bath Haus', 'Aönizbergwald', 'Villa Margherita', 'Frontispicii', 'Theaterplatz', 'Noll Nöthiger Nydcck', 'Uolligenstraße', 'Nleyenburg Neuenburg', 'Der Bach', 'Sardelle Gassennamen', 'Madt Bande', 'Tchwesel', 'Gundelfingen Harnischthurm', 'Velin', 'Gffingerstraße', 'Sarergut Altenberg', 'Münsingen', 'Marzilistraße', 'Tschiffelithurm von Dunker', 'Kuinss Paris', 'Fm', 'NIeiner', 'Der Volksmund', 'Speichergasse Waisenhausstraße', 'Alünsterthurmes Blatt Ost', 'Schoßhalde', 'Bcrgaugeuheit', 'Nagelisheim', 'Bernhardsbrunnen', 'Ober', 'Käfigthurms', 'Stadtthore Line Querstraße', 'Haus der Speichergasse', 'Ankenwaage', 'Schönenberg', 'Akai N05', 'Matte Inseli Muristalden', 'H  pothekarkasse', 'Buurema', 'Garten Weinberg', 'Thoren', 'Christ wiilading OAerfter pulverthurm der Aare', 'Nr Gerbhaus Nr Tchon', 'Aarbergerthor Bärengraben', 'Mittellöwen', 'Nsdeckkirche', 'Zes MMstwißwM Iuli,894', 'Monreposgutcs', 'IHZ', 'Heiliggeistkirche', 'Museum Helvetiaplatz', 'Kirchenseldes', 'Äadttheile', 'Ttufaug', 'Awiebelngüßchen', 'Alten Bern', 'Aeußeres', 'Endlisberg', 'Komthur', 'Aäfigthurin', 'Salem Links', 'Alt5chult', 'Nsdeckb', 'Mattenenge', 'Münsterthurm', '6ntg Oom', 'Iuker', 'Lhorherrentreppe', 'Bergangenheit', 'Aienisbergerhaus', 'Rlünsterthurmes Blatt Nord', 'Haspelgasse', 'Predigerkirche', 'jDIane', 'Lause', 'Kirch', 'Aornhausbrücke', 'Llendenherberge', 'Schänzli', 'Aobischlößli', 'Ostindien Schloß Uolligen  8ö7 228 Bern', 'Uauw', 'Haus Nr Aramgasse', 'Tommerrienhaus', 'Lchweiz', 'Käsigthurm', 'Giebelselde', 'Tiefe', 'Theater Thiergraben Thürme Thurm weißer Tillierthurm', 'Thürmchen', 'Hayade', 'Zwingelhos', 'Zeittzlockenthurm', 'OKKHWW Bern', 'Bundeshäuser Ost', 'Schneebeli', 'apiermühlestraße', 'Lhorhauses', 'Aebischlößli', 'Ghor', 'Ramseyerloch', 'Aäsmarkt', 'Frienisbergerhause', 'Laupenstraße', 'Amsoldingen', 'Etraßburg', 'Grauholz', 'Bubenbergsthürli', 'Bröwenhause', 'Utzigen', 'St Johannscrhaus', 'Nheins', 'Bundesrathhausterrasse', 'Gosphenhübeli', 'Bümpliz', 'Zeugwarts', 'Niggeler Schanzengraben', 'lWO', 'Grrpbenbübeli', 'Der Lärenxlatz', 'Zalt BuureWirtzhuns', 'Vurgdorsjtraße', 'Äettbrunnens', 'Äraß', 'Epeisewirthschastsrecht', 'Erker Eckhause', 'Thorthurm', 'Anshelm ÄtaloZus', 'Lsöhe', 'Uchttenbach', 'Eonne', 'Waisenhansplag', 'Münzrain', 'Korn Haus', 'Aähringen', 'Bernerhose', 'Bondeli', 'Dioureposgutes', 'Etiftschaffners', 'Monbijougutes', 'Am Ltadtbach', 'heiliggeist', 'Schlosses Wolligen', '5chütte', 'Nxdeckkirche', 'Grasfenried', 'Barnischthurm', 'Haus Glur', 'Frienisbergerhauses', 'Köniz', 'OrnuämnOonneui', 'Aornhauses', 'Arone', 'I7HI8', 'Arattingerhaus', 'Rlösterli', 'Spitalmatte', 'Dählhölzli', 'Schiitzeumatte', 'Weiler Gptingen', 'Altes historisches Museum', 'Aeßlergasse', 'Binscheid', 'Großrathssaal', 'Thristoffel', 'Sxitalkttche', 'Rälberslotte', 'Btreckithurm', 'Ieitglockenthurms', 'Nordwesten Lude', 'Hotel Fetzer', 'Münster', 'Spitalgasse Melbild', 'Rathhause', 'Marzilithors', 'Ariegsrathes', 'Brügg Hchon', 'Gerecktigkeitsbrunneu', 'Lngistraße', 'Straßburg', 'Niederlanden', 'Bibliothek Hütte', 'Mkei', 'tadt', 'Lhristoffelthurm', 'Golatenmattgassenthurnr', 'Schweselthurm', 'Der Brunnen', 'Gilgen Lilie', 'Lenti Sack', 'Rodt Architekt Serien', 'Don 141b', 'Käsigthurms', 'Münsterthurms', 'Mattenenge Haus', 'Thor Altenberg', 'Dcrgaiigeirheit', 'Nvdeckkirche', 'Botel Bellevue', 'Ravalleriekaseme', 'Haxade', 'Rvdeckgasse Interlaken', 'Haoade', 'Rönig', 'Äaatskanzlei', 'Nsdeck', 'Meyenburg Kleiner Bär', 'Küwenthal', 'Falkenxlätzli', 'Iran', 'Meißenbühh', 'Bern Berns', 'Scheuer Speicher', 'Katbhaus', 'Thores', 'Bowex', 'Iinkenhubel', 'I3tzO', 'Museum Bern', 'Herkulessaale', 's2äö', 'mn8Üpi6', 'Airche', 'Ostermundigen', 'Brenner', 'Reichsburg Vchdeck', 'Boizot', 'Uaspelweg', 'Atäritgasse', 'Historisches Museum', 'Bauptstraße', 'Tlbeille', 'Gesellsckaftsbaus Museum', 'LWB', 'Lsrns', 'Dom Denner', 'Ulmer Münsters', 'Hotels Bellevue', 'Bierhübeli', 'wabernstraße', 'Augustiner Thorherren', 'Münster Bern', 'waaghaus', 'Eckhaus', 'Bühlstratze', 'Münsterthurmes Blatt West', 'Schindelthurni', 'BerHangenheit', 'Bundesrathhauses', 'Rcünsterthurmes', 'Dietrichs Haus', 'Rathes', 'Bondelihaus', 'Wasserwerkstraße', 'Aarebrücke', 'Rurve', 'Nr Marktgasse', 'Lohr', 'Zcughaushoses', 'Münz', 'Iohannserhaus', 'Schweselthurin', 'Bundesrathhause', 'Nydeckhofes', 'WlilÜ Weinbergen', 'Schützenmatte', 'Kaus Bern', 'Aeitglockenthurm', 'Münsterbau', 'Thunstraße', 'Äadtbachs', 'Interlakenhauses', 'Vivenel', 'Bath', 'Lhristosselthurin', 'Alurtenthor', 'Osterrieths', 'K98', 'Nydeckhof', 'Zürichs', 'Burgerspitals', 'Höheweg', 'Lrlacherhofe', 'Bubenhand', 'Namseverloch', 'Das Isen', 'Richterstuhl', 'Aamseyerloch', '5traßburg', 'Rlünzthor', '6orpu8 äelieti sog Trlach', 'Blatt Süd', 'Nsdeckgaffe'}",617,"{'Wolf', '^-', 'Brodschaalen.21', 'Bartl', 'Iago', 'Schinkengasse', 'Studersche', '- brg', 'Michelisthrli', 'Turngraben', 'Strler', 'Lngistrae', 'Blatternhaus.80', 'Oberes', 'Rrauch', 'Metzgern', 'Miinsterplatz', 'Markt', '- tingen', '5traburg', 'Knizstrae', 'Mnchen', 'Anshelm', 'Reitschulhofe', 'Hohle Gasse', 'Jenner', 'Weihergasse', 'Anizbergwald', 'Eogar', 'Erlacherhoss', 'Rlsterli', 'Tchon', 'Schnyder', 'Tachnaglcrgrabc', 'Gelsarb', 'Iwingelhof', 'Muristrae', 'Bldenburger', '2lugsburg', 'Dalmazi', 'Sandfluh', 'Nwenthal', 'Rth', '^ chauplatzgasse', 'Ksmarkt', 'Lilie', 'Ltschenbach', 'Tillier', 'Elendenherberge.50', 'Kabsburg', 'Tachnaglergraben', 'Wendschatzgasse', 'chweinsberg', 'Brgg', 'ZParis', 'Hollnderthurm', 'Hsrrengasse', 'Egerten-Gasse', 'adtbach', 'Ireiburg', 'St. vincenzen', 'Rirchhoss', 'Freiburgstrae', 'Gbstberg.102', 'Johannserhaus', 'Rodt', 'Bormegasse', 'Grvphenhbeliweg', 'Anno', '- thor', 'Gelin', 'eedors', 'Marzilistrae', 'Thurm', 'avoyen', 'Reitschulhof.100', 'Brenhsli', 'Mller', 'Strcklin', 'Lorrainestrae', 'Lentulus', 'IBeirrberg', 'Zeringen', 'taloZus', 'Monbijou', 'Michelis', 'Oranienburg.82', 'Stalden.12', 'Eden', 'Gallen', 'Ltadtbach', 'Ewaflantzgasse', 'Bchohalde', 'Wald', 'Sd', 'Neuenstadt.16', 'Mnster.131', 'Trommauer', 'Plan', 'Klosterli', 'Stumpf', 'Bpdeckbrcke', 'Tiirst', 'Mnster', 'Falkengasse.20', 'Rauw', 'Gsterrieth', 'Nodt', 'Inneres', 'Lenzburg', 'Metzgcrgasse.24', 'R', 'Rainse', 'Leutkirche.33', 'Berna', 'Engixromenade', 'Rydeckbrcke', 'Tellrodel', 'Herrliberger', 'Bern.6', 'Ost', 'Nzdeckbriicken', 'Viehmarkt', 'Rud', 'Aarebrcke', 'Lombachs', 'chinkengasse', 'charnachthal', 'Mnzrain', 'Graffenried', 'Brenxlatz', 'Mirani', 'Rob', '- strae', 'Mitivari', '5ulgenbach', 'Httengraben', 'tzudengasse', 'Stalden.21', 'Grlach', 'Gerberngraben', 'Sardelle', 'Mutach', 'Margherita', 'Kornhaus', 'Lonrad.80', 'Aebischlli', 'Lsabsburg', 'Dublonen', 'Kelergasse', 'Brenqraben', 'Aornhausplatz', 'Reuenfladt', 'wislisburg', 'Bartl.31', 'MarNli', 'Nvdeckkirche.36', 'Schanzen.10', 'Iudengasse', 'Amtkausgasse', 'Kor', 'Aarburg', 'Laubeckstrae, ', 'tzreiburg', 'weien Areuz', 'Bundesratbbaus', 'Dominikaner', 'Udel', 'Muleren', 'Kohlerthurni.171', '^', 'Morlotlublein.115', 'Loinbachthurm', 'Riiwenthal', 'Meyer', 'Gasier', 'andrain', 'Meienbhh', 'Aeughausgasse', 'Wattenwzl', 'Dalmazi.198', 'Spitz', 'Dnz', 'chnegg', 'platz', 'aris', 'Mnsingeir', 'Rsigthurm', 'Swaflantzgasse.27', 'Scllauch', 'Tngistrae', 'Rieder-Psistern', 'Golaten', 'Berne.7t', 'Schegkenbrunnengraben', 'Grnenbergs', 'Chorherrentreppe', 'Streckithurni', 'Bubenbergsthrli', 'Iserten', 'Aarstrae', 'Frick', 'schweiz', 'Tscharner', 'Trb', 'Heiliggeistspital', 'Fahaus', 'Noll', 'Babsburg', 'Nydeckbrcken', 'wurstemberger', 'Ztalia', 'Turtivril', '- feld', 'Thrme', 'Waisenhausstrae', 'Lutz', 'Uechtland', 'Genoveva', 'Beutels', '5peichergasse', 'Nydcck', 'Iohannsen', 'Aargau', '^ deckkirche', 'Golatcnmattqasse', 'Tabor', 'Schiitzeubruunen', 'Iustinger', '- saucon', 'Ranton', 'chtzenbrunnen', 'Aberli', 'Atritgasse', 'Stich', 'Marzilitbor', 'Kleinkram', 'Kirchgasse.22', 'Aargauer-Stalden', 'Mind', 'Romarkt.22', 'Holligcn', 'Arhenbhl', 'Brengraben gasse', 'Karls', 'Streckithurin.16', 'Grnenberg', 'Oudentbor', '- valleriekaserne', 'Altors', 'Etraburg', 'Matte', 'Cuchlaube', 'Entengraben.213', 'Iudenkirchhof', 'Signmnd', 'Krcuzgasse.12', 'Rmligen', 'Berit', 'Altenberghhe', 'Lainb', 'Badergraben', 'llgenegg', 'genbach', 'Hunkerilgasse', 'Neueilgasse', 'Mnsters', 'Lsirschengraben', 'Msliu', 'Dttwyl', 'Gardelle', 'Kilchgasse', 'Laupenstrae', 'Neiners', '- inach', 'Aarberg', 'Greisenasvl', 'Ttalden', 'Marktkreuz', 'ra', 'Brengraben', 'Iudenthor', 'Dietrich', '- Gerberngraben', 'Mibuw', 'alzmagazingasse', 'Bleuengasse', 'Milden', 'Echauplatzgasse', 'Vchdeck', '- platz', 'Ili', 'westphalen', 'Kram', 'Helvetiaplatz', 'Taubenstrae', 'Knig', 'Bluttburin', 'Nrnberg', 'Nwenburg', 'Bratlingen', 'Erker', 'Massino', 'thenbach', 'Btadtbach', 'Sulgenbach.230', 'Sommerleist', 'Uchtland', 'Werkhof', 'Fichot', 'Halligen', 'Lhristoffelgasse', 'Line Querstrae', 'Michelisthnrli', '-', 'Aauw', 'Sterr', 'Trst', 'Awiebelmarkt', 'Polizeigasse', 'Bavoven', 'Ouergchen', 'Dbergerbcrn', 'Ivilh', 'Ungarn', 'Loin', 'tvendschatzgasse', 'Falken.44', 'Lothringen', 'Bannover', 'Gerbernqraben', 'Mnz', 'Straburg', 'Dittlingerthurm', 'Tedlingen', 'Zaeringen', 'Imhoof', 'Tgle', 'Etalden', 'wartzenburg', 'Fehr', 'Thiergraben', 'Stetibrnnuen', 'Preuen', 'Rhdeckbrcke', 'Bundeshaus-Ostbau', 'Voruz', 'Kauw', 'Enge', 'St.', 'Bmpliz', 'chauplatzgasse', 'Dalp', 'Merian', 'Sophog', 'Blonaz', 'kvendschatzgasse', 'Knizbergwald', 'Relergasse', 'Neggisberg', 'Monrexos', 'Sprngli', 'Zhringen', 'Tistelzwv', 'Aterktgasse', 'Osten', '- mannsgasse', 'Lory', 'Stadlcr', 'Kornbaus.47', 'Engikapelle', 'Diebold', 'Nannazhalde', 'Nabbenthalgutes', '- pltzli', 'Eolothurn', 'Lompostella', 'Schweinmarkt', 'mursbul', 'Stuttgart', 'Mnsingen', 'brg', 'Gassennamen', 'Kerrengasse', 'Hasxelgasse', 'Balustres', 'Kanw', 'Greg', 'Werner', 'Lrz', 'Dal', 'Kwenthal', 'pfeifferbrunuen', 'Ringstrae', 'Lourad', 'Bieder', 'Sau', 'Holzikosen', 'Uolligenstrae', 'Mind.173', 'Zeughausplatz', 'Stettmhlen.14', 'Aelergasse', 'Staufferhaus.I', '- rain', 'Scb.68', 'Zrichs', 'Bundesgasso', 'Mosesbrunncn.136', 'Ulontsaucon', '- bach', 'Stumpfs', 'Unteres Marzilithor', 'Weidet', 'Berrengasse', '5tadt', 'Rrain', 'Thristoffelthurm.17', 'Jrich', 'Br', 'Solotburn', 'Harzthurm', 'Lude', 'Thunstrae', 'Berchtolds', 'Herrengassc', 'Dich', 'virschengraben', 'Nydeckhos.113', 'Weinberg', 'Brn', 'Beunden', 'Aarau', 'Luisenstrae', 'Bubenbergsthrli.13', '- gasse', 'Granit', 'Divis', 'Murtenth', 'Bernsu', 'Brwenhaus.39', 'Zrich', 'Josingen', 'Brugg', 'Brenstadt', 'Nuchsee', 'Jhringen', 'ahrbrcke', 'ulgeneckstrae', 'Bernuin', 'Gosphenhbeli', 'Wattenwyl', 'Bissen', 'Leon', '- mann', 'Bolz', 'Brgglerbrunnen.117', 'Ivaisenhaus', 'Golatenmattga', 'Neuenburg-Lchanzs', 'Bauptgasse', 'Dnnz', 'Eidg', 'Uauw lbrecht', 'Bmplitz', 'Aornhausbrcke', 'Ehrifloffelthurm', 'Hamming', 'Kramgasse.22', 'Nordei', 'Meyenburg', 'Todtentanzgasse', 'Schegkenbrunnengrabeu.28', 'Hchegkenbrunnengraben', 'Albrecht', 'Bormattsgasse', 'Llfenau.240', 'Schauplatzgasse', 'Blumenberg', 'Sigm', 'Gberspitalthnrm', 'Born', 'Trnke', 'Grrpbenbbeli', 'Hrienisberg', 'Dachselhoser', 'Ich-burg', 'Mechthild', 'Schlo', 'Bydeckbrcke', '^- chanzenstrae', 'Blankenburg', 'Weienstein', 'Berne', 'Bad', 'Padua', 'Ehgrben', 'Ahringen', 'Mlinen', 'Uasino', 'Gruber', 'Bberthor', 'Trmelhaus', 'Schwefelthurm', 'Gffingerstrae', 'Rougemont', 'Mhlcbaches', 'Schilling', '- thurmes', 'Morblausen', 'Kirchen', 'Kattingerhaus', 'lllerian', 'Bernum', 'Nydecktreppe', 'Lombachtburm', 'Nidau', 'Schanzli', 'Agels', 'Frankfurt rs2p', 'Grnegg', 'Rwenthal', 'Wittikofen', 'Tngewald', 'Ouria', 'Nydeckbriickcn.108', '- qasse', 'Brgg.38', 'Ligerz', 'Interlakcnhaus', 'Urban', 'Rvdeckgasse', 'Echtzenhaus', 'Bavoyen', 'Falken', 'Unteres Mar', 'Miinzrain', 'Kebien', 'Keuenstadt', 'Salzhaus', 'Langhaus', 'Mey', 'Nleyenburg', 'Sickiuger', 'Ralk', 'Brcke', 'St. Gallen', 'Waiseichausstrae', 'Marzili.10411', 'Brenzug', 'Thring', 'Buche', 'Murtenthor'}",553,"{'Rathhauses', 'Röniz', 'Bartl', 'Iago', 'Nr Mattenenge', 'Schinkengasse', '- brg', 'Strler', 'Äaldens', 'Lhristoffelthunn', 'Rvdeckkirche', 'Hohle Gasse', 'Gerbergesellschast', 'Jenner', 'EgertenGasse', 'Antonierhaus', 'Fr', 'Lilie', 'Ltschenbach', 'Brügg', 'Thorbogens', 'Tachnaglergraben', 'Wendschatzgasse', 'Nr Hirschengraben', 'Rehsues', 'Orlev', 'Störcklin Basel', 'adtbach', 'St. vincenzen', 'Münsters Münsterplatz', 'Anno', 'Breissach', 'Tschisteli', 'Jähringen', 'Aäfigthurm', 'Thüring', 'Lorrainestrae', 'Weißenbühl', 'Äraßenstnck', 'Lentulus', 'Laubeckstraße', 'Schöps', 'Bchohalde', 'Wald', 'Engistraße', 'Heide', 'Tngistraße', 'Bpdeckbrcke', 'Klosterli', 'Das Tommerrienhaus', 'Mnster', 'Falkengasse.20', 'Inneres', 'Hauptstraße', 'Engixromenade', 'Lchafsners', 'Bern.6', 'Nzdeckbriicken', 'Viehmarkt', 'Linden', 'Mnzrain', 'Grlach', 'Stalden.21', 'Läuserplah', 'R89', 'Margherita', 'Münsterplatz', 'Thurm Banse', 'Lsaus', 'Kelergasse', 'Brenqraben', 'Judengasse', 'Donnerbühl', 'Lrlacherhofes', 'Schanzen.10', 'weien Areuz', 'Rüwenthal', 'Aäfigthurnr Bern', 'Schultheiß', 'Alpeuxauorama Bern', 'Udel', '^', 'Burghof', 'Meienbhh', 'Aeughausgasse', 'Aaths', 'Wattenwzl', 'Dalmazi.198', 'IVärterhaus', '2lare', 'chnegg', 'Mnsingeir', 'Bärenhösli', 'Allüsli Bad', 'Räthe', 'Wirthshaus', 'Bubenbergsthrli', 'Echützenhaus', 'Fraubrunnen', 'Münsters', 'Frick', 'Tscharner', 'Tschisfelibesitzg Hinteres Haus', 'Brunngaßhalde', 'Kleine Bär', 'Acbischlößli Altenberg', 'Heiliggeistspital', 'wurstemberger', 'Ztalia', 'Rcünsterthurines', 'BernerLhronik', 'Rlapperläubli', 'Genoveva', '5peichergasse', 'Akosesbrunnen', 'Iohannsen', '^ deckkirche', 'Hüttengraben', 'Iustinger', '- saucon', 'Berner Kunstmusemu', 'Bern Uchtland', 'Atritgasse', 'Graden Streckithurni Oberes Marzilithor Weinberg', 'Kirchgasse.22', 'Aargauer-Stalden', 'Romarkt.22', 'Arhenbhl', 'Brengraben gasse', 'Nr Miinzrain', 'Signmnd', 'Rmligen', 'Berit', 'Bohliebischanzs', 'genbach', 'Deutschordenshaus', 'Historische Museum', 'Der olländerlbur', 'Bym Bütsche', 'Krne', 'Aarberg', 'Greisenasvl', 'Brengraben', 'Iudenthor', 'Luisenstraße', 'Mibuw', 'Kathhaus', 'Bleuengasse', 'IuraÄmplon', 'Kram', 'Hotel lLnropo', 'Taubenstrae', 'Knig', 'Bluttburin', 'Ankenmärit', 'Bratlingen', 'thenbach', 'Weißenheim', 'Line Querstrae', '-', 'Aauw', 'Polizeigasse', 'Ouergchen', 'Villa Margherita', 'Deutschen Orden', 'Bath Haus', 'Dbergerbcrn', 'Ivilh', 'Theaterplatz', 'Noll Nöthiger Nydcck', 'Der Bach', 'Sarergut Altenberg', 'Straburg', 'Tedlingen', 'Zaeringen', 'Ober', 'Käfigthurms', 'Stetibrnnuen', 'Preuen', 'Rhdeckbrcke', 'Schönenberg', 'Akai N05', 'Buurema', 'Neggisberg', 'Aarbergerthor Bärengraben', 'Osten', 'Stadlcr', 'Zes MMstwißwM Iuli,894', 'Nannazhalde', '- pltzli', 'Endlisberg', 'Stuttgart', 'Aäfigthurin', 'brg', 'Salem Links', 'Hasxelgasse', 'Alt5chult', 'Münsterthurm', '6ntg Oom', 'Haspelgasse', 'Aornhausbrücke', 'Zeughausplatz', '- rain', 'Hayade', 'Zeittzlockenthurm', 'Stumpfs', 'Weidet', 'Lhorhauses', 'Etraßburg', 'Grauholz', 'Solotburn', 'Utzigen', 'Lude', 'Nheins', 'Herrengassc', 'Dich', 'Nydeckhos.113', 'Bümpliz', 'Zeugwarts', 'Bubenbergsthrli.13', 'Granit', 'Divis', 'Uchttenbach', 'Zrich', 'Bernerhose', 'Dioureposgutes', 'Barnischthurm', 'Haus Glur', 'I7HI8', 'Arattingerhaus', 'Aeßlergasse', 'Brgglerbrunnen.117', 'Binscheid', 'Rälberslotte', 'Btreckithurm', 'Golatenmattga', 'Bauptgasse', 'Bmplitz', 'Aornhausbrcke', 'Ehrifloffelthurm', 'Hamming', 'Meyenburg', 'Lenti Sack', 'Don 141b', 'Albrecht', 'Bormattsgasse', 'Mattenenge Haus', 'Sigm', 'Gberspitalthnrm', 'Haoade', 'Hrienisberg', 'Meyenburg Kleiner Bär', 'Dachselhoser', 'Iran', 'Bern Berns', 'Katbhaus', 's2äö', 'Mlinen', 'Bberthor', 'Dom Denner', '- thurmes', 'Ulmer Münsters', 'Morblausen', 'Bernum', 'Kattingerhaus', 'Lombachtburm', 'Schanzli', 'Rcünsterthurmes', 'Nr Marktgasse', 'Lohr', 'Urban', 'Schweselthurin', 'Echtzenhaus', 'WlilÜ Weinbergen', 'Thunstraße', 'Osterrieths', 'K98', 'Zürichs', 'Höheweg', '5traßburg', 'Brcke', 'St. Gallen', 'Brenzug', 'Murtenthor', 'Der Münsterthurm', 'Bümplitz', 'Auttelthurm', 'Interlaken', 'Lngistrae', 'Äalden', '5traburg', 'Aargauerstalden', 'Anshelm', 'Anizbergwald', 'Eogar', 'Erlacherhoss', 'Gelsarb', 'Bldenburger', 'Nwenthal', '^ chauplatzgasse', 'R49', 'chweinsberg', 'Hollnderthurm', 'Egerten-Gasse', 'Walds, SLOC', 'Klösterli', 'Rirchhoss', 'Gbstberg.102', 'Johannserhaus', 'Gberthor', '- thor', 'Links', 'eedors', 'Marzilistrae', 'Großen Rathes', 'Rathhausterrasse', 'Nürnberg', 'Allmend', 'Salzmagazin', 'Michelis', 'Monbijou', 'Merkbos', 'Bärenhöfli', 'Stalden.12', 'Gallen', 'Ewaflantzgasse', 'Neuenstadt.16', 'Etrecki', 'Narktuasse', 'tadt Lehen', 'Plan', 'Beundenfeld Erbaut', 'Rauw', 'Gsterrieth', 'Rvdeek', 'Mißbuw', 'Weißenstein', 'Ost', 'Tidche Lggimann', 'Aarebrcke', 'chinkengasse', 'Graffenried', 'Rlarzili', 'Nr Gerechtigkeitsgasse', 'Leutkirche33 Lizi Loinbachthurm', 'Zähringen', 'Taubenstraße', '5ulgenbach', 'Alte Däuser', 'Tramwavgesellschast', 'Sardelle', 'Erlacherhof', 'Rathhaus', 'Amdlisresserbrunneu', 'Kor', 'Amtkausgasse', 'Dominikaner', 'Gberspital', 'Keßlergasse', 'Schlößlistraße', 'Loinbachthurm', 'Arrnäluttg', 'Meyer', 'Gasier', 'Bärn', 'Dnz', 'Rieder-Psistern', 'Ehors', 'Schegkenbrunnengraben', 'Grnenbergs', 'Toubhüsli', 'Trb', 'Thristosselthurm', 'Noll', 'Kupferhammer', 'Straßei', 'Turtivril', 'Hanz', 'Rlarcellus', 'Äügenbach', 'Lutz', 'Uechtland', 'Nydcck', 'Eprüngli', 'Breitenrain', 'Marzilitbor', 'Thierspital', 'Eommercienhaus', 'Kleinkram', 'Äadt', 'Rreuzes', 'Mind', 'Echandpsahle', 'Gstermundigen', 'Streckithurin.16', 'Alapperläubli', 'Grnenberg', 'Oudentbor', 'Heiliggeist', 'Schweinestäüe', 'Entengraben.213', 'Iudenkirchhof', 'Krcuzgasse.12', 'Könizstraße', 'Altenberghhe', 'llgenegg', 'Haus Nr', 'ötadt Bern', 'Dttwyl', 'Kilchgasse', 'Laupenstrae', '- inach', 'Ritters Tonrad', 'Trianon', 'Nr 2tz', 'Hausen', 'Mohnenden', 'Marktkreuz', '- Gerberngraben', 'alzmagazingasse', '- platz', 'Marsilien', 'Hofstatt', 'Tremouille', 'Grvphenhübeliweg', 'Aiegelhütte', 'Massino', 'Erker', 'Btadtbach', 'Räsigthurm', 'Werkhof', 'Fichot', 'Dietrichshaus', 'Waiseichausstraße', 'Sterr', 'Lenbrunnens', 'Salzmagazin Dahinter', 'Ungarn', 'Uolligenstraße', 'Sardelle Gassennamen', 'Velin', 'Nagelisheim', 'Imhoof', 'Tgle', 'Etalden', 'Stadtthore Line Querstraße', 'Fehr', 'Haus der Speichergasse', 'Ankenwaage', 'Kauw', 'Matte Inseli Muristalden', 'Dalp', 'Blonaz', 'kvendschatzgasse', 'Garten Weinberg', 'Monrexos', 'Zhringen', 'Thoren', 'Tistelzwv', 'Christ wiilading OAerfter pulverthurm der Aare', 'Nr Gerbhaus Nr Tchon', '- mannsgasse', 'Engikapelle', 'Monreposgutcs', 'Museum Helvetiaplatz', 'Nabbenthalgutes', 'Ttufaug', 'Alten Bern', 'Aeußeres', 'Eolothurn', 'Balustres', 'Lhorherrentreppe', 'Greg', 'Werner', 'Dal', 'Ringstrae', 'Lourad', 'Kirch', 'Sau', 'Uauw', 'Haus Nr Aramgasse', 'Tommerrienhaus', 'Theater Thiergraben Thürme Thurm weißer Tillierthurm', 'Bundeshäuser Ost', 'Zwingelhos', 'Bundesgasso', 'OKKHWW Bern', 'Ulontsaucon', '- bach', 'Unteres Marzilithor', 'Berrengasse', '5tadt', 'Jrich', 'Br', 'Bubenbergsthürli', 'Harzthurm', 'Thunstrae', 'St Johannscrhaus', 'Bundesrathhausterrasse', 'Brn', 'Grrpbenbübeli', 'Zalt BuureWirtzhuns', 'Luisenstrae', 'Äettbrunnens', 'Epeisewirthschastsrecht', 'Brwenhaus.39', 'Münzrain', 'Brugg', 'Etiftschaffners', 'Am Ltadtbach', 'Schlosses Wolligen', '5chütte', 'Nxdeckkirche', 'Brenstadt', 'Bernuin', 'Leon', 'Bolz', 'Weiler Gptingen', 'Thristoffel', 'Ivaisenhaus', 'Sxitalkttche', 'Neuenburg-Lchanzs', 'Nordwesten Lude', 'Eidg', 'Uauw lbrecht', 'Lngistraße', 'Niederlanden', 'Bibliothek Hütte', 'Lhristoffelthurm', 'Golatenmattgassenthurnr', 'Schweselthurm', 'Der Brunnen', 'Münsterthurms', 'Ravalleriekaseme', 'Born', 'Weienstein', 'Thores', 'I3tzO', 'Berne', 'Ehgrben', 'Airche', 'Reichsburg Vchdeck', 'Trmelhaus', 'Historisches Museum', 'Mhlcbaches', 'Tlbeille', 'Schilling', 'Kirchen', 'Nydecktreppe', 'Nidau', 'Bundesrathhauses', 'Agels', 'Rwenthal', 'Rurve', 'Tngewald', 'Interlakcnhaus', 'Rvdeckgasse', 'Münz', 'Iohannserhaus', 'Kaus Bern', 'Vivenel', 'Salzhaus', 'Alurtenthor', 'Burgerspitals', 'Lrlacherhofe', 'Langhaus', 'Mey', 'Namseverloch', 'Das Isen', 'Ralk', 'Blatt Süd', 'Marzili.10411', 'Thring', 'Buche', 'Studersche', 'Vorblen', 'Unteres Mar Bärengraben', 'Michelisthrli', 'Haspelmatte', 'Den Lombachthurm', 'Oberes', 'Miinsterplatz', 'Markt', '- tingen', 'Staldons', 'Nvin', 'Mnchen', 'Zieglerischen Prospektensammlung', 'Reitschulhofe', 'Iakobsspital', 'Weihergasse', 'Schnyder', 'Kantonsschul', 'AelbiLhntteZyt', 'Gracht Line', 'Ksmarkt', 'Lnrsche', 'Kehrhüsi', 'Tillier', 'Nüeggisberg', 'Hrienisbergerhaus', 'Brgg', 'Kurze Gasse', 'ZParis', 'Wattenwvl', 'Hsrrengasse', 'Waisenhausstraße', 'Ireiburg', 'Savoyen Lothringen', 'Bormegasse', 'Gerberngrabens', 'Nr Bärenplatz Bärengraben', 'Grvphenhbeliweg', 'Schauplatzgasie', 'IBiedermann', 'Pallisaden', 'Thurm', 'Bpdeckbrücke', 'Reitschulhof.100', 'Brenhsli', 'Wattenwzl 1702', 'Nvffli', 'IBeirrberg', 'Zeringen', 'taloZus', 'Oranienburg.82', 'Sd', 'Mnster.131', 'Iohanneskirche', 'Trommauer', 'Tiirst', 'Der Stalden', 'Lenzburg', 'R', 'Rainse', 'Berna', 'Rydeckbrcke', 'R93', 'Klösterliwirthshauses', 'Thurmes', 'Rud', 'Lombachs', 'Osterrieth', 'Brenxlatz', 'Balligen', 'Mitivari', 'Httengraben', 'tzudengasse', 'Mutach', 'Kornhaus', 'Lonrad.80', 'Das Ober', 'Aebischlli', 'Aornhausplatz', 'Reuenfladt', 'wislisburg', 'Bartl.31', 'Aarburg', 'Aeitglockenthurme', 'tzreiburg', 'Als Korn', 'Bundesratbbaus', 'Lkristoffelthurnr', 'Muleren', 'Morlotlublein.115', 'andrain', 'Baspelgäßli', 'Oorps', 'München', 'platz', 'Brod', 'Beinzmann', 'Golaten', 'Aargauerstaldens', 'Chorherrentreppe', 'Lpitalkirche', 'Aasinogarten', 'Airchenfeld', 'WWrX Christoffeltburm', 'Babsburg', '- feld', 'Waisenhausstrae', 'Thurmes Mohnenden', 'Aargau', 'Eommerlaube', 'Inselisteg', 'Golatcnmattqasse', 'Schiitzeubruunen', 'Eüden', 'Ranton', 'Luntenthurm', 'Hossratt', 'Stich', 'Aarenthurin', 'Ziegler', 'Holligcn', 'Karls', 'Den Stadtgraben', 'Bathsmanuals', 'Epitalkirche', 'Altors', 'Münsterthurmes', 'Cuchlaube', 'Patrontasche', 'Äadtbach', 'Lainb', 'Mosesbrunnen', 'Badergraben', 'Manches', 'Neueilgasse', 'Könizbergwald', 'Neiners', 'Lrlachdenkmal', 'Ichburg', 'Münsterbauhütte', 'Echauplatzgasse', 'Frienisbergerhaus', 'Vchdeck', 'westphalen', 'Münzthor', 'Helvetiaplatz', 'Gryphenhübeli', 'Aarstraße', 'Nrnberg', 'Lngi', 'Nwenburg', 'Sulgenbach.230', 'Sommerleist', 'Halligen', 'Lhristoffelgasse', 'Räth', 'Awiebelmarkt', 'Aönizbergwald', 'Frontispicii', 'Loin', 'Nleyenburg Neuenburg', 'Gffingerstraße', 'Bannover', 'Münsingen', 'Gerbernqraben', 'Speichergasse Waisenhausstraße', 'Alünsterthurmes Blatt Ost', 'Bcrgaugeuheit', 'Bernhardsbrunnen', 'wartzenburg', 'Thiergraben', 'H  pothekarkasse', 'Knizbergwald', 'Relergasse', 'Mittellöwen', 'Kornbaus.47', 'Nsdeckkirche', 'Awiebelngüßchen', 'Schweinmarkt', 'Gassennamen', 'Kanw', 'Mattenenge', 'Iuker', 'Predigerkirche', 'jDIane', 'Bieder', 'Schänzli', 'Aobischlößli', 'Mind.173', 'Ostindien Schloß Uolligen  8ö7 228 Bern', 'Lchweiz', 'Käsigthurm', 'Stettmhlen.14', 'Aelergasse', 'Staufferhaus.I', 'Zrichs', 'Schneebeli', 'apiermühlestraße', 'Aebischlößli', 'Ghor', 'Ramseyerloch', 'Rrain', 'Aäsmarkt', 'Frienisbergerhause', 'Bröwenhause', 'Berchtolds', 'Gosphenhübeli', 'Weinberg', 'lWO', 'Aarau', 'Thorthurm', 'Lsöhe', 'Eonne', 'Josingen', 'Monbijougutes', 'Grasfenried', 'Frienisbergerhauses', 'Köniz', 'OrnuämnOonneui', 'ahrbrcke', 'ulgeneckstrae', 'Rlösterli', 'Wattenwyl', 'Bissen', 'Dählhölzli', '- mann', 'Schiitzeumatte', 'Altes historisches Museum', 'Großrathssaal', 'Hotel Fetzer', 'Münster', 'Spitalgasse Melbild', 'Rathhause', 'Brügg Hchon', 'Gerecktigkeitsbrunneu', 'Kramgasse.22', 'Nordei', 'Todtentanzgasse', 'Mkei', 'tadt', 'Gilgen Lilie', 'Rodt Architekt Serien', 'Llfenau.240', 'Thor Altenberg', 'Blumenberg', 'Nvdeckkirche', 'Haxade', 'Trnke', 'Rönig', 'Rvdeckgasse Interlaken', 'Grrpbenbbeli', 'Nsdeck', 'Falkenxlätzli', 'Schlo', 'Scheuer Speicher', 'Gruber', 'Gffingerstrae', 'LWB', 'Lsrns', 'Bierhübeli', 'Hotels Bellevue', 'Augustiner Thorherren', 'lllerian', 'waaghaus', 'Bühlstratze', 'Münsterthurmes Blatt West', 'Schindelthurni', 'Frankfurt rs2p', 'Dietrichs Haus', 'Rathes', 'Wasserwerkstraße', 'Wittikofen', 'Bundesrathhause', 'Nydeckhofes', 'Bavoyen', 'Aeitglockenthurm', 'Münsterbau', 'Äadtbachs', 'Lhristosselthurin', 'Aamseyerloch', 'Nsdeckgaffe', 'Wolf', '^-', 'Brodschaalen.21', 'Gesellschaftshaus Museum', 'Turngraben', 'Blatternhaus.80', 'Rrauch', 'Metzgern', 'Knizstrae', 'waisenhausstraße', 'Rlsterli', 'Tchon', 'Tachnaglcrgrabc', 'Iwingelhof', 'Muristrae', 'Dalmazi', '2lugsburg', 'Sandfluh', 'AN Dorn Gerberngraben', 'Rth', 'Äadtrath', 'Lopoßraiiliisjns', 'Waschhaus Holz', 'Elendenherberge.50', 'Kabsburg', 'Herzogenbuchsee', 'Hinan', 'Gorge Line', 'Freiburgstrae', 'Rodt', 'Oberes lllarzilithor', 'Nr Keßlergasse Niedermetzgern', 'Gelin', 'Austaus', 'avoyen', 'Mller', 'Strcklin', 'Aonüo', 'Nydeckbrücke', 'Antonierkapelle', 'Lehrgotte Nr der Brunngasse', 'Kiellaslis', 'Derselbe', 'Lhorhause', 'Zeughaushof Todtenacker Zeughausgasse Ovrj tlnrüs Zeughausplatz Schweinmarkt Golatenmatt', 'Grünenbergs', 'Eden', 'Ltadtbach', 'Zürich', 'Bäthe', 'Wattenwrl', 'Stumpf', 'Lorrainestraße', 'Ringstraße', 'Nodt', 'Hriedhose', 'Tchattseite', 'Metzgcrgasse.24', 'Frankfurt Bern', 'Leutkirche.33', 'Marmortafel', 'Thorthurme', 'Tellrodel', 'Herrliberger', 'charnachthal', 'Polländerthurm', 'Blatt sxSK', 'Muristraße', 'Mirani', 'Rob', '- strae', 'Gerberngraben', 'Küpser', 'Fallbrücke', 'Trämelhaus', 'Lsabsburg', 'Karls VIII von Frankreich', 'Effinger von Aarburg', 'Dublonen', 'Bärengraben', 'NeuenburgLchanzs', 'Mußhasen', 'MarNli', 'Spital', 'Nvdeckkirche.36', 'Iudengasse', 'Laubeckstrae, ', 'Zeitglockenthurm', 'Gäßchens', 'Nxdeck', 'Kohlerthurni.171', 'Rainseherloch', 'Bathhauses Graben', 'Riiwenthal', 'Lhristosfelthurms', 'Spitz', 'Aieiiisberghaus', 'Gurtens', 'aris', 'Käfigthurm', 'Rsigthurm', 'Hintere Stöck', 'Swaflantzgasse.27', 'Scllauch', 'Tngistrae', 'Aargauerftaldens', 'Etadttheil', 'Berne.7t', 'Trachselwald', 'Streckithurni', 'Iserten', 'St Johannser', 'Aarstrae', 'schweiz', 'Blichelisthürli', 'Aare Bern', 'Fahaus', 'Nydeckbrcken', 'Thrme', 'Beutels', 'Tabor', 'Dalinazi', 'chtzenbrunnen', 'Aberli', 'I8b3', 'Brodschaal', 'Etadt Bern', 'Alorlotläubleins', 'Dalp Bern', '- valleriekaserne', 'Etraburg', 'Matte', 'Leutkirche', 'Ilvrnmnni', 'Lergangenheit', 'Awiebelgäßcheii', 'UMM', 'Hunkerilgasse', 'Dundeshäuscr', 'Mnsters', 'Lsirschengraben', 'Danske', 'Freiburgstraße', 'Bandelsmanns', 'Msliu', 'Gardelle', 'Albrecht ', 'Haus Itt', 'Ranton Bern', 'Schloß Holligcn', 'Mittellande', 'Ttalden', 'ra', 'Bathhauses', 'Dietrich', 'Assen', 'Milden', 'Rodt von  87Z 878', 'Bern Lourad Tiirst', 'Nr Zeughaus', 'Bestimmuna', 'Ili', 'Diesbachhaus', 'Erker Thurme', 'Uchtland', 'Tschisseli', 'Aeußeres Golatenmattgaßthor', 'Michelisthnrli', 'Hricktreppe', 'Trst', 'Bavoven', 'tvendschatzgasse', 'Falken.44', 'Madt Bande', 'Tchwesel', 'Gundelfingen Harnischthurm', 'Lothringen', 'Marzilistraße', 'Tschiffelithurm von Dunker', 'Kuinss Paris', 'Fm', 'NIeiner', 'Der Volksmund', 'Mnz', 'Dittlingerthurm', 'Schoßhalde', 'Bundeshaus-Ostbau', 'Voruz', 'Enge', 'St.', 'Bmpliz', 'chauplatzgasse', 'Merian', 'Sophog', 'Sprngli', 'Aterktgasse', 'Lory', 'Diebold', 'IHZ', 'Heiliggeistkirche', 'Kirchenseldes', 'Äadttheile', 'Lompostella', 'Komthur', 'mursbul', 'Mnsingen', 'Kerrengasse', 'Nsdeckb', 'Bergangenheit', 'Aienisbergerhaus', 'Rlünsterthurmes Blatt Nord', 'Lrz', 'Kwenthal', 'pfeifferbrunuen', 'Lause', 'Llendenherberge', 'Holzikosen', 'Uolligenstrae', 'Giebelselde', 'Tiefe', 'Scb.68', 'Thürmchen', 'Mosesbrunncn.136', 'Laupenstraße', 'Thristoffelthurm.17', 'Amsoldingen', 'virschengraben', 'Niggeler Schanzengraben', 'Beunden', 'Der Lärenxlatz', 'Vurgdorsjtraße', 'Äraß', 'Erker Eckhause', '- gasse', 'Murtenth', 'Anshelm ÄtaloZus', 'Bernsu', 'Waisenhansplag', 'Korn Haus', 'Aähringen', 'Bondeli', 'heiliggeist', 'Nuchsee', 'Jhringen', 'Aornhauses', 'Arone', 'Gosphenhbeli', 'Spitalmatte', 'Ieitglockenthurms', 'Dnnz', 'Marzilithors', 'Ariegsrathes', 'Straßburg', 'Schegkenbrunnengrabeu.28', 'Hchegkenbrunnengraben', 'Käsigthurms', 'Schauplatzgasse', 'Dcrgaiigeirheit', 'Botel Bellevue', 'Äaatskanzlei', 'Ich-burg', 'Küwenthal', 'Mechthild', 'Meißenbühh', 'Bydeckbrcke', '^- chanzenstrae', 'Blankenburg', 'Bowex', 'Iinkenhubel', 'Bad', 'Padua', 'Museum Bern', 'Herkulessaale', 'mn8Üpi6', 'Ostermundigen', 'Ahringen', 'Brenner', 'Boizot', 'Uaspelweg', 'Uasino', 'Atäritgasse', 'Schwefelthurm', 'Rougemont', 'Bauptstraße', 'Gesellsckaftsbaus Museum', 'wabernstraße', 'Münster Bern', 'Eckhaus', 'BerHangenheit', 'Grnegg', 'Bondelihaus', 'Aarebrücke', 'Zcughaushoses', 'Ouria', 'Nydeckbriickcn.108', '- qasse', 'Brgg.38', 'Ligerz', 'Falken', 'Schützenmatte', 'Unteres Mar', 'Miinzrain', 'Kebien', 'Keuenstadt', 'Interlakenhauses', 'Bath', 'Nydeckhof', 'Bubenhand', 'Richterstuhl', 'Nleyenburg', 'Rlünzthor', 'Sickiuger', '6orpu8 äelieti sog Trlach', 'Waiseichausstrae'}",1170
21460097,238344,"{'Krauchthal', 'Rapperswil', 'Augsburg', 'Murten', 'Brugg', 'Kyburg', 'Frankfurt', 'Leheu', 'Aarburg', 'Aargaus', 'Zofingen', 'Pruntrut', 'Freiburg', 'Dijon', 'Marzili', 'Broye', 'Europa', 'Meran', 'Bacharach', 'Lauffenburg', 'Cypern', 'Schott', 'Godesberg', 'Lyon', 'Salins', 'Schweinsberg', 'Lipding', 'Frankreichs', 'Sardinien', 'Lothringen', 'Landshut', 'Schwanden', 'Diesbach', 'Hallwyl', 'Oberhofen', 'Lausanne', 'Frutigen', 'Kempten', 'Neueneck', 'Herrengasse', 'Schweiz', 'Grimsel', 'Compostella', 'Waadt', 'Altdorf', 'Italien', 'Trachselwald', 'Rom', 'Greifensee', 'Paris', 'Simmental', 'schweiz', 'Baden', 'Winterthur', 'Kandersteg', 'Diessenberg', 'Heidelberg', 'Laupen', 'Scharnachthal', 'Bubenberg', 'Vincenzen', 'Kreuzgasse', 'Konstanz', 'Erlach', 'Krakau', 'Zurzach', 'Mailand', 'Buchsee', 'Bernern', 'Burgund', 'Oranien', 'Bern', 'Neuenstadt', 'Wettingen', 'Wangen', 'Diesbachs', 'England', 'Aargau', 'Ulm', 'Cahors', 'Eschenbach', 'Riggisberg', 'Romont', 'Junkerngasse', 'Bernbiet', 'Jerusalem', 'Barcelona', 'Freiburgs', 'Schottland', 'Frienisberg', 'Wartenfels', 'Adelboden', 'Wichtrach', 'Pisa', 'Savoyen', 'Pavia', 'Worms', 'Brunngasse', 'Luzern', 'Bipp', 'Oltigen', 'Oberland', 'Solothurn', 'Burgdorf', 'Monte Rosa', 'Venedig', 'Locarno', 'Griechenland', 'Frankreich', 'Murlen', 'Gotthard', 'Hochberg', 'Genf', 'London', 'Bres', 'Schil', 'Landeron', 'Nancy', 'Kirchgasse', 'Egypten', 'Harz', 'Wabern', 'Nidau', 'Bremgarten', 'Liebenau', 'Hungarn', 'Habsburg', 'Auenstein', 'Rinach', 'Dornach', 'Spanien', 'Leutkirch', 'Portugal', 'Ligerz', 'Lenzburg', 'Postgasse', 'Zollikofen', 'Besan', 'Rottweil', 'Bologna', 'Aarberg', 'Eptingen', 'Europas', 'Regensburg', 'Spiez', 'Brienz', 'Montpellier', 'Thun', 'Como', 'Wangen Aare', 'Grindelwald', 'Deutschland', 'Bleienbach', 'Hasli', 'Greyerz', 'Rhein', 'Ravensburg', 'Basel', 'Wildenstein', 'Moudon', 'Avignon', 'Wynigen', 'Golattenmatt', 'Metz', 'Kramgasse', 'Aarau', 'Wimmis', 'Ostindien', 'Domodossola'}",169,"{'Fallbrücke', 'Köln Rhein', 'Twann', 'Bömwald', 'Haus Haus', 'Meßmer Siechenhaus', 'Stein Rhein', 'Bern Zoll', 'Dominikus', 'Walstatt', 'Val Gressoney', 'Köniz', 'Andlau Elsaß', 'Meiringen', 'Zoll', 'Köln', 'Schloß Godesberg', 'Lyonermesse', 'Mülenen', 'Twingherrenrecht', 'Lahr', 'Graubünden', 'Wohlen', 'Bern III Blatt XVI', 'Münster', 'München', 'Eine Bremgarten', 'Österreich', 'Hofstetten', 'Diesbach Capellen', 'Monte Cassino', 'Schloß Thun', 'Oberlandes', 'Barfüßerkirche', 'Hilterfingen', 'Bern Thun', 'Fränklis', 'Torrent', 'Lllhclflüh', 'Straßburg', 'Mecheln', 'Bubenberg Erlach', 'Bümpliz Mühleberg', 'Scharnachthals', 'Eriz', 'Bern VII', 'Münchenbuchsee Blumenstein', 'Distelzwey', 'Sigismunds', 'Urseren', 'Kirchhof', 'Käfigturm Berner Taschenbuch', 'Gmein Stuben', 'Twingherrenstreites', 'Savoy', 'Thun Wangen', 'Oberhasli', 'Twingherren', 'Straßburg Rottweil', 'Bern Aarberg', 'Neubrücke', 'SchwäbischGmünd', 'Sant Vincenzen Steinhütte', 'Leprosenhaus', 'Niedern Brück', 'Gümmenen', 'Kriedli, SLOC', 'Spiez Frutigen', 'Freiburg Schwyz', 'Grüningen', 'Tarras', 'Bönwald Bowald', 'Thuner Udelbuch Bern', 'Zrancke', 'Garriliatis Bern', 'Lombarden', 'brugg Worlauffen Schil', 'Orna', 'August Steinberg', 'Luzern Besan', 'Gotthardstraße', 'Aare', 'Missivenbuch', 'Museum Bern', 'Ballmoos', 'Nürnberg', 'St Vincenzen', 'St Urban', 'Alten Bern', 'Bern Solothurn', 'VlneenrenFestschrlsk', 'Sizilien Kandia', 'Westfront', 'Palästina', 'Werders', 'Viviers', 'Carouge', 'Mendrisio', 'Zürich', 'Mittelländischen Meeres', 'Leutkirche', 'Steiger Kirchdorf', 'Nürenberg', 'Kienholz Hasli Guttannen', 'Königsfelden', 'Wildbann', 'Dominikanerkirche', 'Bannes Stör', 'Höchst', 'Batten Thunersee', 'Rodt Bcrn', 'Bern Ähnlich Belp', 'Schloß Landshut', 'Asti Rodt Bern', 'brugg', 'Herrn Gebiet', 'Johanneskapelle', 'Ringgenberg Brienz', 'nachFreiburg', 'Büren', 'bern', 'Münsterbau', 'Diemtigen', 'Gemmi', 'Dänemark', 'Fränkli', 'Rottweil Schwarzwald', 'Öfters', 'Jnterlaken', 'Jura', 'Kestenberg', 'Amsoldingen', 'Münsterportal', 'Roßmärit', 'Äirchherr Gerzensee', 'Twingen', 'Hof Hofstatt', 'Murgeten', 'Bern XIII xux 537 Justinger', 'Silberberg', 'Königsselden', 'ChristoffelTor', 'Bümpliz', 'Basels', 'Hofstatt', 'Courtelary', 'Thüring von Ringoldingen', 'Schloß Fallon', 'Septimer', 'Mülhausen', 'Rüeggisberg', 'Stadtbach', 'Friedens'}",153,"{'Hormannsgasse', 'Ctr Eichhorn', 'Altenberg', 'Lombach', 'Sttarsen', 'Vesoul', 'Landstrae', '- pen', 'Zrich', 'Mlhausen', 'Gundelfingen', 'Pruntruk', 'Neubrcke', '-', 'Brandenburg', 'Blatt', 'Schlipfen', 'Bcrn', 'Nrenberg', 'Nydau', 'Bhmen', 'Pohlen', 'Ziehl', 'Rrndtsch, ', 'Grchwil', 'Rogier', 'Seevogt', 'Brck', 'Mnchen', 'Anshelm', 'Asti Rodt', 'Burgunds', 'Acherum', 'Palstina', 'St. Vincenzen', 'Mhleberg', 'Hall', 'Oestreich', 'Friesenland', 'Memmingen', 'Luternau', 'Murgenthal', '^', 'Ringol', 'Finedig', 'Rarndtsch', 'Constanz', 'Vixou', '- cenzenstiftes', 'reuzgasse', 'Burgundien', 'Stettlers', 'Reggisberg', 'Bnwald Bowald', 'Vrloub', 'Limburg', 'Cassino', 'Stephanstag', 'Christi', 'Veldenz', 'St. Urban', 'Bren', 'Hauenstein', 'Lattreien-Alp', 'Straburg', 'Schwbisch-Gmnd', 'Del Urb Bern', 'Arow', 'Besan ^ on', 'Huttwyl', '- bau', 'Wrttemberg', 'Ringgenberg', 'Miltenberg', 'Campostella', 'Kienholz', 'Welti', 'Helvetia', 'Neuenburg', 'Kenzingen', 'Mnsigen', 'Stffis', '- berg', 'Bmpliz', 'Kirchdorf', 'Kln', 'Englisberg', 'Kandia', 'Rhodus', 'Arm', 'Rodt', 'Frciburg', 'Bttikon', 'Grandson', 'Murkeu', 'Grub', '- sonaz', 'Mnsterchor', 'Trken', 'Zhringen', 'Bmwald', 'Neubau', 'Eppingen', 'Pfg', 'Alpenrosen', 'Naney', 'Dies', 'Brssel', 'Zimmet', 'Johannestag', 'Schenkenberg', 'St. Jakob', 'Wietlisbach', 'Kleinkram', 'Aalbcken', 'Vincenzenbau', 'Sizilien', 'Schwarzwald', 'Salz', 'Gotthardstrae', 'Kiental', '- lerno', 'Weyden', 'Hagenau', 'Mlinen', 'Seewegs', 'Hiltcrfingen', 'Dnemark', 'sterreich', 'Mnchenbuchsee', 'Schrlitz', 'Ringoldingen', 'Gallen', 'Troeschen', 'Lamparten', 'Frei', 'St. Martinstag', 'Nydeckbrcke', 'Malazien', 'Pest', 'Spinal', 'Grasburg', 'Brotschal', 'Schwyz', 'Grovieh', 'Garriliati', 'Gmnd', 'egerdongasse', 'Mnster', 'Pfd', 'Hochburgund', 'Adrians', '- wald', 'Urban', 'Trachsel', 'Gmmenen', 'Guttannen', 'Vern', 'Steck', 'Aarwangen', 'Btikon', 'Zrichkrieg', 'Belp', 'Grningen', 'Marktgasse', 'Vincenzen-Kirche', 'Lau', 'Berns', 'Bincenzen-Mnster', '- bach', 'Knigsselden', 'Fontes', 'Wildegg', 'Michaelis', 'Dinkel', 'Lpiez', 'Jnnocenz', '- burg', 'Prag', 'Springolf', 'Blamond', 'Sicilien', 'Thunersee', 'Niedersiebental', 'Berner', 'Sa', 'Speichingen', 'Knigsfelden', 'Herbligen', 'Graubnden', 'Wallisergebirg', 'Mritgasse', 'Sew', 'Pfenningen', 'Alt-Bern', 'Dirnen', 'Bonstetten', 'Leutkirchenturm', 'nrenberg', 'Wurgund', 'Schl', 'Nrnberg', 'Wallis', 'Thring'}",204,"{'Hormannsgasse', 'Ctr Eichhorn', 'Sttarsen', 'Lombach', 'Köln Rhein', 'Landstrae', 'Twann', 'Mlhausen', 'Bömwald', 'Gundelfingen', 'Pruntruk', '-', 'Brandenburg', 'Bcrn', 'Stein Rhein', 'Nrenberg', 'Nydau', 'Pohlen', 'Ziehl', 'Dominikus', 'Rrndtsch, ', 'Rogier', 'Brck', 'Mnchen', 'Anshelm', 'Burgunds', 'Memmingen', 'Zoll', 'Luternau', 'Finedig', 'Rarndtsch', 'Mülenen', 'Twingherrenrecht', 'Wohlen', 'reuzgasse', 'Bern III Blatt XVI', 'Reggisberg', 'Limburg', 'Stephanstag', 'Österreich', 'St. Urban', 'Diesbach Capellen', 'Hauenstein', 'Monte Cassino', 'Straburg', 'Schwbisch-Gmnd', 'Oberlandes', 'Arow', 'Schloß Thun', 'Hilterfingen', 'Besan ^ on', 'Huttwyl', '- bau', 'Miltenberg', 'Bern Thun', 'Torrent', 'Welti', 'Bubenberg Erlach', 'Bümpliz Mühleberg', 'Scharnachthals', 'Eriz', 'Bern VII', 'Münchenbuchsee Blumenstein', 'Sigismunds', 'Urseren', 'Kirchhof', '- berg', 'Bmpliz', 'Savoy', 'Thun Wangen', 'Kln', 'Oberhasli', 'Englisberg', 'Twingherren', 'Straßburg Rottweil', 'Rodt', 'Bern Aarberg', 'SchwäbischGmünd', 'Niedern Brück', 'Mnsterchor', 'Zhringen', 'Gümmenen', 'Kriedli, SLOC', 'Spiez Frutigen', 'Freiburg Schwyz', 'Grüningen', 'Tarras', 'Bönwald Bowald', 'Eppingen', 'Pfg', 'Zrancke', 'Alpenrosen', 'Dies', 'Zimmet', 'Johannestag', 'Luzern Besan', 'Orna', 'Schenkenberg', 'Missivenbuch', 'Nürnberg', 'Vincenzenbau', 'Sizilien', 'Alten Bern', 'Gotthardstrae', 'Kiental', 'Bern Solothurn', 'Hiltcrfingen', 'Dnemark', 'sterreich', 'VlneenrenFestschrlsk', 'Schrlitz', 'Gallen', 'Troeschen', 'Lamparten', 'Palästina', 'Pest', 'Carouge', 'Mendrisio', 'Spinal', 'Zürich', 'Grasburg', 'Steiger Kirchdorf', 'Schwyz', 'Grovieh', 'Garriliati', 'Gmnd', 'egerdongasse', 'Dominikanerkirche', 'Bannes Stör', 'Rodt Bcrn', 'Mnster', 'Bern Ähnlich Belp', 'Pfd', 'Adrians', '- wald', 'Asti Rodt Bern', 'Schloß Landshut', 'Vern', 'Steck', 'Ringgenberg Brienz', 'Zrichkrieg', 'nachFreiburg', 'Büren', 'Grningen', 'Marktgasse', 'Lau', 'Berns', '- bach', 'Knigsselden', 'Fontes', 'Gemmi', 'Dänemark', 'Fränkli', 'Jnnocenz', 'Lpiez', 'Amsoldingen', 'Jura', 'Münsterportal', 'Blamond', 'Sicilien', 'Äirchherr Gerzensee', 'Niedersiebental', 'Berner', 'Sa', 'Herbligen', 'Silberberg', 'Wallisergebirg', 'Mritgasse', 'Sew', 'Bümpliz', 'Basels', 'Courtelary', 'Schloß Fallon', 'Wurgund', 'Mülhausen', 'Rüeggisberg', 'Stadtbach', 'Fallbrücke', 'Altenberg', 'Vesoul', '- pen', 'Zrich', 'Haus Haus', 'Neubrcke', 'Blatt', 'Schlipfen', 'Meßmer Siechenhaus', 'Bern Zoll', 'Bhmen', 'Walstatt', 'Grchwil', 'Val Gressoney', 'Seevogt', 'Köniz', 'Andlau Elsaß', 'Asti Rodt', 'Meiringen', 'Acherum', 'Palstina', 'St. Vincenzen', 'Mhleberg', 'Hall', 'Oestreich', 'Friesenland', 'Köln', 'Murgenthal', '^', 'Schloß Godesberg', 'Ringol', 'Lyonermesse', 'Graubünden', 'Constanz', 'Lahr', 'Vixou', '- cenzenstiftes', 'Burgundien', 'Stettlers', 'Bnwald Bowald', 'Vrloub', 'Münster', 'München', 'Cassino', 'Eine Bremgarten', 'Christi', 'Veldenz', 'Hofstetten', 'Bren', 'Lattreien-Alp', 'Del Urb Bern', 'Barfüßerkirche', 'Ringgenberg', 'Wrttemberg', 'Campostella', 'Fränklis', 'Lllhclflüh', 'Kienholz', 'Straßburg', 'Mecheln', 'Helvetia', 'Neuenburg', 'Kenzingen', 'Distelzwey', 'Käfigturm Berner Taschenbuch', 'Mnsigen', 'Gmein Stuben', 'Stffis', 'Twingherrenstreites', 'Kirchdorf', 'Kandia', 'Rhodus', 'Arm', 'Frciburg', 'Neubrücke', 'Bttikon', 'Grandson', 'Murkeu', 'Sant Vincenzen Steinhütte', 'Grub', 'Leprosenhaus', '- sonaz', 'Trken', 'Bmwald', 'Neubau', 'Thuner Udelbuch Bern', 'Garriliatis Bern', 'Lombarden', 'Naney', 'Brssel', 'brugg Worlauffen Schil', 'August Steinberg', 'St. Jakob', 'Gotthardstraße', 'Aare', 'Wietlisbach', 'Kleinkram', 'Aalbcken', 'Museum Bern', 'Ballmoos', 'St Vincenzen', 'St Urban', 'Salz', 'Schwarzwald', '- lerno', 'Weyden', 'Hagenau', 'Mlinen', 'Seewegs', 'Mnchenbuchsee', 'Ringoldingen', 'Sizilien Kandia', 'Westfront', 'Nydeckbrcke', 'Frei', 'St. Martinstag', 'Malazien', 'Werders', 'Viviers', 'Mittelländischen Meeres', 'Leutkirche', 'Nürenberg', 'Brotschal', 'Kienholz Hasli Guttannen', 'Königsfelden', 'Wildbann', 'Höchst', 'Batten Thunersee', 'Hochburgund', 'brugg', 'Urban', 'Trachsel', 'Gmmenen', 'Guttannen', 'Herrn Gebiet', 'Johanneskapelle', 'Aarwangen', 'Btikon', 'Belp', 'bern', 'Vincenzen-Kirche', 'Bincenzen-Mnster', 'Münsterbau', 'Wildegg', 'Diemtigen', 'Michaelis', 'Dinkel', 'Rottweil Schwarzwald', 'Öfters', '- burg', 'Prag', 'Jnterlaken', 'Roßmärit', 'Springolf', 'Kestenberg', 'Thunersee', 'Twingen', 'Hof Hofstatt', 'Murgeten', 'Speichingen', 'Knigsfelden', 'Graubnden', 'Bern XIII xux 537 Justinger', 'Königsselden', 'ChristoffelTor', 'Thüring von Ringoldingen', 'Hofstatt', 'Pfenningen', 'Alt-Bern', 'Dirnen', 'Bonstetten', 'Leutkirchenturm', 'nrenberg', 'Septimer', 'Schl', 'Nrnberg', 'Wallis', 'Thring', 'Friedens'}",357
18831419,280060,"{'Roms', 'Hormannsgasse', 'Altenberg', 'Main', 'Oesterreichs', 'Ufgau', 'Werkhof', 'Judenkirchhof', 'Wylerfeld', 'Oberwil', 'Brugg', 'Kyburg', 'Galgenhubel', 'Turin', 'Alemannien', 'Freiburg', 'Donau', 'Mitteldeutschland', 'Alemannen', 'Kleinburgund', 'Muri', 'Jagdburg', 'Spitalgasse', 'Weiermanns', 'Wattenwyl', 'Schwarzenburg', 'Elisried', 'Muristalden', 'Sulgenbach', 'Lyon', 'Vilbringen', 'Galterntal', 'Balmegg', 'Friburg', 'Lausanne', 'Steinebach', 'Kramburg', 'Geroldseck', 'Neuburgund', 'Geristein', 'Herrengasse', 'Schweiz', 'Zeughausgasse', 'Ringgenberg', 'Waadt', 'Altenbergweg', 'Zeughausgassc', 'Luzerns', 'Petinesca', 'Italien', 'Neuenburg', 'Worblaufen', 'Rom', 'Kien', 'Kirchenseld', 'Amsoldingeu', 'Blangkenburg', 'Baden', 'Winterthur', 'Lnbenberg', 'Engeivald', 'Thurgau', 'Laupen', 'Verona', 'Konol', 'Vincenzen', 'Savoyens', 'Wankdorf', 'Thorberg', 'Erlach', 'Kreuzgasse', 'Konstanz', 'Mailand', 'Runsen', 'Allmendingen', 'Aventicum', 'Wisflisburg', 'Buchsee', 'Altenbergs', 'Marbach', 'Burgund', 'Burgdorfs', 'Bern', 'Neuenstadt', 'Lybien', 'Wettingen', 'Piacenza', 'Florenz', 'Buchegg', 'Wighaus', 'Aargau', 'Weicrmannshaus', 'Ulm', 'Haag', 'Romont', 'Junkerngasse', 'Sempach', 'Solodurum', 'Jerusalem', 'Breisgau', 'Blankenburg', 'Aarbergergasse', 'Freiburgs', 'Signau', 'Frienisberg', 'Aare', 'Berne', 'Neuenegg', 'Schwarzwald', 'Savoyen', 'Savohen', 'Wydenfeld', 'Brunngasse', 'Schwaben', 'Luzern', 'Metzgergasse', 'Hettiswil', 'Oberland', 'Solothurn', 'Burgdorf', 'Nydegg', 'Tiefenau', 'Bielersee', 'Autun', 'Hirschhorn', 'Vindonissa', 'Diespach', 'Leutkirche', 'Vincenzenkirche', 'Grasburg', 'Landeron', 'Uri', 'Biglen', 'Kirchgasse', 'Wabern', 'Kirchlindach', 'Nidau', 'Bremgarten', 'Brunnadern', 'Moosseedorfsee', 'Alpen', 'Meikirch', 'Vnbcnbergslnrlein', 'Burgunderreich', 'Garonne', 'Spanien', 'Peterlingen', 'Portugal', 'Postgasse', 'Zollikofen', 'Besan', 'Palermo', 'Vern', 'Bologna', 'Udelbnch', 'Belp', 'Aarberg', 'Ueberstorf', 'Marktgasse', 'Berns', 'Aar', 'Helvetien', 'Jnselgasse', 'Spiez', 'Caorsa', 'Thun', 'Marsili', 'Torturm', 'Trier', 'Jura', 'Grindelwald', 'Sulgen', 'Amsoldingen', 'Unterwalden', 'Helvetiens', 'Deutschland', 'Thunstetten', 'Hasli', 'Greyerz', 'Rhein', 'Gallien', 'Engewald', 'Seftigen', 'Felsenburg', 'Rheins', 'Cluny', 'Basel', 'Basels', 'Laupens', 'Avignon', 'Bechburg', 'Montenach', 'Velp', 'Kramgasse', 'Aarau', 'Obstberg', 'Wimmis', 'Rhone', 'Wallis', 'Stadtbach', 'Saane', 'Bubenbergs', 'Rohrberg'}",203,"{'Zwinger', 'Wädiswil', 'Wendelstein', 'Stadtschloß', 'Leuenberger Bcrnische Nechisgeschichtc', 'Barnigen', 'Waldstätte paZ', 'Wendelsee', 'Judengasse', 'Einsiedeln', 'Museum Stiirlcr ResormalionsUrkuiiden', 'Schloß Bremgarten', 'Blumenstein', 'Käfigturm', 'Histor Museum', 'Wattenwyl Stadt', 'Bern Bern', 'Vechigen', 'Jammertal', 'Zofingen', 'Elsaß', 'Leinwandband', 'Gcngler', 'Grindelwald Oberland', 'Gundebald', 'Mühlenberg Desertum Mulinberg', 'Deutschen Orden', 'Predigcnurin', 'Köniz', 'Schloß Locarno', 'Basel Luzern', 'Gberspital', 'Burgunds', 'Kirchhofmauer', 'Därstetten', 'Andccktreiwe', 'Judentor', 'Köln', 'Schmitten', 'Aainsene', 'Tiesbaelrhaiis', 'Längenberg', 'Rosenbühl', 'Romfahrten', 'Lausanne Wurstcmberger', 'Andreastage', 'PredigertorTurm', 'Aarschwelle', 'Münsingen', 'Münster', 'Auxonne', 'Martigny', 'Rümligen', 'Frutigen', 'Graubündens', 'Oberbüren', 'Stettlen', 'Schoßhalde', 'Bern xuZ 145 Fontes piF', 'DeutschOrdensleutkirche', 'Waisenhausplatzes', 'Dornbühl', 'Bern Stadtgeschichte', 'Niedern Spitals von Bern', 'Saxergutes', 'Erstein Rhein', 'Gerechtigkeitsgasse', 'Kaiuons Bern', 'Straßburg', 'Münchenbuchsee', 'Klöster Weg', 'Ncchtsquellen', 'Bümpliz Mühleberg', 'Reichsstraße', 'Erlenbach', 'Vogesen', 'Frauenkäfy', 'Fraubrunnen', 'Münsters', 'Ostbaues', 'Kirchhof', 'Rüeggisberg Münchenwyler St Johannsen', 'Lützelflüh', 'Zürichgau', 'Römer', 'Rüeggisbergs', 'Schloß Burgdorf', 'Mattenengi', 'Greden', 'Klösterli', 'Zuirareenkur', 'Grasburg Bubenberg Geristein', 'Bern Kastvögtc', 'Marienglas', 'Vom Reich', 'Udelhaus', 'Jnselschwestern', 'Ebendaselbst', 'Parlamentsgcbäudc', 'Andeckkirche', 'Belp Hoh', 'Oandrluli', 'Bernerrecht', 'Freiburg Uechtland', 'Ehristosielturm Vern', 'Gümmenen', 'Jordanhauses Jsenhut', 'Bernstraße', 'Pont Fraubrunnen', 'Wabernstraße', 'Steghalde', 'Ober Pfistcrn Zntgloekcnlnrin', 'Christoffels', 'Breitenrain', 'Nydeggbrücke', 'Greda', 'Nydeckbrücke', 'Hasle', 'Ler Bern', 'Heiliggeistkirche', 'Colatieri Deutschland', 'Michelstürli', 'Zeughausfa', 'Bubenberge', 'Neuenegg Mühleberg', 'Nürnberg', 'Museum Bern', 'St Vincenzen', 'Holzigkofen', 'Ostermundigen Feld', 'Burgäschi', 'Straß', 'Aventikum', 'Ehhafte Forst', 'Israels', 'Münstngen Ranton Vorn', 'Egghölzli', 'Heerbannes Bern', 'SüdWestSchweiz', 'Helvetier', 'Rougemont', 'Bern, SLOC', 'Blanernhans', 'Müslin', 'Brunnadern Kalchegg Schoßhalde', 'Zwischen Wighaus', 'Lonüiotus', 'Brllnnen', 'Zürich', 'Hangende Fluh', 'St Georgs', 'Uri Schwyz', 'Speyer', 'Bern VIII pnx 186', 'Büren Aare', 'Rümlingen', 'KlösterliWirtshauses', 'Keine Tellrödel', 'Roßfeld Engimeistergut', 'Tachiiagsergrabeil Oberner Pulvermriu der Barengraben', 'Schindeliurm', 'St Mau', 'Weißenburg', 'Ägypten', 'Tnelilaiibe', 'Rodt Bern', 'Boetius Werk', 'Haus Nr', 'Wendelstein Schl Ebenso', 'Lorraine', 'Schweiz Bern', 'Schönberg', 'Stafis', 'Wyler Rubigen Sinneringen', 'Näfels', 'Aartales', 'Gvlatenmatt', 'Nydegg Diese Burg', 'Holligen Stadtbach', 'Rottweil', 'Schloß Reichenbach', 'Schwarztorstraße', 'Sternenberg Bern', 'Eschenbach Oberhofen', 'Wylergutes', 'Thunersees', 'Büren', 'Muri Ostermundigen', 'Postgaßhalde', 'Louppen', '8rvioia', 'Burgdorfstraß', 'iD7SkZs', 'LLÄMKzSLL', 'Bubenbergtürli', 'Könizerkirche', 'Wyden', 'Jodocus', 'Üuria Helvetiorum', 'leins Buren', 'Ramseyerloch', 'Nydegg Bern', 'Kleinhöchstetten', 'Huttwil', 'Jnterlaken', 'Johanniterkirche', 'Die Keller', 'Burgdorf Thun', 'Schloß Rcichenbach', 'Muristraße', 'Osthäuserfronten', 'Predigerkloster', 'Bundesverhältnis', 'Neuburgundischen Reiches', 'Zähringen', 'Genf Gallien', 'Bümpliz', 'Hofstatt', 'Thun Burgdorf Jferten', 'MoosscedorfSecs', 'TschiffeUtnrm Hirschenbaldc Pnlvcrtnrm', 'Schloß Dremgarken', 'Ralsnianual', 'St Vincenzen Leutkirche', 'Berne Bubenberg', 'Srugercßlcdtlicßes', 'Fraubrunnen Guglerkrieg', 'Münsterecke', 'Rubigen', 'Rüeggisberg', 'Schlösser Reichenbach', 'Tentenbergischen Mühlen', 'St Peter', 'Haspelweg'}",234,"{'Reggisbergs', 'Lchwanau', 'Diebach', 'Pfistcrn', 'Pont', 'Laube', 'Beundenseld', 'Sennhein', 'Knigshfen', 'Kilchtorf', 'Wipprecht', 'Scmpach', 'Toffen', 'Brunstat', 'Agaunum', 'Reggisberg', 'Muristrae', 'Schwanden', 'St. Urban', '- len', 'Reich', 'Haller', '- Kramburg', 'Schwanow', 'Simmental', 'Sonnenseite', 'Bubenberg', 'Rodt', 'Elsa', 'Wurstcmbergcr', '- Bern', '- gartenwald', 'Oentz', 'Nichlcrmibl', 'Schwartzenburg', 'Hohenburg', 'Sternenberg', 'Buobenberg', 'Psd', 'Wittigkofen', 'Murtcn', 'Jferten', '- lingen', 'Vincencyen', 'Reichenbach', 'Skala', 'Bremgartenwaldes', 'Burkhart', 'Georgs', 'Worb', 'St. Michaels -', 'Habsburg', 'St. Vinzenzen', 'Riedligraben', 'estlergasse', 'Justinger', 'Berna', 'Saanenufer', 'Lchinkengasse', 'Fontes', 'Thuns', '- matt-Gasse', 'Rud', 'Gld', 'Graffenried', 'Morgarten', 'Nhtland', 'Gisenstein', 'St. Peter', 'Leibe', 'Wevn', 'Gerberngraben', 'chtland', 'Rodn', 'Delle', 'Haspel', 'Schleusen', 'Kelergasse', 'Christoffelgasse', 'Vurgdorf', 'Vincenzenkirchlurm', 'Brescia', 'Dremgarken', 'Ocntz', '- fingen', 'Mhleberg', 'Lanpen', 'Nellenburg', 'Gysenstein', 'Frisching', 'Gerbernviertel', 'Bicocca', '- burgern', 'Rodl', 'Bren', 'xng', '- rice', 'Leuenbergcr', 'Berncr', 'Golaten', 'Blutturm', 'Maserholz', 'Berno', 'Baselwind', 'Straberg', 'Walser', 'Frick', 'Gybelegg', 'Trb', 'Siben', 'Stein', 'Rhodus', 'Wolon', 'Bernern', 'Rmlingen', 'Uechtland', 'Novara', 'Gerolds', 'Heiligen', 'Couch', 'Dern', 'Mau', 'Fibel', 'Ulrich', 'Ranton', 'Schohalde', 'Gcrberngraben', 'Karls', '- tal', 'Brandis', 'Schnberg', 'St. Petersinsel', 'St. Martinstag', 'Martinstag', '- gelbach', 'Mulinberg', 'Burgenstein', 'Gravenriet', 'Vincenncs', 'Mnsters', 'Fellenberg', 'Ehgraben', 'Gmmenen', 'Nydegge', 'Marktgassc', 'Bern paZ', 'bern', 'Langenthal', 'Brienz', '- egg', 'Oesterreich', '- burg', 'Burgundionen', 'Drstetten', 'Vrowenbrunnen', 'Udelzinse', 'Bern, ', 'Homberg', 'Brienzersee', 'Nrnberg', 'Bubenbcrg', 'berstorf', 'Berch', 'Nov', '-', 'Mhlenberg', 'Neukomm', 'Richenbach', 'Trottlohn', 'Vincenzen-Kirchhof', 'Gyber', 'Vitodurans', 'St. Urs', 'kilchgasse', 'St. Schwarzenburg', 'Regensberg', 'Nephrit', 'Diesbach', 'Thicrstein', 'Straburg', 'Strauchrittern', 'Heyningen', 'AnShelm', 'Bibrakte', 'Walliz', 'Wynau', '- berg', 'Bmpliz', 'St.', 'Batzen', 'Kln', 'Sd-West-Schweiz', 'Magstatt', 'Blienswyl', 'Zhringen', 'Klsterli', 'Rotweils', 'Landau', 'Walde', 'Heisterbach', 'Pfg', 'Zwinglis', 'Switz', 'Tentenberg', 'Luxemburg', 'Wattenwyl-Pourtales', 'Strt', 'Kirchgasst', 'Zendal', 'Kastvgtc', 'Wabernstrae', 'Harnasch', 'Bipp', 'Mnsingen', 'Balswyl', 'Kienthal', '- haus', 'Locarno', 'Steininbrug-Graben', 'Pest', 'Genf', 'Mlinc', 'Ltzelflh', 'Egerdon', 'Burgdorfstra', 'Gisensteins', 'Bernstrae', 'Schwyz', '- burgunds', 'Schlo Rcichenbach', 'Berner-Heim', 'Pfd', 'Weidland', 'Golatenmattgasse', 'Guggis', 'Br', 'Graubndens', 'Maikirch', 'Berner', 'Burgistein', 'Grune', 'Mritgasse', 'Neuen brg', 'tornhaus', 'Wy', 'Berchtold', 'Neu', 'Del Bern', 'Pern', 'Wiler', '- gasse', 'Danton', 'Zrich', 'Brungaffen', 'rcnzgasse', 'vvlUjdvTVs', 'Wasserburg', 'Pim', 'Zell', 'Waldsttten', 'Grenchen', 'St. Rubigen', '- thurn', 'Weienburg', 'Stadlbach', 'Kirchhofs', 'Fenis', 'Christi', 'Oberhofen', 'Ky', 'Senn', 'Kniz', 'Baumgarten', 'Jordana', 'Brcklein', 'Mnstngen', 'Zrichgau', 'Mnsigen', 'Seedorf', 'Jegistorf', 'Grandson', 'Rcggis', 'Thierstein', 'Neubau', 'Eschenbach', 'Schlo', 'Spilman', 'Aquino', 'St. Jakob', 'Nydeggbrcke', 'mritgasse', 'Werdt-Denkmal', 'Solo', 'Brem', 'Oltigen', 'Mnchenbuchsee', 'Nydeckbrcke', 'Wurstembcrger', 'Lex', 'Schilling', 'Kanton', 'Stiickclberg', 'Mslin', 'Venli', 'Urban', 'Neuburgunds', 'Kalchegg', 'Aarwangen', 'Hormaniisgaste', 'Moosseedors', 'Marche', 'Vinccnnes', 'Balstal', 'Heimberg', 'Liilhi', 'Muristra', 'Woh', 'Egghlzli', 'Langenstein', 'Omega', 'Gli', 'Andreastag', 'Schl', 'Egidien'}",324,"{'Reggisbergs', 'Lchwanau', 'Diebach', 'Pfistcrn', 'Pont', 'Laube', 'Beundenseld', 'Elsaß', 'Gundebald', 'Schloß Locarno', 'Sennhein', 'Burgunds', 'Andccktreiwe', 'Knigshfen', 'Kilchtorf', 'Wipprecht', 'Längenberg', 'Scmpach', 'Andreastage', 'Toffen', 'Brunstat', 'Agaunum', 'Reggisberg', 'Muristrae', 'Schwanden', 'St. Urban', 'Rümligen', 'Oberbüren', '- len', 'Reich', 'Dornbühl', 'Kaiuons Bern', 'Bümpliz Mühleberg', 'Haller', '- Kramburg', 'Schwanow', 'Simmental', 'Kirchhof', 'Sonnenseite', 'Bubenberg', 'Mattenengi', 'Klösterli', 'Grasburg Bubenberg Geristein', 'Udelhaus', 'Rodt', 'Wurstcmbergcr', 'Elsa', '- Bern', '- gartenwald', 'Oentz', 'Nichlcrmibl', 'Parlamentsgcbäudc', 'Andeckkirche', 'Schwartzenburg', 'Freiburg Uechtland', 'Ehristosielturm Vern', 'Gümmenen', 'Bernstraße', 'Pont Fraubrunnen', 'Greda', 'Hohenburg', 'Nydeckbrücke', 'Sternenberg', 'Michelstürli', 'Zeughausfa', 'Buobenberg', 'Bubenberge', 'Psd', 'Wittigkofen', 'Nürnberg', 'Holzigkofen', 'Aventikum', 'Ehhafte Forst', 'Murtcn', 'Jferten', '- lingen', 'Vincencyen', 'Reichenbach', 'Skala', 'Zürich', 'Hangende Fluh', 'Uri Schwyz', 'Bremgartenwaldes', 'Burkhart', 'Georgs', 'Roßfeld Engimeistergut', 'Worb', 'St. Michaels -', 'Habsburg', 'Wendelstein Schl Ebenso', 'Lorraine', 'Schönberg', 'St. Vinzenzen', 'Riedligraben', 'Aartales', 'estlergasse', 'Justinger', 'Berna', 'Saanenufer', 'Lchinkengasse', 'Thunersees', 'Fontes', 'Thuns', '- matt-Gasse', 'Rud', 'Wyden', 'Gld', 'Kleinhöchstetten', 'Die Keller', 'Muristraße', 'Graffenried', 'Morgarten', 'Nhtland', 'Osthäuserfronten', 'Predigerkloster', 'Gisenstein', 'St. Peter', 'Bundesverhältnis', 'Zähringen', 'Leibe', 'Wevn', 'MoosscedorfSecs', 'Ralsnianual', 'Srugercßlcdtlicßes', 'Gerberngraben', 'Schlösser Reichenbach', 'chtland', 'Rodn', 'Zwinger', 'Wädiswil', 'Delle', 'Wendelstein', 'Haspel', 'Schleusen', 'Kelergasse', 'Waldstätte paZ', 'Wendelsee', 'Judengasse', 'Christoffelgasse', 'Vurgdorf', 'Einsiedeln', 'Museum Stiirlcr ResormalionsUrkuiiden', 'Schloß Bremgarten', 'Vincenzenkirchlurm', 'Brescia', 'Vechigen', 'Jammertal', 'Zofingen', 'Grindelwald Oberland', 'Dremgarken', 'Mühlenberg Desertum Mulinberg', 'Ocntz', '- fingen', 'Basel Luzern', 'Gberspital', 'Kirchhofmauer', 'Mhleberg', 'Lanpen', 'Judentor', 'Nellenburg', 'Köln', 'Gysenstein', 'Frisching', 'Gerbernviertel', 'Aarschwelle', 'Bicocca', '- burgern', 'Rodl', 'Bren', 'xng', '- rice', 'Bern xuZ 145 Fontes piF', 'Leuenbergcr', 'Berncr', 'Golaten', 'Blutturm', 'Maserholz', 'Niedern Spitals von Bern', 'Berno', 'Baselwind', 'Klöster Weg', 'Reichsstraße', 'Straberg', 'Vogesen', 'Fraubrunnen', 'Münsters', 'Walser', 'Frick', 'Gybelegg', 'Rüeggisberg Münchenwyler St Johannsen', 'Lützelflüh', 'Trb', 'Siben', 'Römer', 'Greden', 'Zuirareenkur', 'Bern Kastvögtc', 'Stein', 'Jnselschwestern', 'Rhodus', 'Wolon', 'Bernern', 'Rmlingen', 'Bernerrecht', 'Uechtland', 'Novara', 'Gerolds', 'Couch', 'Heiligen', 'Wabernstraße', 'Ober Pfistcrn Zntgloekcnlnrin', 'Dern', 'Christoffels', 'Breitenrain', 'Mau', 'Fibel', 'Ulrich', 'Ranton', 'Hasle', 'Ler Bern', 'Schohalde', 'Neuenegg Mühleberg', 'Burgäschi', 'Gcrberngraben', 'Egghölzli', 'Karls', '- tal', 'SüdWestSchweiz', 'Brandis', 'Schnberg', 'St. Petersinsel', 'St. Martinstag', 'Blanernhans', 'Müslin', 'Lonüiotus', 'St Georgs', 'Speyer', 'Martinstag', '- gelbach', 'KlösterliWirtshauses', 'Mulinberg', 'Burgenstein', 'Gravenriet', 'Vincenncs', 'Tachiiagsergrabeil Oberner Pulvermriu der Barengraben', 'Schindeliurm', 'Haus Nr', 'Mnsters', 'Fellenberg', 'Ehgraben', 'Stafis', 'Gmmenen', 'Nydegge', 'Holligen Stadtbach', 'Marktgassc', 'Sternenberg Bern', 'Bern paZ', 'bern', 'Langenthal', 'Louppen', 'Brienz', '- egg', 'Oesterreich', 'Nydegg Bern', '- burg', 'Jnterlaken', 'Johanniterkirche', 'Burgundionen', 'Huttwil', 'Drstetten', 'Burgdorf Thun', 'Vrowenbrunnen', 'Udelzinse', 'Neuburgundischen Reiches', 'Genf Gallien', 'Bern, ', 'Hofstatt', 'TschiffeUtnrm Hirschenbaldc Pnlvcrtnrm', 'Schloß Dremgarken', 'Homberg', 'Brienzersee', 'Nrnberg', 'Bubenbcrg', 'St Peter', 'Haspelweg', 'berstorf', 'Berch', 'Nov', '-', 'Blumenstein', 'Mhlenberg', 'Leinwandband', 'Neukomm', 'Richenbach', 'Trottlohn', 'Vincenzen-Kirchhof', 'Deutschen Orden', 'Gyber', 'Vitodurans', 'St. Urs', 'Därstetten', 'Schmitten', 'kilchgasse', 'St. Schwarzenburg', 'Regensberg', 'Rosenbühl', 'Romfahrten', 'Lausanne Wurstcmberger', 'PredigertorTurm', 'Nephrit', 'Münsingen', 'Diesbach', 'Thicrstein', 'Auxonne', 'Straburg', 'Schoßhalde', 'Strauchrittern', 'Heyningen', 'AnShelm', 'Bern Stadtgeschichte', 'Saxergutes', 'Erstein Rhein', 'Münchenbuchsee', 'Ncchtsquellen', 'Erlenbach', 'Bibrakte', 'Walliz', 'Wynau', '- berg', 'Bmpliz', 'St.', 'Rüeggisbergs', 'Batzen', 'Kln', 'Sd-West-Schweiz', 'Magstatt', 'Blienswyl', 'Marienglas', 'Belp Hoh', 'Zhringen', 'Klsterli', 'Rotweils', 'Landau', 'Walde', 'Steghalde', 'Heisterbach', 'Pfg', 'Zwinglis', 'Switz', 'Luxemburg', 'Tentenberg', 'Wattenwyl-Pourtales', 'Strt', 'Heiliggeistkirche', 'Colatieri Deutschland', 'Kirchgasst', 'Zendal', 'Straß', 'Kastvgtc', 'Wabernstrae', 'Harnasch', 'Bipp', 'Mnsingen', 'Balswyl', 'Münstngen Ranton Vorn', 'Heerbannes Bern', 'Kienthal', '- haus', 'Locarno', 'Helvetier', 'Steininbrug-Graben', 'Pest', 'Zwischen Wighaus', 'Genf', 'Mlinc', 'Egerdon', 'Burgdorfstra', 'Ltzelflh', 'Brllnnen', 'Gisensteins', 'Bern VIII pnx 186', 'Bernstrae', 'Schwyz', 'Rümlingen', '- burgunds', 'Schlo Rcichenbach', 'St Mau', 'Berner-Heim', 'Ägypten', 'Weißenburg', 'Pfd', 'Schweiz Bern', 'Wyler Rubigen Sinneringen', 'Näfels', 'Weidland', 'Gvlatenmatt', 'Nydegg Diese Burg', 'Golatenmattgasse', 'Schwarztorstraße', 'Eschenbach Oberhofen', 'Guggis', 'Wylergutes', 'Büren', 'Postgaßhalde', '8rvioia', 'Burgdorfstraß', 'LLÄMKzSLL', 'Bubenbergtürli', 'Könizerkirche', 'Üuria Helvetiorum', 'Ramseyerloch', 'Br', 'Graubndens', 'Maikirch', 'Berner', 'Burgistein', 'Grune', 'Mritgasse', 'Neuen brg', 'tornhaus', 'Wy', 'Bümpliz', 'Thun Burgdorf Jferten', 'Berchtold', 'Neu', 'St Vincenzen Leutkirche', 'Del Bern', 'Pern', 'Münsterecke', 'Wiler', 'Rüeggisberg', '- gasse', 'Stadtschloß', 'Leuenberger Bcrnische Nechisgeschichtc', 'Barnigen', 'Danton', 'Zrich', 'Brungaffen', 'Käfigturm', 'Histor Museum', 'rcnzgasse', 'Wattenwyl Stadt', 'vvlUjdvTVs', 'Wasserburg', 'Pim', 'Bern Bern', 'Gcngler', 'Zell', 'Predigcnurin', 'Köniz', 'Waldsttten', 'Grenchen', 'St. Rubigen', 'Aainsene', 'Tiesbaelrhaiis', '- thurn', 'Weienburg', 'Stadlbach', 'Kirchhofs', 'Münster', 'Fenis', 'Christi', 'Oberhofen', 'Martigny', 'Ky', 'Frutigen', 'Graubündens', 'Stettlen', 'Senn', 'DeutschOrdensleutkirche', 'Waisenhausplatzes', 'Kniz', 'Baumgarten', 'Gerechtigkeitsgasse', 'Jordana', 'Brcklein', 'Straßburg', 'Frauenkäfy', 'Mnstngen', 'Zrichgau', 'Ostbaues', 'Mnsigen', 'Seedorf', 'Zürichgau', 'Jegistorf', 'Schloß Burgdorf', 'Vom Reich', 'Ebendaselbst', 'Grandson', 'Oandrluli', 'Rcggis', 'Thierstein', 'Jordanhauses Jsenhut', 'Neubau', 'Eschenbach', 'Schlo', 'Nydeggbrücke', 'Spilman', 'Aquino', 'St. Jakob', 'Nydeggbrcke', 'mritgasse', 'Museum Bern', 'St Vincenzen', 'Werdt-Denkmal', 'Solo', 'Ostermundigen Feld', 'Israels', 'Brem', 'Oltigen', 'Mnchenbuchsee', 'Rougemont', 'Nydeckbrcke', 'Bern, SLOC', 'Wurstembcrger', 'Lex', 'Brunnadern Kalchegg Schoßhalde', 'Schilling', 'Büren Aare', 'Kanton', 'Stiickclberg', 'Mslin', 'Venli', 'Keine Tellrödel', 'Tnelilaiibe', 'Rodt Bern', 'Boetius Werk', 'Urban', 'Neuburgunds', 'Kalchegg', 'Rottweil', 'Schloß Reichenbach', 'Aarwangen', 'Hormaniisgaste', 'Moosseedors', 'Muri Ostermundigen', 'Marche', 'Vinccnnes', 'iD7SkZs', 'Balstal', 'Jodocus', 'Heimberg', 'leins Buren', 'Liilhi', 'Muristra', 'Woh', 'Schloß Rcichenbach', 'Egghlzli', 'Langenstein', 'Omega', 'Gli', 'Andreastag', 'Berne Bubenberg', 'Fraubrunnen Guglerkrieg', 'Schl', 'Rubigen', 'Egidien', 'Tentenbergischen Mühlen'}",558
10381638,377340,"{'Aarbergerthor', 'Augsburg', 'Arona', 'Rnmisberg', 'Sihl', 'Konolsingen', 'Kyburg', 'Balm', 'Dranse', 'Brandenburg', 'Stendal', 'Thur', 'Lnzern', 'Pruntrut', 'Dijon', 'Thurn', 'Oberaargau', 'Trostburg', 'Alemannen', 'Burgunds', 'Engelberg', 'Luternau', 'Messina', 'Schwarzenburg', 'Burgerspital', 'Englands', 'Nydeggkirche', 'Frankreichs', 'Maschwanden', 'Provence', 'Huttwyl', 'Mulhausen', 'Wien', 'Vallemaggia', 'Italien', 'Bramberg', 'Muttenz', 'Willisau', 'Pcterlingen', 'Genfcrsee', 'Gaeta', 'Verona', 'Bubenberg', 'Neuenbnrg', 'Solothurns', 'Erlach', 'Lignau', 'Beresina', 'Longueville', 'Utznach', 'Veltlin', 'Tellenburg', 'Thurm', 'Schafshausen', 'Lugano', 'Wiflisburg', 'Sempach', 'Freiburgs', 'Weimar', 'Kappel', 'Lissabon', 'Sternenberg', 'Ormonts', 'Wichtrach', 'Savohen', 'Chambery', 'Thusis', 'Oberland', 'Lemansees', 'Reichenbach', 'Bellievre', 'Lothars', 'Delfinat', 'Belst', 'Hannover', 'Wandt', 'Mnrgeten', 'Dornach', 'Lenzburg', 'Hugenotte', 'Malserhaide', 'Helvetien', 'Lavaux', 'Spiez', 'Emrne', 'Jura', 'Grindelwald', 'Khburg', 'Thunstetten', 'Greyerz', 'Ostschweiz', 'Derschau', 'Deutschlands', 'Montenach', 'Canada', 'Rhone', 'Freibnrg', 'Ramillies', 'Freienbach', 'Sarganserland', 'Altenberg', 'Sundgau', 'Oltingen', 'Erlacherhof', 'Davos', 'Greherz', 'Snmiswald', 'Farnsburg', 'Mailands', 'Frankfurt', 'Wiesenthal', 'Breisach', 'Aarburg', 'Malmaison', 'Zofingen', 'Stalden', 'Europa', 'Muri', 'Lauffenburg', 'Kleinburgnnd', 'Schweden', 'Langenstein Langetenthal', 'Vercelli', 'Sardinien', 'Bicocca', 'Hallwyl', 'Armagnaken', 'Forstwald', 'Lausanne', 'Bnchegg', 'Zosingen', 'Frundsberg', 'Ringgenberg', 'Solvthurn', 'Rossiniare', 'Trachselwald', 'Fraubrunnen', 'Seengen', 'Paris', 'Baden', 'Schweizersaal', 'Nassau', 'Thurgau', 'Montfaucon Sebastian', 'Scharnachthal', 'Thorberg', 'Mailand', 'Tafelfeld', 'Niederburgund', 'Novara', 'Saanen', 'Buchegg', 'Gingins', 'Aargau', 'Meaux', 'Romont', 'Snlgen', 'Junkerngasse', 'Seeland', 'Luntenthurm', 'Mannenberg', 'Hasle', 'Signau', 'Frienisberg', 'Neuenegg', 'Schanzen', 'Engelburg', 'Savoyen', 'Schwarzwald', 'Sursee', 'Burgdorf', 'Lreiburg', 'Lanterbrnnuen', 'Marignano', 'Frankreich', 'Arlesheim', 'Schwedens', 'Oberrheins', 'Trachfelwald', 'London', 'Italiens', 'Sargans', 'Sanetsch', 'Kreuzmatte', 'Bremgarten', 'Coppet', 'Polen', 'Alpen', 'Freiberge', 'Laupeu', 'Falkenstein', 'Coligny', 'Marienthal', 'Liestal', 'Neuenburgersee', 'Postgasse', 'Bremgartenwald', 'Aarberg', 'Weinsberg', 'Valsainte', 'Oesterreich', 'Frutigthal', 'Brienz', 'Laufanne', 'Catania', 'Andermatt', 'Ensisheim', 'Unterwalden', 'Schybi', 'Thunersee', 'Rhein', 'Rheins', 'Tirano', 'Abraham', 'Lausten', 'Aachen', 'Tremouille', 'Bonstetten', 'Homberg', 'Ueberlingen', 'Riedburg', 'Aarestadt', 'Saane', 'Buttisholz', 'Oberwangen', 'Niederlande', 'Murten', 'Kesselring', 'Aargaus', 'Freiburg', 'Brusio', 'Gottstatt', 'Ungarn', 'Flandern', 'Engadin', 'Beautteville', 'Laufenburg', 'Erlis', 'Stans', 'Lothringen', 'Diesbach', 'Kramburg', 'Tedlingen', 'Rothwald', 'Schweiz', 'Zeughausgasse', 'Vorarlberg', 'Louvre', 'Erlenbach', 'Ringoltingeu', 'Leicester', 'Laupen', 'Savoyens', 'Rhellicanus', 'Kreuzgasse', 'Konstanz', 'Mnrtenthor', 'Hirzel', 'Delsberg', 'Waldenburg', 'Toggenburg', 'Buchsee', 'Mantua', 'Schauenburg', 'Burgund', 'Tine', 'Holland', 'Waldeck', 'Lory', 'Napoleon', 'Jerusalem', 'Breisgau', 'Siebenthal', 'Utrecht', 'Gex', 'Valangin', 'Savoyer', 'Mellingen', 'Echallens', 'Pavia', 'Neckargan', 'Thonon', 'Schwaben', 'Luzern', 'Rapperswyl', 'Bipp', 'Sumiswald', 'Vincennes', 'Nydegg', 'Nhon', 'Biel', 'Cremona', 'Urschweiz', 'Hochberg', 'Hegau', 'Genf', 'Museum', 'Mendrisio', 'Grasburg', 'Bargen', 'Burghut', 'Schwyz', 'Brunnadern', 'Solothnrn', 'Wartberg', 'Nyon', 'Belpberg', 'Oberer Spital', 'Versoix', 'Zollikofen', 'Zugerberg', 'Waadtland', 'Berns', 'Oron', 'Navarra', 'Quesne', 'Sulgen', 'Staldcn', 'Trvme', 'Grauholz', 'Burgistein', 'Gerenstein', 'Nhdegg', 'Basel', 'Monza', 'Mannmberg', 'Rheinfelden', 'Moudon', 'Wiflisbnrg', 'Bernhardsberg', 'Nsgatifs', 'Nivau', 'Kramgasse', 'Aarau', 'Oesterreichs', 'Bellmund', 'Aurvra', 'Orleans', 'Brugg', 'Lemanjee', 'Turin', 'Grasfenried', 'Marzili', 'Emmenthal', 'Schinznach', 'Tarentaise', 'Richtessen', 'Ragaz', 'Othmarsingen', 'Langnau', 'Blamont', 'Constanz', 'Neapel', 'Berlin', 'Landshut', 'Genfs', 'Aarburgund', 'Genua', 'Oberhofen', 'Chillon', 'Frutigen', 'Savoycn', 'Waadt', 'Neuenburg', 'Rom', 'Aldingen', 'Kien', 'Schaffhausen', 'Unteraargau', 'Morsee', 'Jegistorf', 'Genfersee', 'Nieder', 'Thurgaus', 'Grandson', 'Bern', 'Thierstein', 'Nantes', 'Hollands', 'Wangen', 'Beatenberg', 'Biberstein', 'England', 'Landenberg', 'Eschenbach', 'Malplaquet', 'Aarbergergasse', 'Kirchenfeld', 'Aare', 'Wietlisbach', 'Unterseen', 'Montferrat', 'Saanenland', 'Saragossa', 'Rheinthal', 'Heinrich', 'Solothurn', 'Birs', 'Feldkirch', 'Bielersee', 'Rougemont', 'Neckargau', 'Gotthard', 'Tyrol', 'Thunerfees', 'Sondrio', 'Cromwell', 'Crousaz', 'Enghien', 'Ried', 'Wabern', 'Nidau', 'Neuenlmrgs', 'Montbovon', 'Lombardei', 'Bonmont', 'Wales', 'Glarus', 'Spanien', 'Indien', 'Duquesne', 'Franz', 'Aarburgnnd', 'Saone', 'Piemont', 'Neuenburgs', 'Hallwhl', 'Bnrgdorf', 'Thun', 'Heimberg', 'Vadian', 'Deutschland', 'Walensee', 'Amthausgasse', 'Tarentaife', 'Anhalt', 'Waldshut', 'Oberitalien', 'Leipzig', 'Wimmis', 'Wallis'}",441,"{'Schwellenmätteli', 'Oesterreichs Münsterthal', 'Neuenburg Murten', 'Röthenbach', 'Pestalozzi Heinrich', 'Weingarten Bendicht', 'Reichsburg', 'Stockhvrn', 'Burgdorf Laupen', 'Elsaß', 'Neuenburg Genf', 'St Johannfen', 'Unspunnen', 'Thun Dazu', 'Orbe Echallens', 'Bern Friburg', 'Leberberg Jura', 'Verona Versoix', 'Murten Grandson', 'Könitz', 'Wildegg Thüring', 'Dessau', 'Königsfelden Muri', 'Quesne Henri', 'Genua Gerbern', 'Salvenach Wyler', 'König Samuel', 'NiederSimmenthal', 'Schwarzmurer Felix Schwarzwald', 'Schwyz Schwyzer', 'Dornbühl', 'Bern Solotern', 'Schwaben Rudolf von Schwabenkricg', 'Veltlin Zürich', 'Nidau Strasberg', 'Beding', 'Neuenburgersee Neuenegg', 'Venner Tschachtlan', 'Chablais Genevois', 'Neuenstadt', 'Rougemont Rousseau', 'Henzivcrschwörung', 'Grüningen', 'Weißen Berg', 'Noth', 'Blutthnrm', 'Tafelfelde', 'Niederwall', 'Konolfingen', 'Dießenberg', 'Ramseierloch', 'Dorneck', 'Bipp Birs', 'Weißenbnrg', 'Weißland', 'Raron', 'Nydegg Nydeggbriicke Nydeggkirche Nymwegcn', 'Jnterlaken Oberhofen', 'Neuß', 'Bex Ollon', 'Heimath Reich', 'Wädischwhl Weißenburg', 'Der Käfichthnrm', 'Zürich', 'Mittelmeer', 'Kleine Schanze', 'Lunsville', 'Rüggisberg', 'Friesenberg Frieso Freudenberger', 'Mllßerkrieg', 'Karl', 'Meiringen ILi', 'Oberlande', 'Aubonne', 'Bärenmatte', 'Grünenberg', 'Nägeli Magdalena', 'Weingarten', 'Brünig', 'Der Graf', 'Die Burg', 'Cheneaux', 'Gümmiuen', 'Weißenan', 'Dänemark', 'Baselwind Diebold', 'Zürich Solothurn', 'Stüßi', 'Nassau Moritz', 'Metzgern Metzgernzunftkapelle', 'Basel Biet', 'Neuhaus Karl', 'Riggisberg Rüeggisberg Schwarzenbnrg', 'Zähringen', 'Urach', 'Franbrunnen', 'Daux Jsbrand', 'Zweisimmen', 'Blamont Blomont', 'Grimmenstein Grünenberg', 'Rathhaus', 'Mulhausen Elsaß', 'Gonzenbaäi', 'Justisthal', 'Pontarlier', 'Romont Rue', 'Waadt Canton', 'Aargau Lenzburg', '° 52', 'Keßlergasse', 'Dieser Suerschlncht', 'Graubünden', 'Römer Römisches Reich', 'Frutigen Oberhofen', 'München', 'Schöftland', 'Frankfurt Fränkli Fränkli', 'Nassau Adolf', 'Couch Couch Jngelram von Courtelary', 'Räthe', 'Aarwangen Bern', 'Münsters', 'Eidgenossen', 'Hanensteiu', 'Lützelflüh', 'Jurapässe', 'Römer', 'Bellegarde Laubeck', 'Dünz', 'Obergcrbern Oberhofen', 'Basel Aargau', 'St Jakob', 'Schwanden Schwarzer AdlerOrden', 'Den Dauphin', 'Tomingue', 'Crossaz', 'Könitz Bümplih', 'Seeland Waadtland', 'Dachselhofer Karl Gottlieb', 'Barfüßerkloster', 'Bern Oberland', 'Frutigen Ober', 'Standesrath', 'St Petrus St Petersinsel Quiquerez Auguste', 'Erlenbach Weißenburg', 'Frisching Karl Albrecht', 'Bürgisser Leonhard', 'Ouchy', 'Brunner Clevi Brunstadt Brusio', 'Wankdorf Worblaufen', 'Bnchsee Jegistors', 'Hcimberg Naher', 'Oesterreichcr', 'Christophel', 'Weißenau', 'Belp Bclpberg Benedictiner Benedictinerinnen', 'Bucheggberg Morgen', 'Christophelthurm', 'Frankreich Lugano', 'Hausen', 'England Kleine Schanze', 'Diemtigen', 'Büren Ludwig', 'Flüe', 'Solothurn Freiburg', 'Jnterlaken', 'Hugenotten', 'Burgdorf Thun', 'Bern Solothnrn', 'Monod Henri', 'Oberwyl', 'Jougne', 'Hotel Musique', 'Sigger', 'Dürig', 'GrandBois', 'Zwingli, SLOC', 'Uechtland Bärn', 'Conds der Feldherr', 'Frisching Frisching Peter Frisching Samuel', 'LauPen Bremgarten', 'Frienisberg AußerRhoden', 'Ney General', 'Därstetten', 'Oettingen', 'Burgdorf Oltigen', 'Münsingen', 'Davcl Abraham', 'Rümlingen Wabern', 'Moustiers', 'Schoßhalde', 'Montenach Belp', 'Friedrich', 'Oliälons', 'Rüderswyl', 'Tübingen', 'Monnier', 'Wappenthier', 'Diocletian', 'Ungarn Agrippa', 'Große Schanze', 'Dante Dänemark', 'Löwenberg', 'Thürme', 'Büttikon', 'Waadt Bern', 'Frickthal Friedrich III Kaiser Friedrich der Grosse König Preußen', 'Stäffis Bern', 'Bern Zürich', 'Dachselhofcr', 'Armagnac', 'Eidgenossenschaft', 'Bern Solothurn', 'Käfichthurm', 'Schauenburg Bern', 'Hofwyl', 'Harnischthurm', 'Talleyrand Auguste', 'Laupen Murten', 'Predigerkirche', 'Mohren Molidre', 'Luntenthnrm', 'Schnell Hans', 'Höwen', 'WaldHut', 'Leuenmatte', 'Güm', 'Schänzli', 'Göttingen', 'Weißenburg', 'Neus Nyon', 'Graubündeu', 'Näfels', 'Enge Engel Samuel', 'Val Ruz', 'bnrg', 'Mötzli', 'Büren', 'DornacherSchlacht', 'Bariüßer Franciskaner Bariüßerkirche', 'Französische Kirche Frastenz', 'Hochalpen', 'MuriStalden', 'Colmar Comersee', 'Brunegg Brünig', 'Unfpunnen', 'Obwaldcn', 'Weißeuburg', 'Rath', 'Mühldorf', 'Bremgarten Belp', 'Gibellinen Gingins', 'Meßmer', 'Mülhausen', 'Ludwig von Schöstland', 'Modena', 'Preußen', 'Looses', 'Xlll', 'Hallwil', 'Marienthal Marignano', 'Lemanifche Republik', 'Pruntrut Delsberg', 'SenfftPilsach', 'Bartholomäusnacht', 'Faubourg St Germain', 'Könitz Jura', 'Roßbach', 'Münster', 'Tralles Georg', 'Graubündens', 'Golattenmattgaß', 'Straßburg', 'AnhaltDessau', 'Dominicanerordens', 'Greifensee', 'Hartmaun', 'Ochsenfeld', 'Ungarn Königin Agnes', 'Ziirchersee Zurkinden Zurzach', 'Defensionale', 'Stein Brandolf', 'Bargen Bargenbrück Barthslemy Franyois', 'Grauholz Bern', 'Schwäbische Städte Schwäbischer Städtebund Schwaderloch', 'Provence Graf der Pauli', 'Unterthanen', 'St Gallen', 'Nydeggbrücke', 'Wimmis Thun', 'Schlettstadt Schliern Schmieden Schnell Samuel', 'Wolf Freiburg', 'Rapp', 'Zweibrücken', 'Mühldorf Mühlen der Aare', 'Nenziverschrvörung', 'Ostermundigen', 'Stein Hartmann', 'Große Räthe', 'Freiburg Breisgau', 'Hasle Lanpen', 'Balois', 'Zeughaus', 'Mirabeau Marquis', 'Cornwallis Richelieu', 'Königsfelden', 'Stellingen', 'Pruntrut Dekan Delsberg', 'Bdze Theodor', 'Eschen', 'Den Schwhzern', 'Zeughause', 'Gex giengen', 'Grandson Orbe', 'Hasle Welsen', 'Simmenthal Zweisimmen', 'König Karl VII Ludwig Dauphin Ludwig', 'Bern Schwyz', 'Glarus Freiburg', 'Lugano Locarno', 'Oberaargaus', 'Dießen', 'Achshalm Affen Gesellschaft', 'Freiamt', 'Zürichs', 'Seftigen', 'Greyerz Städtchen', 'Ringgcnberg', 'Patriciern', 'Rotenflnh', 'Brunnadern Brunner Caspar', 'Tscherlitz Echallens', 'Erlach Stift St Johannsen', 'Brüttelen', 'Bätterkinden', 'Charenton', 'Mandements', 'Rußland', 'Flachsland Flandern', 'Monod Froideville'}",340,"{'Weienau', 'Meggenberg', 'Lombach', 'Bauernkrieg', 'Leberberg', 'Worblausen', 'Mlhausen', 'Rmligen-Haus', 'Diebach', 'Kfichthurm', 'Aarinsel', 'Wyl', 'Zauggenried', 'Gromogul', 'Hans', 'Schwaderloch', 'Metzgern', '- tingen', 'Walliser', 'Bercelli', 'Mnsterthal', 'Hieronymus', 'Rtti Hans', 'Ptanta', 'Villars', 'Mnchen', 'Helvetik', 'Lauterburg', 'Habsbnrg', 'Aarbcrg', 'Obersiebenthal', 'Niklaus', 'Brunner', 'Barba', 'Rotenfluh', 'Michaelsinselkloster', 'Clevi', 'Wydenbosch', 'Maser', 'Knigreich', 'Sarganjerland', 'Brnig', 'Reggisberg', 'Schwanden', 'Johannitcr', 'Petersinsel', 'Gttingen', 'St. Urban', 'Plagen', 'burg-Kyburg', 'Bennewyl', 'Golattenmattgathurm', 'Bclpberg', 'Arow', 'Martertod', 'Pillichody', 'Wienercongre', 'Bren Ludwig', 'WLlinen', 'Tillier', 'Ringoltingcn', 'Habsburg.19', 'Schwarzenbnrg', 'Herzogenbuchsee', 'Weingarten Wolfgang', 'Westphalen', 'Auer-Rhoden', 'Bartholomusnacht', 'Ronchamps', 'Aelen', 'Grner', 'Winterthur', 'Dittlinger', 'Biet', 'St. Niklaus', 'Albemarle', 'Gener', 'Burgrecht', 'Hsricourt', 'Englisberg', 'Zurzach', 'Jost', 'Badstuberbrief', 'Elsa', 'Rodt', 'Diesbachcapelle', 'Benedig', 'Rudols', 'Nieder-Simmenthal', 'Thuring', 'Boner', 'Judcnthurm', 'Montmolian', 'Vivis', '- nachthal', 'Burg', 'Tscherlitz', 'Sebastians', 'Hetzel', '- Weimar', 'Hans Albrecht', 'Campobasso', 'Ruz', 'Stein Kaspar', 'Ludwig', 'Schenkenberg', 'Bnrgistein', 'Bay', 'Riigsau', 'Eins', 'Sand', 'Scharnach', 'Scharnachthal Konrad', 'Wittigkofen', 'Mn', 'Rued', 'Frundsbergs', 'Sachsen-Weimar Bernhard', 'Genevois', 'Castelen', 'Chablais', 'Rthenbach', 'Dnemark', 'nidow', 'Lindnach', 'Bongars', 'Calvin', 'Gallen', 'Jnn', 'Buchjee', 'Kanderthal', 'Notre', 'Conti', 'Sgern', 'lten', 'Habsburg-Khburg', 'Glarner', 'Sd', 'Hcimathland', 'Ochfenfeld', 'Aix', 'Augsburger', 'Zrcher', 'Halter', 'Barbarossa', 'Uri', 'Oester reich', 'Teglio', 'Gasser', 'Burkhart', 'Knitz', 'Habsburg', 'Mnster', '- land', 'Wiedertufer', 'Bonivard', 'Peterlingen', 'Ormonds', 'Muralt', 'Weien', 'Bervs', 'Scharnachthal Niklaus', 'Rossinisre', '- temberg-Mmpelgard', 'Zornig', 'Ollon', 'Wyler', 'Schstland', 'Zrichkrieg', 'Grningen', 'Aargauerstaldenj', 'Ost', 'Bnigen', 'Mnrien', 'Laufjenburg', 'Galerate', 'Pfunt', 'Briiggler', 'Wyden', 'Greijensee', 'Vincenz', 'Jnnocenz', 'Kranchthal', 'Vilmergcn', 'Gbcrlandes', 'Conds', 'Laufser', 'Morgarten', 'Liebegg', 'Obwalden', 'Mlhauseu', 'Binder', 'Schar', '- singen', 'Bechburg', 'Buffon', 'Leinan', 'Wysz', 'Jolantha', 'Knabenwaisenhaus', 'Nidwalden', '- tenach', 'Siebenthals', 'Wol', 'Gvllheim', 'Schnen', 'Rmerstal', 'Mittelland', 'Gerberngraben', 'Frauenthurm', 'Brge', 'Bielerinsel', 'Burgunderkrieg', 'Krauchthal', 'Nymwegen', 'Schftland', 'Kornhaus', 'Schnholz', 'Rheinach', 'Diokletian', 'Kelergasse', 'Schnfels', 'Judengasse', 'Strttlingen', 'Frank', 'Carignan', 'Thnrgau', 'Entlebuch', 'Gerbern', 'Spital', 'Farel', 'Arnoud', 'Plappartkrieg', 'Zeitglockenthurm', 'Jordan', 'Biimplitz', 'Heudorf', 'Oberrhein', 'West Nord', 'Senf', 'Vienne', 'Ochsenbein', 'Johann', 'Ziirchersee', 'Winkelried', '^', 'Ringol', 'Gens', 'Gysenstein', 'Marias', 'Adrian', 'Manncnberg', 'Minoriten', 'Frisching', 'Stein Georg', 'March', 'Egerten', 'Dnz', 'Vilmergerkrieg', 'Weienan', 'Rolle', 'Bwlin', 'Caspar', 'Todtentanz', 'Waldsttte', 'Oekolampad', 'Darob', 'Bren', 'Niederer', 'Dornbhl', 'Stockhorn', 'Hcimberg', 'Trsme', 'Friesenberg', 'Fclsenbnrg', 'Baselwind', 'Jeremias', 'Corning', 'Argun', 'Gllheim', 'Binders', 'Trb', 'Carls', 'Lykurg', 'Muhleren', 'Drucklibund', 'Erlach Rudolf', 'Aigle', 'Gldli', 'Leut-Kirche', 'Allmendingen', 'Metzgernzunftkapelle', 'Jtal', 'Bernern', 'Siggcr', 'Baldegg', 'Rmlingen', 'Oranien', 'Wettstein', 'Uechtland', 'Wettingen', 'Zenghausgasse', 'Couch', 'Bellenz', 'Bartlome', 'Crest', 'Emme', 'Wrt', 'Faubourg', 'Tschachtlan', 'Niedersicbenthal', 'Blomont', 'Hwen', 'Ulrich', 'Orbe', 'Effinger', 'Barferkloster', '- bnrg', 'Aberli', 'Schotzhalde', 'Schohalde', 'Surfee', 'Granson', 'Micheli', 'Hotrs-Uurns', 'Ludlows', 'Thuner', 'Pariserbluthochzeit', 'Pilgrim', 'Badstuber', 'Stsfis', 'Klosterhof', 'Bulle', 'Karls', 'Thomas', 'Grnenberg', 'Brandis', 'Juukerngasse', 'Bellinzona', 'Bnden', 'Frei', 'Unterwaldeu', 'Erlach Hans', 'Frieso', 'Freudenberger', 'Reichsland', 'Pfalz', 'Nancy', 'Neus', 'Petersinsel Bielersee', 'Rmligen', 'Ulmitz', 'Egerden', 'Saauen', 'Toggenburgerkrieg', 'Sorbonne', 'Aargaucrstalden', 'Leim', 'Obergcrbern', 'Mnsters', 'Hochburgund', 'Alba', 'Rousseau', 'Savoher', 'Chambry', 'Rchag', 'Brandts', 'Klzi', 'Habsbur', 'Bargenbrck', 'Grnenbcrg', 'Sogcrn-Seedorf', 'Oesterrich', 'Belp', 'Ballaigues', 'Barthslemy', 'Grand-Bois', 'Wildegg', 'Laurenz', 'Sachsen-Weimar', 'Matthus', 'Fricker', 'Bubeuberg', 'Waldenser', '- burg', 'Cisterzienser', 'Drstetten', 'Sogern-Seedorf', 'Romvnt', 'Brune', 'Lothar', 'Boken', 'Milden', 'Rggisberg', 'Graubnden', 'Tbingen', 'Reggs', 'Hain', 'Reu', 'Hagenbach', 'Bern.', 'Lanzenstein', 'Sterchi', 'Aurora', 'Peterlingeu', 'Cervola', 'Kybnrg', 'Knig', 'Britten', 'Mvrsee', 'Unitarier', 'Watt', 'Heidegger', 'Hoch', 'Julia', 'Livinenthal', 'Kruthen', 'Venncr', 'Sonnenberg', 'Loins', 'Rhonethal', 'Donnerbhl', 'Gatschet', '-', 'Bern.185', 'Dominicanerkloster', 'Jammerthal', 'Aarauer', 'Alkazena', 'Pverdonl', 'Zwingli', 'Drig', 'Lautrer', 'Bund', 'Hasler', 'Wurstemberger', 'Hochbnrgund', 'MUnsterkuchc', 'Kleinburgund', 'Konrad', 'Margaretha', 'Ougspurger', 'Guglcrn', 'Goldener', 'Burkhard', 'Brandolf', 'Wyken', 'Freiburger', 'Mllerkrieg', 'Schwabenkricg', 'Rcu', 'Muristalden', 'Dieen', 'Geltenhals', 'Wohlen', 'Schrn', 'Zwlserkrieg, ', 'St. Germain', 'Wrttembcrg-Miimpelgard', 'Anton', 'Comersee', 'Schlettstadt', 'Straburg', 'Orleans-Longueville', 'Dittlingerthurm', 'Brnigs', 'Murifeldvertrag', 'Wiinmis', 'Koppigeu', 'Engel Engelberg', 'Graubndeu', 'Ober', 'Aarufer', '- gau', 'Pfaffenbries', 'Musso', 'Luzerns', 'Walden', 'Frickthal', 'Christen', 'Regg', 'Jolanthas', 'Stecklikrieg', 'Bayern', 'Preuen', 'Mnstcrthal', 'Varicourt', 'Ergw', 'Tfcharner', 'Enge', '- berg', 'St.', 'Diftelzwang', 'Wankdorf', 'Darnach', 'Wyttenbach', 'Olilons', 'Mon', 'Lauterbrunnen', 'Langetenthal', 'Senfft-Pilsach', 'Russen', 'Rderswyl', 'Gerbernpromenade', 'Moritz', 'Weienbnrg', 'Zhringen', 'Ueberlingcn', 'Schtzen', 'St. Johannfen', 'Rothes', 'Ney', 'Achshalm', 'Zwinglis', 'Peyerlant', 'Sebastian', 'Robach', 'Neding', 'Tentenberg', 'Luxemburg', 'Taselfeld', 'Diebold', 'Orlouim-IiONKukviUs', 'Jvhannsen', 'Prattelen', 'Erlisburg', 'Iverdon', 'sterich', 'Gnininoii', 'Ensinger', 'Birsinsel', 'Schnzli', 'Dderlein', 'Brentzikoser', 'Lorenz', 'Bell', 'Leuxingen', 'brg', 'Mnsingen', 'Suze', 'Venner', 'Sense', 'Ltzelsth', 'Khbnrg', 'Locarno', 'Groherzoge', 'Brunstadt', 'Grimmenstein', 'Nothenburg', 'Franyois', 'Ltzelflh', 'Johannsen', 'Condo', 'Bdze', 'Schmieden', 'Jrstenberg', 'Salis', 'Schwyzer', 'Michaelsinsel', 'Lunoville', 'Theodor', 'Estavayer', 'Niedersiebenthal', 'Rgsau', 'Kyburgs', 'Burgdors', 'Namseierloch', 'Lausfenburg', 'Frstenberg', 'Willading', 'Bonaparte', 'Saugern', 'Niedergerbern', 'Savoyen-Romont', 'Alliirte', 'Strasberg', 'Schwhz', 'Louis', 'Kiesen', 'Bucheggberg', 'Brattelen', 'Jrg', '- husen', 'Lemanifche', 'Munfeld', 'Gravifeth', 'Zrichs', 'Gonzenbai', 'Medici', 'Oberwhl', 'Rebleute', 'Weieuburg', '- bach', 'Grasfenried Niklaus', 'Borromeischcr', 'Aarburguud', 'Hewen', 'Thuru', 'Mhldorf', 'Nidan', 'Tfchudi', 'Heilig-Geist-Kirche', 'Kantons', 'Vilmergen', 'Amsoldingen', 'Marquart', 'Rehag', 'Bnchsee', 'Graubndens', 'Berner', 'Marzilithor', 'Trouillat', 'Murren', 'Rothenburg', 'Kaspar', 'Berchtolds', 'Voltaire', 'Dieenberg', 'Osterbuch', 'wirtenberg', 'Neuhaus', 'Luc', 'Colmar', 'Prcdigerkloster', 'Funkhuser', 'Courtelary', 'Berchtold', 'Sogern', 'Neu', 'Planta', 'Anhalt-Dessau', 'Mansberg', 'Fran', 'Schinner', 'Sin land', 'Divis', 'Zrich', 'Heimbcrg', 'Wartburg', 'Aenenbnrg', 'Wurstembergerthurm', 'Lazariter', 'Sitten', 'Beru', 'Bondeli', 'Burgunn', 'Galgenhubel', 'Casinoplatz', 'Rott', 'Roverea', 'Viel', 'Wolfhard', 'Wildhans', 'Hans Rudols', 'Arth', 'Frastenz', 'Gugler', 'Weiland', 'Waldsttten', 'Ruland', 'Wattenwyl', 'Ringoltingen', '- thurn', 'Schnenwerth', 'Weienburg', 'Rudolf', 'Nydeggbriicke', 'Peter Krnthen', 'Rhcinfclden', 'Weien Berg', 'Stift', 'Friburg', 'Thiiring', 'Philipp', 'Stein Jakob', 'Montfaucon', 'Word', 'Quiquerez', 'Staus', 'Stettlen', 'Bmplitz', 'Akademie', 'Morges', 'Walo', 'Jth', 'Gregor', 'Copvet', 'Freudenreich', 'Christophelihurm', 'Consulta', 'St. Martin', 'Normandie', 'Peter', 'Waadt.118', 'Kirchenseld', 'Laubeck', 'Parricida', 'Albrecht', 'Wittigkosen', 'Seedorf', 'Habkesjen', 'Calven', 'Bmplih', 'Leonhard', 'Lichterschein', '- thal', 'Brcken', 'Bttikon', 'peyerlant', 'Romainmotier', 'Winterthnr', 'Glayre', 'Aeschi', 'Gaudot', 'Richelieu', '- Simmenthal', 'Wiener', 'Wattenwhl', 'Amphalissa', 'Schlo', 'Leman', 'Cornwallis', 'burg-Kybnrg', 'Riggisberg', 'Blankenburg', 'Bnbenberg', 'Scharnachthal Franz', 'Schliern', 'St. Jakob', 'Wlflein', 'Brcngraben', 'Nydeggbrcke', 'Erlach Ulrich', 'Rssegg', '- reich', 'Solo', 'Lwenberg', 'Murifelde', 'Lesdiguisres', 'Mlinen', 'Oltigen', 'Mnchenbuchsee', 'Urner', 'Konra', 'Frnkli', 'Walcnsee', 'Karolinger', 'Valois', 'Brttelen', 'Mengaud', 'Hermann', 'Schweizer', 'Schilling', 'Kyburger', 'Hohenstaufen', 'Orlsans', 'Kanton', 'Prior', 'Teutsch', 'Vincenzkirche', 'Habsburg-Lanfenburg', 'Canton', 'Kyburg.27', 'Bernermarsch', 'Balmoos', 'Sittenmandat', 'Franken', 'Brggler', 'Leiber', 'Sins', 'Solothuru', 'Dante', 'Jakob', 'Bruderholz', 'Freiburgern', 'Grosse', 'Sigisnmnd', 'Polier', 'Moden', 'Werdt', 'Watteuwyl', 'Subannerzug', 'Urban', 'Trachsel', 'Brunegg', 'Rottweil', 'Sachsen', 'Gramont', 'Barierkirche', 'Aarwangen', 'Barier', 'Salvenach', 'Clewi', 'Balm Peter', 'Nymwegcn', 'Bellegarde', 'Amadeus', 'Labsburg', 'Wirtenberg', 'Rumisberg', 'Murminen', 'Emmcnthal', 'Breitfeld', '- mund', 'Sonnen', 'Rohan', 'Petrus', 'Bhl', 'Milot', 'Wolshard', 'Virch', 'Franciscancr', 'Kortm', 'Knigsfelden', 'Hitzig', 'Ermatingen', 'Flachsland', 'Laupcn', 'Ochs', 'Wyhan', 'Rechberg', 'Morste', 'St. Gallen', 'Seliger', 'Nuu', 'Livinerthal', 'Zhringer', 'Bex', 'Thring', 'Ungern', 'Barde', 'Tichachtlan', 'Faucignh'}",833,"{'Oesterreichs Münsterthal', 'Bauernkrieg', 'Leberberg', 'Neuenburg Murten', 'Worblausen', 'Rmligen-Haus', 'Diebach', 'Aarinsel', 'Röthenbach', 'Weingarten Bendicht', 'Gromogul', 'Reichsburg', 'Elsaß', 'Neuenburg Genf', '- tingen', 'St Johannfen', 'Mnchen', 'Helvetik', 'Thun Dazu', 'Aarbcrg', 'Niklaus', 'Verona Versoix', 'Murten Grandson', 'Rotenfluh', 'Wildegg Thüring', 'Clevi', 'Knigreich', 'Sarganjerland', 'Reggisberg', 'Genua Gerbern', 'König Samuel', 'St. Urban', 'Plagen', 'NiederSimmenthal', 'Bclpberg', 'Schwarzmurer Felix Schwarzwald', 'Schwyz Schwyzer', 'Dornbühl', 'Pillichody', 'Tillier', 'Westphalen', 'Ronchamps', 'Veltlin Zürich', 'Winterthur', 'Nidau Strasberg', 'Dittlinger', 'Biet', 'St. Niklaus', 'Albemarle', 'Gener', 'Beding', 'Venner Tschachtlan', 'Jost', 'Badstuberbrief', 'Elsa', 'Diesbachcapelle', 'Chablais Genevois', 'Benedig', 'Rudols', 'Nieder-Simmenthal', 'Thuring', 'Rougemont Rousseau', 'Montmolian', 'Vivis', 'Weißen Berg', '- nachthal', 'Tscherlitz', 'Sebastians', '- Weimar', 'Noth', 'Hans Albrecht', 'Campobasso', 'Tafelfelde', 'Ruz', 'Stein Kaspar', 'Schenkenberg', 'Niederwall', 'Bay', 'Dorneck', 'Scharnach', 'Eins', 'Sand', 'Bipp Birs', 'Scharnachthal Konrad', 'Wittigkofen', 'Mn', 'Genevois', 'Castelen', 'Chablais', 'Nydegg Nydeggbriicke Nydeggkirche Nymwegcn', 'Dnemark', 'nidow', 'Lindnach', 'Calvin', 'Jnn', 'Buchjee', 'Bex Ollon', 'Notre', 'Heimath Reich', 'Habsburg-Khburg', 'lten', 'Sd', 'Glarner', 'Hcimathland', 'Augsburger', 'Mittelmeer', 'Barbarossa', 'Uri', 'Teglio', 'Burkhart', 'Kleine Schanze', 'Lunsville', 'Rüggisberg', 'Mnster', '- land', 'Wiedertufer', 'Mllßerkrieg', 'Ormonds', 'Meiringen ILi', 'Oberlande', 'Aubonne', '- temberg-Mmpelgard', 'Bärenmatte', 'Brünig', 'Der Graf', 'Ollon', 'Die Burg', 'Aargauerstaldenj', 'Bnigen', 'Briiggler', 'Weißenan', 'Vincenz', 'Dänemark', 'Baselwind Diebold', 'Jnnocenz', 'Kranchthal', 'Vilmergcn', 'Zürich Solothurn', 'Conds', 'Stüßi', 'Morgarten', 'Liebegg', 'Obwalden', 'Neuhaus Karl', 'Mlhauseu', 'Urach', 'Schar', 'Daux Jsbrand', '- singen', 'Buffon', 'Wysz', 'Jolantha', 'Knabenwaisenhaus', 'Nidwalden', 'Zweisimmen', 'Siebenthals', 'Wol', 'Gvllheim', 'Brge', 'Bielerinsel', 'Krauchthal', 'Nymwegen', 'Schftland', 'Kornhaus', 'Diokletian', 'Kelergasse', 'Schnfels', 'Grimmenstein Grünenberg', 'Judengasse', 'Carignan', 'Gerbern', 'Gonzenbaäi', 'Farel', 'Plappartkrieg', 'Pontarlier', 'West Nord', 'Senf', 'Waadt Canton', 'Johann', 'Ziirchersee', '^', 'Ringol', 'Adrian', 'Minoriten', 'Römer Römisches Reich', 'Stein Georg', 'March', 'Vilmergerkrieg', 'Weienan', 'Rolle', 'Bwlin', 'Schöftland', 'Caspar', 'Todtentanz', 'München', 'Oekolampad', 'Bren', 'Frankfurt Fränkli Fränkli', 'Stockhorn', 'Hcimberg', 'Nassau Adolf', 'Trsme', 'Baselwind', 'Jeremias', 'Corning', 'Räthe', 'Argun', 'Münsters', 'Hanensteiu', 'Jurapässe', 'Lykurg', 'Römer', 'Drucklibund', 'Erlach Rudolf', 'Gldli', 'Allmendingen', 'Metzgernzunftkapelle', 'Jtal', 'Bernern', 'St Jakob', 'Baldegg', 'Oranien', 'Wettstein', 'Couch', 'Emme', 'Tschachtlan', 'Crossaz', 'Niedersicbenthal', 'Blomont', 'Ulrich', 'Könitz Bümplih', 'Schotzhalde', 'Schohalde', 'Barfüßerkloster', 'Surfee', 'Granson', 'Ludlows', 'Thuner', 'Pilgrim', 'Badstuber', 'Klosterhof', 'Bulle', 'Frutigen Ober', 'Karls', 'Standesrath', 'Bnden', 'Brandis', 'Bellinzona', 'Erlenbach Weißenburg', 'Reichsland', 'Ouchy', 'Rmligen', 'Egerden', 'Obergcrbern', 'Hochburgund', 'Oesterreichcr', 'Rousseau', 'Christophel', 'Rchag', 'Brandts', 'Belp Bclpberg Benedictiner Benedictinerinnen', 'Habsbur', 'Bucheggberg Morgen', 'Belp', 'Christophelthurm', 'Grand-Bois', 'Wildegg', 'Diemtigen', 'Laurenz', 'Solothurn Freiburg', 'Matthus', 'Waldenser', 'Cisterzienser', 'Drstetten', 'Burgdorf Thun', 'Sogern-Seedorf', 'Rggisberg', 'Tbingen', 'Reu', 'Bern.', 'Oberwyl', 'Jougne', 'Aurora', 'Knig', 'Britten', 'Sigger', 'Dürig', 'Unitarier', 'GrandBois', 'Watt', 'Livinenthal', 'Sonnenberg', 'Uechtland Bärn', 'Loins', 'Conds der Feldherr', 'Rhonethal', '-', 'Jammerthal', 'Aarauer', 'Lautrer', 'Bund', 'Hasler', 'Wurstemberger', 'Hochbnrgund', 'Kleinburgund', 'Ougspurger', 'Därstetten', 'Guglcrn', 'Goldener', 'Burkhard', 'Brandolf', 'Wyken', 'Freiburger', 'Oettingen', 'Schwabenkricg', 'Rcu', 'Dieen', 'Schrn', 'Burgdorf Oltigen', 'Zwlserkrieg, ', 'St. Germain', 'Münsingen', 'Wrttembcrg-Miimpelgard', 'Davcl Abraham', 'Straburg', 'Orleans-Longueville', 'Brnigs', 'Aarufer', 'Graubndeu', 'Ober', '- gau', 'Pfaffenbries', 'Friedrich', 'Frickthal', 'Jolanthas', 'Stecklikrieg', 'Bayern', 'Preuen', 'Varicourt', 'Ergw', '- berg', 'Diftelzwang', 'Wankdorf', 'Wyttenbach', 'Olilons', 'Lauterbrunnen', 'Langetenthal', 'Weienbnrg', 'Waadt Bern', 'Rothes', 'Ney', 'Achshalm', 'Zwinglis', 'Neding', 'Tentenberg', 'Luxemburg', 'Taselfeld', 'Dachselhofcr', 'sterich', 'Armagnac', 'Birsinsel', 'Schnzli', 'Eidgenossenschaft', 'Bern Solothurn', 'Lorenz', 'Leuxingen', 'brg', 'Bell', 'Hofwyl', 'Venner', 'Talleyrand Auguste', 'Ltzelsth', 'Khbnrg', 'Laupen Murten', 'Brunstadt', 'Grimmenstein', 'Nothenburg', 'Franyois', 'Johannsen', 'Condo', 'Schmieden', 'Predigerkirche', 'Jrstenberg', 'Mohren Molidre', 'Salis', 'Luntenthnrm', 'Michaelsinsel', 'Schnell Hans', 'Lunoville', 'WaldHut', 'Leuenmatte', 'Rgsau', 'Kyburgs', 'Burgdors', 'Güm', 'Schänzli', 'Willading', 'Göttingen', 'Alliirte', 'Graubündeu', 'Näfels', 'Schwhz', 'Louis', 'Kiesen', 'Bucheggberg', 'Brattelen', 'Val Ruz', 'Lemanifche', 'Munfeld', 'Mötzli', 'Gravifeth', 'Zrichs', 'Gonzenbai', 'Büren', 'Bariüßer Franciskaner Bariüßerkirche', 'Hochalpen', 'Grasfenried Niklaus', 'Hewen', 'Mhldorf', 'MuriStalden', 'Tfchudi', 'Kantons', 'Colmar Comersee', 'Marquart', 'Brunegg Brünig', 'Graubndens', 'Berner', 'Trouillat', 'Rothenburg', 'Obwaldcn', 'Berchtolds', 'Kaspar', 'Voltaire', 'Osterbuch', 'Neuhaus', 'Luc', 'Colmar', 'Prcdigerkloster', 'Funkhuser', 'Bremgarten Belp', 'Sogern', 'Planta', 'Fran', 'Divis', 'Preußen', 'Looses', 'Zrich', 'Heimbcrg', 'Aenenbnrg', 'Lazariter', 'Galgenhubel', 'Xlll', 'Hallwil', 'Rott', 'Roverea', 'Lemanifche Republik', 'Wildhans', 'Hans Rudols', 'Frastenz', 'Weiland', 'Waldsttten', 'Pruntrut Delsberg', 'Wattenwyl', 'Bartholomäusnacht', 'Ringoltingen', 'Schnenwerth', 'Weienburg', 'Rudolf', 'Nydeggbriicke', 'Peter Krnthen', 'Stift', 'Thiiring', 'Friburg', 'Philipp', 'Münster', 'Word', 'Tralles Georg', 'Staus', 'Stettlen', 'Bmplitz', 'Akademie', 'Gregor', 'Copvet', 'Freudenreich', 'Consulta', 'AnhaltDessau', 'Dominicanerordens', 'Normandie', 'Ochsenfeld', 'Albrecht', 'Calven', 'Bmplih', 'Leonhard', 'Lichterschein', '- thal', 'Ziirchersee Zurkinden Zurzach', 'Brcken', 'Defensionale', 'peyerlant', 'Romainmotier', 'Aeschi', 'Gaudot', 'Schwäbische Städte Schwäbischer Städtebund Schwaderloch', 'Provence Graf der Pauli', 'Unterthanen', 'Wattenwhl', 'Schlo', 'Leman', 'Cornwallis', 'burg-Kybnrg', 'Nydeggbrücke', 'Bnbenberg', 'Scharnachthal Franz', 'Schliern', 'Wlflein', 'Schlettstadt Schliern Schmieden Schnell Samuel', 'Wolf Freiburg', 'Erlach Ulrich', 'Rapp', '- reich', 'Solo', 'Lesdiguisres', 'Mlinen', 'Oltigen', 'Hasle Lanpen', 'Mnchenbuchsee', 'Konra', 'Frnkli', 'Karolinger', 'Valois', 'Brttelen', 'Hohenstaufen', 'Orlsans', 'Prior', 'Vincenzkirche', 'Habsburg-Lanfenburg', 'Stellingen', 'Kyburg.27', 'Balmoos', 'Sittenmandat', 'Brggler', 'Leiber', 'Bdze Theodor', 'Solothuru', 'Jakob', 'Bruderholz', 'Freiburgern', 'Grosse', 'Sigisnmnd', 'Polier', 'Den Schwhzern', 'Werdt', 'Watteuwyl', 'Urban', 'Zeughause', 'Gex giengen', 'Sachsen', 'Barierkirche', 'Bern Schwyz', 'Barier', 'Salvenach', 'Clewi', 'Nymwegcn', 'Amadeus', 'Rumisberg', 'Achshalm Affen Gesellschaft', 'Murminen', 'Emmcnthal', '- mund', 'Zürichs', 'Rohan', 'Wolshard', 'Virch', 'Kortm', 'Patriciern', 'Flachsland', 'Rotenflnh', 'Ochs', 'Brunnadern Brunner Caspar', 'Wyhan', 'Brüttelen', 'St. Gallen', 'Seliger', 'Livinerthal', 'Zhringer', 'Charenton', 'Mandements', 'Flachsland Flandern', 'Ungern', 'Tichachtlan', 'Schwellenmätteli', 'Weienau', 'Meggenberg', 'Lombach', 'Mlhausen', 'Kfichthurm', 'Wyl', 'Pestalozzi Heinrich', 'Zauggenried', 'Hans', 'Schwaderloch', 'Stockhvrn', 'Metzgern', 'Burgdorf Laupen', 'Walliser', 'Bercelli', 'Mnsterthal', 'Hieronymus', 'Rtti Hans', 'Ptanta', 'Villars', 'Unspunnen', 'Lauterburg', 'Orbe Echallens', 'Habsbnrg', 'Obersiebenthal', 'Bern Friburg', 'Leberberg Jura', 'Brunner', 'Barba', 'Michaelsinselkloster', 'Könitz', 'Wydenbosch', 'Dessau', 'Maser', 'Brnig', 'Schwanden', 'Königsfelden Muri', 'Johannitcr', 'Quesne Henri', 'Petersinsel', 'Gttingen', 'Salvenach Wyler', 'burg-Kyburg', 'Bennewyl', 'Golattenmattgathurm', 'Arow', 'Martertod', 'Wienercongre', 'Bren Ludwig', 'WLlinen', 'Ringoltingcn', 'Bern Solotern', 'Schwaben Rudolf von Schwabenkricg', 'Habsburg.19', 'Schwarzenbnrg', 'Herzogenbuchsee', 'Weingarten Wolfgang', 'Auer-Rhoden', 'Bartholomusnacht', 'Aelen', 'Grner', 'Burgrecht', 'Neuenburgersee Neuenegg', 'Hsricourt', 'Englisberg', 'Zurzach', 'Rodt', 'Neuenstadt', 'Boner', 'Judcnthurm', 'Henzivcrschwörung', 'Grüningen', 'Burg', 'Hetzel', 'Blutthnrm', 'Ludwig', 'Bnrgistein', 'Konolfingen', 'Dießenberg', 'Ramseierloch', 'Riigsau', 'Weißenbnrg', 'Rued', 'Weißland', 'Frundsbergs', 'Raron', 'Sachsen-Weimar Bernhard', 'Rthenbach', 'Jnterlaken Oberhofen', 'Bongars', 'Gallen', 'Neuß', 'Kanderthal', 'Conti', 'Sgern', 'Ochfenfeld', 'Wädischwhl Weißenburg', 'Der Käfichthnrm', 'Aix', 'Zürich', 'Zrcher', 'Halter', 'Oester reich', 'Gasser', 'Knitz', 'Habsburg', 'Friesenberg Frieso Freudenberger', 'Bonivard', 'Karl', 'Peterlingen', 'Muralt', 'Weien', 'Bervs', 'Scharnachthal Niklaus', 'Rossinisre', 'Grünenberg', 'Nägeli Magdalena', 'Zornig', 'Weingarten', 'Wyler', 'Schstland', 'Zrichkrieg', 'Grningen', 'Cheneaux', 'Ost', 'Mnrien', 'Laufjenburg', 'Galerate', 'Pfunt', 'Greijensee', 'Wyden', 'Gümmiuen', 'Gbcrlandes', 'Laufser', 'Nassau Moritz', 'Metzgern Metzgernzunftkapelle', 'Basel Biet', 'Riggisberg Rüeggisberg Schwarzenbnrg', 'Zähringen', 'Franbrunnen', 'Binder', 'Bechburg', 'Leinan', '- tenach', 'Schnen', 'Rmerstal', 'Mittelland', 'Gerberngraben', 'Frauenthurm', 'Burgunderkrieg', 'Blamont Blomont', 'Schnholz', 'Rheinach', 'Rathhaus', 'Strttlingen', 'Frank', 'Thnrgau', 'Entlebuch', 'Mulhausen Elsaß', 'Spital', 'Arnoud', 'Zeitglockenthurm', 'Justisthal', 'Jordan', 'Biimplitz', 'Heudorf', 'Oberrhein', 'Vienne', 'Romont Rue', 'Ochsenbein', 'Winkelried', 'Aargau Lenzburg', '° 52', 'Keßlergasse', 'Gens', 'Dieser Suerschlncht', 'Gysenstein', 'Marias', 'Graubünden', 'Manncnberg', 'Frisching', 'Frutigen Oberhofen', 'Egerten', 'Dnz', 'Waldsttte', 'Darob', 'Niederer', 'Dornbhl', 'Friesenberg', 'Fclsenbnrg', 'Couch Couch Jngelram von Courtelary', 'Aarwangen Bern', 'Eidgenossen', 'Gllheim', 'Binders', 'Trb', 'Carls', 'Lützelflüh', 'Bellegarde Laubeck', 'Muhleren', 'Dünz', 'Aigle', 'Leut-Kirche', 'Obergcrbern Oberhofen', 'Basel Aargau', 'Siggcr', 'Rmlingen', 'Schwanden Schwarzer AdlerOrden', 'Uechtland', 'Wettingen', 'Den Dauphin', 'Zenghausgasse', 'Bellenz', 'Tomingue', 'Bartlome', 'Crest', 'Wrt', 'Faubourg', 'Hwen', 'Orbe', 'Effinger', 'Barferkloster', '- bnrg', 'Aberli', 'Seeland Waadtland', 'Dachselhofer Karl Gottlieb', 'Micheli', 'Hotrs-Uurns', 'Pariserbluthochzeit', 'Stsfis', 'Bern Oberland', 'Thomas', 'Grnenberg', 'Juukerngasse', 'Frei', 'St Petrus St Petersinsel Quiquerez Auguste', 'Unterwaldeu', 'Erlach Hans', 'Frisching Karl Albrecht', 'Frieso', 'Bürgisser Leonhard', 'Freudenberger', 'Pfalz', 'Nancy', 'Neus', 'Petersinsel Bielersee', 'Brunner Clevi Brunstadt Brusio', 'Wankdorf Worblaufen', 'Ulmitz', 'Saauen', 'Toggenburgerkrieg', 'Sorbonne', 'Aargaucrstalden', 'Leim', 'Bnchsee Jegistors', 'Hcimberg Naher', 'Mnsters', 'Alba', 'Savoher', 'Chambry', 'Weißenau', 'Klzi', 'Bargenbrck', 'Grnenbcrg', 'Sogcrn-Seedorf', 'Oesterrich', 'Ballaigues', 'Barthslemy', 'Frankreich Lugano', 'Hausen', 'England Kleine Schanze', 'Sachsen-Weimar', 'Büren Ludwig', 'Flüe', 'Fricker', 'Bubeuberg', '- burg', 'Jnterlaken', 'Hugenotten', 'Romvnt', 'Brune', 'Bern Solothnrn', 'Lothar', 'Boken', 'Milden', 'Graubnden', 'Monod Henri', 'Reggs', 'Hain', 'Hagenbach', 'Lanzenstein', 'Sterchi', 'Peterlingeu', 'Cervola', 'Kybnrg', 'Hotel Musique', 'Mvrsee', 'Heidegger', 'Hoch', 'Zwingli, SLOC', 'Julia', 'Kruthen', 'Venncr', 'Frisching Frisching Peter Frisching Samuel', 'Donnerbhl', 'Gatschet', 'Bern.185', 'Dominicanerkloster', 'Alkazena', 'Pverdonl', 'Zwingli', 'Drig', 'LauPen Bremgarten', 'Frienisberg AußerRhoden', 'MUnsterkuchc', 'Konrad', 'Margaretha', 'Ney General', 'Mllerkrieg', 'Muristalden', 'Geltenhals', 'Wohlen', 'Anton', 'Comersee', 'Rümlingen Wabern', 'Schlettstadt', 'Moustiers', 'Dittlingerthurm', 'Murifeldvertrag', 'Schoßhalde', 'Wiinmis', 'Koppigeu', 'Engel Engelberg', 'Montenach Belp', 'Musso', 'Luzerns', 'Walden', 'Christen', 'Regg', 'Oliälons', 'Rüderswyl', 'Tübingen', 'Mnstcrthal', 'Tfcharner', 'Monnier', 'Enge', 'St.', 'Wappenthier', 'Diocletian', 'Darnach', 'Ungarn Agrippa', 'Große Schanze', 'Dante Dänemark', 'Löwenberg', 'Mon', 'Thürme', 'Senfft-Pilsach', 'Russen', 'Büttikon', 'Rderswyl', 'Gerbernpromenade', 'Moritz', 'Zhringen', 'Ueberlingcn', 'Frickthal Friedrich III Kaiser Friedrich der Grosse König Preußen', 'Schtzen', 'St. Johannfen', 'Stäffis Bern', 'Peyerlant', 'Sebastian', 'Robach', 'Bern Zürich', 'Diebold', 'Orlouim-IiONKukviUs', 'Jvhannsen', 'Prattelen', 'Erlisburg', 'Iverdon', 'Gnininoii', 'Ensinger', 'Dderlein', 'Brentzikoser', 'Mnsingen', 'Käfichthurm', 'Suze', 'Schauenburg Bern', 'Harnischthurm', 'Sense', 'Locarno', 'Groherzoge', 'Ltzelflh', 'Bdze', 'Schwyzer', 'Theodor', 'Estavayer', 'Niedersiebenthal', 'Höwen', 'Namseierloch', 'Frstenberg', 'Lausfenburg', 'Bonaparte', 'Saugern', 'Weißenburg', 'Niedergerbern', 'Savoyen-Romont', 'Neus Nyon', 'Enge Engel Samuel', 'Strasberg', 'Jrg', '- husen', 'bnrg', 'Medici', 'Oberwhl', 'Rebleute', 'DornacherSchlacht', 'Französische Kirche Frastenz', 'Weieuburg', '- bach', 'Borromeischcr', 'Aarburguud', 'Thuru', 'Nidan', 'Heilig-Geist-Kirche', 'Vilmergen', 'Amsoldingen', 'Rehag', 'Bnchsee', 'Marzilithor', 'Unfpunnen', 'Murren', 'Weißeuburg', 'Dieenberg', 'wirtenberg', 'Rath', 'Courtelary', 'Mühldorf', 'Berchtold', 'Gibellinen Gingins', 'Neu', 'Meßmer', 'Anhalt-Dessau', 'Mansberg', 'Schinner', 'Mülhausen', 'Ludwig von Schöstland', 'Modena', 'Sin land', 'Wartburg', 'Wurstembergerthurm', 'Sitten', 'Beru', 'Bondeli', 'Burgunn', 'Casinoplatz', 'Marienthal Marignano', 'Viel', 'Wolfhard', 'Arth', 'Gugler', 'Ruland', 'SenfftPilsach', 'Faubourg St Germain', '- thurn', 'Könitz Jura', 'Rhcinfclden', 'Roßbach', 'Stein Jakob', 'Montfaucon', 'Quiquerez', 'Graubündens', 'Morges', 'Walo', 'Jth', 'Christophelihurm', 'St. Martin', 'Golattenmattgaß', 'Straßburg', 'Peter', 'Waadt.118', 'Kirchenseld', 'Laubeck', 'Greifensee', 'Hartmaun', 'Parricida', 'Wittigkosen', 'Seedorf', 'Habkesjen', 'Ungarn Königin Agnes', 'Bttikon', 'Winterthnr', 'Glayre', '- Simmenthal', 'Richelieu', 'Stein Brandolf', 'Bargen Bargenbrück Barthslemy Franyois', 'Grauholz Bern', 'Wiener', 'Amphalissa', 'Riggisberg', 'St Gallen', 'Wimmis Thun', 'Blankenburg', 'St. Jakob', 'Brcngraben', 'Nydeggbrcke', 'Rssegg', 'Zweibrücken', 'Mühldorf Mühlen der Aare', 'Nenziverschrvörung', 'Lwenberg', 'Ostermundigen', 'Murifelde', 'Stein Hartmann', 'Große Räthe', 'Freiburg Breisgau', 'Urner', 'Walcnsee', 'Mengaud', 'Hermann', 'Schweizer', 'Schilling', 'Balois', 'Zeughaus', 'Kyburger', 'Kanton', 'Mirabeau Marquis', 'Cornwallis Richelieu', 'Teutsch', 'Pruntrut Dekan Delsberg', 'Canton', 'Königsfelden', 'Bernermarsch', 'Franken', 'Sins', 'Dante', 'Moden', 'Eschen', 'Subannerzug', 'Trachsel', 'Grandson Orbe', 'Brunegg', 'Rottweil', 'Hasle Welsen', 'Gramont', 'Aarwangen', 'Simmenthal Zweisimmen', 'König Karl VII Ludwig Dauphin Ludwig', 'Glarus Freiburg', 'Lugano Locarno', 'Oberaargaus', 'Balm Peter', 'Bellegarde', 'Dießen', 'Labsburg', 'Wirtenberg', 'Freiamt', 'Breitfeld', 'Sonnen', 'Petrus', 'Seftigen', 'Bhl', 'Milot', 'Franciscancr', 'Greyerz Städtchen', 'Knigsfelden', 'Hitzig', 'Ringgcnberg', 'Ermatingen', 'Laupcn', 'Tscherlitz Echallens', 'Rechberg', 'Morste', 'Erlach Stift St Johannsen', 'Bätterkinden', 'Nuu', 'Rußland', 'Thring', 'Bex', 'Weien Berg', 'Barde', 'Monod Froideville', 'Faucignh'}",1173
5713078,552485,"{'Hormannsgasse', 'Neuengasse', 'Lombach', 'Kesslergasse', 'Kyburg', 'Interlaken', 'Nydau', 'Tavol', 'Schowlandsgasse', 'Burgunds', 'Marsilienberg', 'Schwarzenburg', 'Burgerspital', 'Landerons', 'Ostermundigenfeld', 'Frankreichs', 'Kirchberg', 'Spruchbach', 'Michelsthurm', 'Sandfluh', 'Provence', 'Italien', 'Alto Bern', 'Muttenz', 'Kirchhof', 'Verona', 'Bubenberg', 'Erlach', 'Novarra', 'Englisberg', 'HausanderKirchgasse', 'Ted', 'Neuenstadt', 'Freiburgs', 'Oberschwaben', 'Konolfingen', 'Ramseierloch', 'Sternenberg', 'Distelzwang', 'Wittigkofen', 'Oranienburg', 'Bolligen', 'Holligen', 'Laurentiuskirche', 'Venedig', 'Boiligen', 'Amsoldingon', 'Sulgenbaches', 'Magerau', 'Biglen', 'Uri', 'Kirchgasse', 'Wattcmvyl', 'Worb', 'Chur', 'Loire', 'Lenzburg', 'Wangenthal', 'Zschecken', 'Badlaube', 'Allmendland', 'Egelberg', 'Gresisliaus', 'Tellrodel', 'Fontes', 'Regensburg', 'Spiez', 'Vallis Sancta Maria', 'Praroman Kramgasse', 'Landskron', 'Jura', 'Thunstetten', 'Limmat', 'Verdun', 'Windisch', 'Ostschweiz', 'Deutschlands', 'Freiburgerstrasse', 'Montenach', 'Obstberg', 'Aargaues', 'Altenberg', 'Judenkirchhof', 'Leuk', 'Rathhaus', 'Sust', 'Egelmoos', 'Gerbern', 'Frankfurt', 'Spital', 'Alemanien', 'Aegypten', 'Jordan', 'Stalden', 'Vienne', 'Schwanau', 'Europa', 'Muri', 'Lom', 'Aarschwelle', 'Lausanne', 'Stettier', 'Marziele', 'Brod', 'Paris', 'Baden', 'Thurgau', 'Gonstanz', 'Orient', 'Altenberges', 'Schenkengasse', 'Querstrasse', 'Mailand', 'Siggernbach', 'Stein', 'FVeiburg', 'Scliow', 'Buchegg', 'Egerdongasse', 'Jordanhaus', 'Junkerngasse', 'Seeland', 'Frienisberg', 'Savoyen', 'Brunngasse', 'Sursee', 'Burgdorf', 'Ulms', 'Brandis', 'Frankreich', 'Italiens', 'Leutkirche', 'Sargans', 'Durheim', 'Bernhardsbrunn', 'Bremgarten', 'Liebenau', 'Burgenstein', 'Alpen', 'Marienthal', 'Lombachthurm', 'Brunn', 'Postgasse', 'Kilchgasse', 'Elfenau', 'Bologna', 'Bremgartenwald', 'Belp', 'Aarberg', 'Anvers', 'Oesterreich', 'Weissenstein', 'Weyermannshaus', 'Ringgoltingen', 'Nideckbriicke', 'Rhein', 'Rheins', 'Hirschhalde', 'Poslgasso', 'Murten', 'Reichsburg Nideck', 'Krypta', 'Freiburg', 'Nideckkirche', 'Kleinburgund', 'Mainz', 'Benin', 'Aarmitte', 'Spruclibnch', 'Nideck', 'Golattenmatlgasse', 'Diesbach', 'Granada', 'Schowland', 'Kramburg', 'Tedlingen', 'Schweiz', 'Zeughausgasse', 'Ober', 'Wasserthurm', 'Predigergasse', 'Waldau', 'Laupen', 'Lion', 'Wankdorf', 'Kreuzgasse', 'Oberhasli', 'Spa', 'Buchsee', 'Balsthal', 'Burgund', 'Thurmau', 'Swert', 'Florenz', 'Zoliikofen', 'Ulm', 'Breisgau', 'Muristrasse', 'Schwabens', 'Schwaben', 'Luzern', 'Metzgergasse', 'Stuttgart', 'Sumiswald', 'Nydegg', 'Sense', 'Locarno', 'Biel', 'Buwenthal', 'Egerdon', 'Spitzbad', 'Grasburg', 'Ansholm', 'Burghut', 'Michaelsinsel', 'Kirch', 'Villette', 'Brunnadern', 'Kapuzinerthurm', 'Reichenau', 'Kiburg', 'Mar', 'Zollikofen', 'Marktgasse', 'Waadtland', 'Berns', 'Schwendeplatz', 'Marsili', 'Sulgen', 'Amsoldingen', 'Bnchsee', 'Felsenburg', 'Kircligasse', 'Basel', 'Rheinfelden', 'Kramgasse', 'Aarau', 'Esslingen', 'Bernhardtsbrunn', 'Stadtbach', 'Eger', 'Gsteig', 'Hohlgasse', 'Brugg', 'Petersiusel', 'Graflenried', 'Spitalgasse', 'Nideck Blutthurm', 'Grenchen', 'Thorfuss', 'Aarbergerthores', 'Lombachthunn', 'Sulgenbach', 'Constanz', 'Avenches', 'Webern', 'Suiniswald', 'Oberhofen', 'Chillon', 'Eggiwyl', 'Stettlen', 'Martinskirche', 'Constantinopel', 'Herrengasse', 'Weissenburg', 'Waadt', 'Gerechtigkeitsgasse', 'Westschweiz', 'Neuenburg', 'Rom', 'Strassburg', 'Schaffhausen', 'Altenbergs', 'Grandson', 'Born', 'Bern', 'Aeschi', 'Schegkenbrunnen', 'Colmars', 'Twing', 'Ruwenthal', 'Plepps', 'Stettbrunnen', 'Aarbergergasse', 'Engi', 'Kirchenfeld', 'Aare', 'Berne', 'Adelboden', 'Hindel', 'Ostermundigen', 'Guggisberg', 'Solothurn', 'Ringoldingen', 'Staufen', 'Ghetto', 'Toulouse', 'Guglaviertel', 'Landeron', 'Wabern', 'Nidau', 'Bimplitz', 'Walkringen', 'Ligerz', 'Kalchegg', 'Saone', 'Gapitel', 'Ensingen', 'Thun', 'Wengi', 'Balmlolin', 'Helvetiens', 'Plepp', 'Deutschland', 'Zwingolfs', 'Amthausgasse', 'Schafflandsgasse', 'Freibutg', 'Wimmis', 'Wittigkofens', 'Librey', 'Marly'}",322,"{'Rathhauses', 'Jerusalempilger', 'Poitiers', 'Stadttheil', 'Rcctorates', 'Brunnaderns', 'Reichsburg Nydeck', 'Bümplitz', 'Capellen', 'Süddeutschland', 'Aarinsel', 'Sant Vincenzen', 'Frauencapelle', 'Sanctimonialium', 'Maladers', 'Schloss Hagcnwyl, ELOC', 'Berchtold Bern', 'Caplanei', 'Stadtmülile', 'Bathsmanual', 'Burgdorf Burgund', 'Diesser', 'Bisthum Constanz', '20Pfd', 'Laupen Gümmenen', 'Könitz', 'Hübschi', 'Baleien', 'Bern BernBuch', 'Camerais', 'Biffli', 'Der Altenberg', 'Museum Original histor Museum', 'St Michels', 'Bubenbergraines', 'Bern Stadtbibliothek', 'Mulesei', 'Fr', 'Dudels', 'Rebberg Altenberg', 'Dornbühl', 'Bcrchtold', 'Cfyrislcf', 'Bremgarten Reichenbach', 'Abendlande', 'Frienisberghaus', 'Warmbiichli', 'Hirschengraben', 'Münsterbau Ulm', 'Bern Schweiz', 'Miislin', 'Klösterli', 'Kapellbrücke', 'Thorberg haus', 'Kantons Born', 'Susthaus', 'Nideck Bern', 'Andere Thürme', 'Truberhaus', 'Antonierkirche', 'Baumgarton', 'Noth', 'Worms Hagenau', 'Hilf Gottes', 'Nydeckkirclie', 'Leutpriesterei', 'Greda', 'Roc', 'Ram', 'Museum Stantz Münsterbuch', 'Niederwall', 'Nydeckbrücke', 'Bern Blatt', 'aare harabe Stifts', 'Rathhaus Freiburg Schloss Romont', 'Muri Stettlen Vechigen', 'Nürnberg', 'Montcnachs', 'Derselbe', 'Sursee Spreuerbrlicke', 'Mueshafenlocal', 'Aarseite', 'Buwes', 'Imoborsteg', 'Haus Nr Stalden', 'Bongars', 'Wirtli', 'Ulm Gulden', 'Werkschuh', 'Palästina', 'Mülinen Helvetia', 'Ratlihaus', 'ElsassBurgund', 'IJrau', 'St Franciscus', 'Mittelalters Schwaben', 'Schloss Worb', 'Donjon Burgfried', 'Zürich', 'Schosshalde', 'Babylon', 'Bern Rathsmanual', 'Chorweibels', 'Dominikanerkirche', 'Bern Imobersteg', 'Israel', 'Niederlassungsplatz', 'NiederSpitalDocumentenbucli', 'Rüggisberg', 'Der Stalden', 'Eiendenherberge', 'Zeerleder III Tafel', 'Stengel', 'Berclitold', 'Marien', 'Plepp Stadtplan', 'Thurmes', 'Giermont', 'EgerdonGasse', 'Burgistein Belp', 'Unser Klösterlein', 'Beim Sommerleist', 'Holligen L8t', 'Burg Nideck', 'Fontes III Nr Fontes III Nr 351 Messmer', 'Reich Reichsvogt', 'Altenberg Wankdorf', 'Löhner', 'Armbrastercapelle', 'Kappelen', 'Bern Val Aiishelm', 'Mossmer Burgerspital', 'Predigerkloster', 'Metallwerth', 'Rheinfelden Schaffhausen', 'Zähringen', 'Düsseldorf', 'Aussatzhause', 'Bubenbergs', 'Münsterplatz', 'Berner Altenberg', 'Badhaus Marsili', 'Ilausfa', 'Wendelstein', 'Hettiswyl Rüggisberg', 'Emmenlinie', 'Bärengraben', 'Zähringischcn', 'Bern Tafel', 'Judengasse', 'Signau Snmiswald', 'Monstranz', 'Constanzerbisthums', 'Stalden Oberhalb', 'Machicoulis', 'Krattingerhause', 'Nied', 'Rosengarten Frutiggarten', 'Rue Bastionen', 'Sant Görgiencapelle', 'Kirchhofmauer', 'Schloss Gösgen', 'Jetzers', 'Tellrödel', 'Köln', 'Heil Geist', 'Rathsmanual', 'Cöln', 'Bern Blatt DeutschSpruchbuch 1639 Durheim', 'Ramseierloch Nideckbriicke', 'Rothhaus', 'Ivirchendienst', 'Courtine', 'Rathsbeschluss', 'Kantonstheil Born', 'Buudesrathliauses', 'Haspelgässli', 'Hilden', 'Pfrundhaus', 'Aarabhangs', 'Frauenkirche', 'Buiyüorf', 'Scheidemauer', 'Zürich Luzern', 'Ilurde', 'Meclitildens', 'Fagade', 'Heiligen Geist', 'Alte Muttor', 'Eschen Ahorne', 'AltMissivenbuch', 'Sant Vintzencien', 'Marienthal Vallis sancta Maria Inselschwestern Dominikanerinnen', 'Bern Solothurner', 'Thorbergs', 'Räthe', 'Wirthshaus', 'Tuchlaube', 'Mühloberg', 'Münsters', 'Bali', 'Armbrustschützenmatt', 'Hausthür', 'Bern Missiven', 'Bernensis', 'Lützelflüh', 'Schenkenbrunnen', 'Römer', 'Judenthurm', 'Franziskanerkloster', 'Aarlinie', 'Allmend Wankdorf', 'Rathhaus Stalden', 'Sant Lucretientag', 'Nied SpitalDocumentenbuch Staatsarchiv Bern', 'Capitol Wappen Balm', 'Interlakenhaus', 'Blatternhause', 'Dominikanerkloster', 'St Vin', 'Brunnadern Wittigkofen', 'Hauensteins', 'Rh Das Haus', 'StrassenfaQaden', 'Büren Bern', 'Christoffels', 'Musegg Luzern Haus', 'Breitenrain', 'Altorthnmskunde', 'Hessen', 'BrodSchaalen', 'Gothik', 'Schübelcnmatte', 'Simson', 'Stadtaufwärts', 'Frischinghaus Wattenwyl von Rüm', 'Brunnadern Bernhardsbrunn', 'Schwarzwald', 'DiesbachCapelle', 'Reitschulhof', 'Klosterhof', 'Bern Anshehn', 'Chur Malters', 'Diessbach Capell', 'Deutschen Ordens', 'Museum Born', 'Fontos III Nr 390 Fontes III Nr 400 Fontes III Nr 405 Fontes III Nr 406 Fontes', 'Müslin', 'Niedersulgen', 'Schweiz Museum', 'Matte', 'Reichsland', 'Jahrzoitenbuch', 'Pfalz', 'Nürenberg', 'Lion Bern', 'Kreuzmatte', 'Feste Thun', 'Klosterkirche', 'Schloss Holligen Messmer Burgerspital', 'Elisabethenaltar', 'Apostelflgurcn', 'Berner Burgdorf', 'Mosesbrunnen', 'Geist Spital', 'St Antonis', 'Capitol III', 'Burggarnison', 'Steingruben', 'Nied SpitalDocumcntenbucli', 'Altenbe', 'Einigen', 'brugg', 'Bern Stift Dito Dito', 'Rectoratslande', 'Schloss Vüfflens', 'Dito Blatt', 'Berne Walthard', 'Archers', 'Vüfflens', 'Pfalzgrafen Rhein', 'Burgdorf Bern', 'Jegistorf Münsigen', 'Capelle der Matte', 'TIeiliggeistkirche', 'Altes Schloss Schloss Stäflis', 'Kirchenscliatz', 'Zähringischen Burg', 'Vatikan', 'Ita', 'Deutschherren', 'Rümmlang', 'Ruventhal', 'Ramseierloch Brücke', 'Hofstatt', 'Pferdeschwemme', 'Märitgasse', 'Spnichlmch', 'Schloss Burgdorf', 'Avemaria', 'Saane', 'Blatt III Blatt', 'Gottesacker', 'Nordfaijade', 'Diesbach Schweiz', 'Blumenstein', 'Oberes Thor', 'FrauenDominikanerklöster', 'Bern Blatt Fontes', 'Klösterlein', 'Nideckbrücke', 'Schloss Nydeck', 'Rüthen', 'Wurstemborgcr Landschaft Born', 'Deutschen Orden', 'Fontes III Nr Fontes Nr 199 Fontes III Nr 233', 'Därstetten', 'Schloss Stäffis Hauptthurm Schloss Stäffis Vorwerk Schloss Büron Solothurn', 'Bern Fontes III', 'Leutkirclie', 'Sitteralda', 'Nothdurft', 'Münsingen', 'Ulmer Thurmausbaues', 'Haldenberg Schosshalde', 'Nothfalle', 'Breitenrains', 'Mueshafens', 'Siechenhaus', 'Ritters Senn', 'Geldnoth', 'llathhaus Räth', 'Wurstemberger Landschaft Bern', 'Grüneck', 'St Maria', 'Nr Höfchen', 'Baden Aargau', 'Münchenbuchsee', 'Klingenberg', 'Schloss Reichenbach', 'Bern VII', 'Münsterkirche', 'Savoyens', 'Belp Rümlingen', 'Konolfmgen', 'Thürme', 'Büttikon', 'Rütte', 'Steinfuhrungen', 'Anslielm', 'Thorberghaus', 'Walthard Description Berne', 'Würzburg', 'Bader Graben', 'Münsterbucli', 'Menschenkoth', 'LateinSchule', 'Frauhnmnen', 'Mittellöwen', 'Uebrigens', 'Stecks Manuscript Burgerspital Bern Studers Justingor', 'Murten Pfund', 'Röwe', 'Schatfhausen', 'Capelle', 'Bornischcs', 'gath', 'Amsehn', 'Born Liebenau', 'NioderSpitalUrkundon', 'CtusjDieiold chLllinc', 'Bern Dito', 'Blutthurm', 'Brückeneinganges', 'Tüchlin', 'Alten Bern', 'Sumiswald Docunientbuch', 'Armbrustercapelle', 'Käfichthunn', 'Goncil', 'Affenzunft', 'Stett', 'Käfichthurm', 'Letzi', 'Museum Berns', 'Jordanhauses', 'Pfisternhaus', 'Hollanc', 'WeibelnCapelle', 'Richterstuhles', 'Haus Hof', 'Freiburger Münster', 'Bern Schaubriefe Testamentenbuch', 'Schwende', 'Commercienhaus', 'Rathus', 'Brüssel', 'Predigerkirche', 'Kriegsnoth', 'RedingBiberegg', 'Brunnaderen', 'Halde', 'Haus von Niedergerbern', 'Sässliaus', 'Burgunder Feld', 'Bürens', 'Thürmchen', 'Michaelscapelle', 'Büren', 'Sanct Antonien', 'Der Grendel', 'Krumme Weg', 'Capelli Niederwangen', 'Worb Kachelofen', 'Stadtmühle', 'Ursanne Amsoldingen', 'Tedlingen Frienisberg', 'Chrütz', 'Kuventhal', 'Kirchengeräthe', 'Bern St Vinconzen', 'Grauholz', 'Bubenbergsthürli', 'Bern OberSpitalurkunden', 'Born VIII', 'Fiussufer Bogen', 'Born Th', 'AegerdonGasse', 'Dienstadel Burglehens', 'Aarenhalde', 'Rath', 'Münstergrundrisses', 'Könitz Belp', 'Storchen', 'Bärenhäusli', 'Spitalhof', 'Laupon', 'Bern Tillior', 'Giebelfagade', 'Stadtkirche', 'Wattenwyl Stadt', 'Bern Studers Justingor', 'WattenwylPourtalcs', 'Waarenbahn', 'Allgemeinen Kirchenvisitation', 'marais Moor', 'Künigsfeldon', 'Krattigenhaus', 'Böhmen', 'Gremaud Memorial Frybourg', 'Bern Blatt Stettier', 'Schellhammers', 'Friburg', 'Haus Nr Mattenenge', 'Münster', 'Montfaucon', 'Kriegsrath', 'Tschudis Chronik', 'Yoreins', 'Aare Seftigen', 'Sacristei', 'Kirchhöf', 'Golatten', 'Missiven', 'Klosterkornhaus', 'Rothgiesser', 'Strättligen WyJ Worb', 'Hofstatt Cuno Münzmeisters', 'Bruck', 'Pfisternhauses', 'Balm von Bargen', 'BeideStuben', 'Lütschenbaches', 'Ramseierloch Nideckbrücke', 'Bremgartens', 'Capelle St Michaelis Capelle', 'Cloaken', 'Aventicum', 'Haus Moudon', 'Forst', 'Clages Thurm', 'Mittelalters Deutschland', 'Herzogthums Schwaben', 'Bern DeutschSpruchbucli', 'Scherzligen', 'Klapperläubli', 'MarschaU Trimouille', 'Diesbach Wappens', 'Udelbuch pag', 'Alterthums', 'Bern Fontes', 'Fluh', 'Tliürme', 'Schultheiss', 'Leprose', 'Montferrat', 'Rittcrordeus', 'Museum Bern', 'Thorfusses', 'Deutschorden', 'St Gilg', 'Muesliafen Documeutenbucli', 'Riffli', 'Gottesackers', 'Haus der Johanniter', 'Haus Stör', 'Freiburg Breisgau', 'Sant Niclausen', 'Staatsarchiv Bern', 'Neuenburg Hof', 'Erlaclierhofes', 'Münchwyler Guggisperg', 'Dörnach', 'Könitz Born', 'Canton Frybourg', 'Bern Deutsch Ord', 'Königsfelden', 'Ferner', 'Deutschordens', 'Rathes', 'Rödel', 'Dcutsch', 'Genf Lausanne', 'Fuss Länge', 'Mariencapelle', 'St Vinccnzentapete', 'Zoüngen', 'Mittelalters', 'Nord Süd', 'StUdtewesen', 'Aarwangen', 'Cauton Fribourg', 'Dieser Glockenthurm', 'Chrützgasse', 'Franceybad', 'Münsterbau', 'Todtentanzes', 'Käficbthurm', 'Sanct Vincenzen', 'Baar', 'Holligen Trachselwald', 'Steinhölzli', 'Bellina', 'Zürichs', 'St Yincenzen', 'Seftigen', 'Deutschen Ordens Der Graben', 'Säckingen', 'St Gilgencapell', 'Müserie', 'Schützenmattbrünnlein', 'Münsterplatzes', 'Neuenegg Sternenberg', 'Siohe Capitol', 'Bern Messmer Inselspital', 'Könitzer Kirche', 'Kreuzgasse Ring', 'Thüringen'}",558,"{'Buben', 'Imobersteg', 'Schnegg', '- cenzenkirche', 'Schinkengasse', 'Schlosshof', 'Vincenzenhoupt', 'Kfichthurm', 'Marmorstein', 'Balm', 'Gsgen', 'Nrenberg', 'Bern.237', 'Reichsburg', 'Drnach', 'Rue', 'Anshelm', 'Illingen', 'St. Antonien', 'Eigistorf', '- bachtlmrm', 'Aula', 'Vincenzenbauhtte', 'Petersinsel', 'Vincenzenkirchlein', 'Reich', '- aderns', '- bau', 'Wien', 'Haldenberg', 'Sciiaffhausen', 'Rtlien', 'Haller', 'Kachelofen', 'Winterthur', 'Leu', 'Sissach', 'Fol', 'Konol', 'Savoy', 'Burgrecht', 'Elggcr', 'Vincenzen', 'St. Antoni', 'Bourguillon', 'Thrraen', 'Teutonia', 'Grneck', 'Trlhsli', 'Rm', 'Boner', 'Armbruster', 'Albreeht', 'Urodfii', '- brugg-Graben', 'Malazige', 'Thurm', 'Alpenrosen', 'Kfichthunn', 'Haspelgssli', 'Klosterzimmor', 'Kappel', 'Broisgau', 'Neustadt', 'Rtti', 'Mn', 'Nideckbrcke.49', 'Pontes pag', 'Rthenbach', 'Mittellwen', 'Zwingelhof', 'Marienburg', 'Bron', 'Gallen', 'Vincenzon', '- lingen', 'Vincenzenkirchhof', 'St. Gilg', 'Reichenbach', 'Sd', 'Tscharner-Diesbach', 'Rtte', 'St. Didier', 'Frutiggarten', 'Cronica berno pag', 'Cap', 'Fry', 'Knitz', 'Del Schweiz', 'Musegg', 'Habsburg', 'Messen', 'Mnster', 'St. Vineenz', 'Montenacli', 'Peterlingen', 'Vincenzenmnsters', 'Vintzencien', 'Vintzencie', 'pag Fontes', 'Vincenzenkirchen', 'Steinen', 'Weingarten', 'Wyler', 'Wattenwyl-Pourtalcs', 'Zrichkrieg', 'Mathus', '- lattenmattgasse', 'Wertlienstein', 'Rerns', 'Montpellier', 'Weiher', 'Ghrtzgassen', 'Grindelwald', 'Wrzburg', 'Wurstembergor', 'Greyerz', 'St. Moritz', 'Morgarten', 'Val Aiishelm', 'Sutz', 'Metzgernbrunnen', 'Lengenberg', 'Font.es', 'Cln', 'Gasse', 'Gerberngraben', 'Borns', 'Mies', 'Brunnen', 'Krauchthal', 'Zhringerbrunnen', 'Venner-Manual', 'Reichenstein', 'Haspel', 'Messmer', 'Chrtz', 'Egerdongass', 'Metzg', '- hauses', 'Strttlingen', 'St. Maria', 'Neubrcke', 'Blumistein', 'Snmiswald', 'Biello', 'Bhmen', 'Vechigen', 'Innocenz', 'St. Michael-Altar', 'Hochstetten', 'Vincenzenstiftes', 'Alt-Missivenbucli', 'Palstina', 'Smniswald', 'Muleren', 'Nellenburg', 'St. Maria Magdalenen', 'Nideckbrcke Fontes', 'Gysenstein', 'Stantz', 'Altenryf', 'Kurzengasse', 'Verzel', 'Gerbernviertel', 'Muttor', 'Diessbacli', 'Lonstorf', 'Bren', 'Preussen', '- thunn', 'Froiburg', 'St. Andreasabond', 'Dornbhl', 'Baselthor', 'Frienis', 'Edelstein', 'Guggisperg', 'Berno', 'Baselwind', 'Helvetia', 'Trachselwald', 'Worblaufen', 'Bubenbergsthrli', 'Hagcnwyl', 'Aegerdon-Gasse', 'Stffis', 'Sulgeubachgegend', 'Kies', 'Inselgasse', 'Moos', 'Prcssel', 'Burgdorfstrasse', 'Bern.225', 'Bernern', 'Stadtthor', 'Alt-Udelbuch pag', 'Fontos', 'Aargau', 'Mslin pag', 'Tabor', 'Montfaueon', 'Romont', 'Signau', 'Hettiswyl', 'Egerdon-Gasse', 'Neuenegg', 'Korns', 'Niedersiebcnthalbuch', 'Schtteweg', 'Aarann', 'Mattenareal', 'Jacobsherberge.276', 'Iimno', 'Schnberg', 'Chavannes', 'Egle', 'Gysensteinviertel', 'Stadtchronik', 'Buiyorf', '- bergsthrli', 'Steffanshalden', 'Rmligen', 'Spalenthor', '- leins', 'Sclipflin', 'Berns.81', 'Rinkoldingen', 'Mnsters', 'pag Pontes', 'Hochburgund', 'Ehgraben', 'Mainmertshofen', 'Schatt', 'St. Vincenzenkirche', 'Gmmenen', 'neuenburg', 'Btikon', 'bern', 'Teilrodel', 'Mlsen', 'Entengraben', 'Malters', 'Spreuerbrlicke', 'Rebberg', 'Brienz', '- burg', 'Prag', 'Kapellbrcke', 'Drstetten', '- brlin', 'Bann', 'Rggisberg', '- cenzen-Jahrzeitbuch', 'Pfenningen', 'Kram', 'Bonstetten', 'Mhloberg', 'Nrnberg', 'Dudelsackpfeifferbrunnen', 'Viktualien', 'Ivng', 'Obergerbern', 'Chrtzgasse', 'Bubenbergrain', 'Indiana', '-', 'Schill', 'Khlewyl', 'Bern bach', 'Runs', 'Wurstemberger', 'Archiv', '- silithor', 'Vincenzen-Kirchhof', 'Wattcnwyl', 'Schlsser', '- hfli', 'Aarlauf', 'St. Antonius', 'Golattenmattgassthor', 'Deutsch-Spruohlmch', '- bank', 'Blutthurm.41', 'Mrit', 'Manuels', '- cenzen-Chorherrenstift.146', 'Fontes pag', 'Bach', 'Bernthor', 'Eisass', 'Tudengasse', 'niederbrugg', 'Ostermundigenstein', 'Kal', 'Aarufer', 'Miltenberg', 'Anshelms', 'Futtcrvorrtlie', 'Luzerns', 'Delphinat', 'Steininbruggraben', 'Sandeck', '- berg', 'St.', 'Deutsch-Spruchbucli', 'Studors', '- thores', 'St. Burgund', 'Batzen', 'Kln', 'Sehinkengasse', 'Sandstein', 'Unter-Wankdorf', 'Niclausen', '- cenzenkilch', 'Zhringen', 'bubenberg', 'pag pag', 'Rtitti', 'Antoni', 'ponte nostro', 'Bernisches', 'St. Gilgencapell', 'Brwenliaus', 'Tentenberg', 'Knigsfeldon', 'Siebenthal', '- Sulgen', 'Hem', 'Savoyer', 'Fribourg', 'Rmmlang', 'Vincenzenbau', '- hannsen', 'Vfflens', 'Bipp', 'Dentenberg', 'Mnsingen', 'Busse', 'Kienthal', 'Harnischthurm', 'Stadtmauer', 'Cronica', 'Tcdlingen', 'Faucigny', 'Pest', 'Genf', 'Ltzelflh', 'Gln', 'Vincenzenkirche', 'Bargen', 'Schwyz', 'Pontes', 'Ersnne', 'Ale', 'Treib', 'Gmmencn', 'Solothnrn', 'Niedergerbern', 'Pfd', 'Cloak', 'Engelhof', 'Grgiencapelle', 'Ilabsburg', 'Zrichs', 'Aar', '- bach', 'Valeria', 'Schattseite', 'Vincelizenkirche', 'Helvetia sacra', 'Nideckbrcke', 'Wurstemborgcr', 'Schleuse', 'Bern-Buch', 'Lit pag', 'Berner', 'Kleinwabern', 'Burgistein', 'Rothenburg', 'Glns', '- maasse', 'Ilelvetien', 'Burgundia', 'Mnsterplatz', 'Mritgasse', 'Ravenspurg', 'Colmar', 'Scharnachthai', 'Moudon', 'Berchtold', 'Rh', 'Simmenthal', 'Constanzischen', '- gasse', 'Grendel', 'Maria-Magdalenen', '- Markt', 'Wallisern', 'Boos', '- pen', 'Zrich', 'Reding-Biberegg', 'Dom', 'Brwenhaus', 'Sddeutschland', 'Bern pag', 'Vincenzienbuw', 'Sitten', 'Frybourg', 'Rtschmund', 'Schnegka', 'Herzogenbuehsee', 'Lind', 'Udelzins', 'Wattenwyl', '- ligen', 'Basel, ', 'Scbinkengasse', 'Ursanne', 'Vincen', 'Sclmltheiss', 'Kirchhofs', 'Euss', 'Christi', 'Bmplitz', 'Strassberg', 'Altenbergstrssehens', 'Eugubio', 'Mauensee', 'Fryburg', 'Christoffelthurm', 'Wrttemberg', '- cenzen', 'Steffisburg', 'Golattenmattgass', 'Kersatz', 'pag', 'Sultan', 'Mauorn', 'Ilormannsgasse', 'Wonne', 'Kien', 'Peter', 'Tellen', 'Schlsschen', 'Mnsigen', 'Marienthalkloster', 'Seedorf', 'Del Buchsee', 'Jegistorf', 'Schwaben pag', 'Munoth', 'Wrzbrunnen', 'Schauplatzgasse', 'Go', 'Nieder', 'Rossmarkt', 'Optingen', 'Elsass-Burgund', 'Strassenlauben', 'Brin', 'Vallis', 'Dsseldorf', 'Bttikon', 'Vincenzenstift', 'Ursenbastion', 'Romainmotier', 'Gren', 'Neubau', 'St. Maria-Magdalenenkirche', 'Wangen', '- kirche', 'Yincenzen', 'Strassburgern', 'Zhringen.309', 'Reichsvogt', 'Kirchhf', '- cenzenschatz', 'Mlinens', 'Wyerhaus', 'Eschenbach', 'Kleinhchstetten', 'Riggisberg', 'St. Michael', 'Brssel', 'Saano', 'Sckingen', 'Wuhrdamm', 'Jo', 'Cfottez', 'Gras', 'Brem', 'Hagenau', 'Mlinen', 'Oltigen', 'Burgau', 'Schloss', 'Almendingen', 'Mnchenbuchsee', 'Rougemont', 'Nydeckbrcke', '- landsgasse', 'Dito', 'Sedorf', 'Hohenstaufen', 'Kanton', 'Ried', 'Fuss', 'Ruhenthal', 'Strasse', 'Rosengarten', 'Mass', 'Mslin', 'St. Leonhard', 'Almedingen', 'desBrwen', 'Acussere', 'Stadtelironik', 'Trub', 'Kilchhof', 'Brens', 'Del Stalden', 'Vin', 'Helvetfen', 'Mar ziele', 'Ltschenbaches', 'Mhren', 'Lanzhut', 'Erlachs', 'Castilien', 'Altisliofcn', 'briiggo', '- cenzen-Sakristei', 'Nydeck', 'Eptingen', '- chenstein', 'Strass', 'Mechtild', 'Michaelis', 'Heimberg', '- mannien', 'Fusse', '- lenthor', 'Langhaus', 'Langenstein', 'Born pag', 'Knigsfelden', 'Beatusbrunnen', '- gssli', 'Jjausanne', '- clieneck', 'Alb Kurz', 'Rechberg', 'St. Gallen', '- chen', 'Nord', 'Wallis', 'Niedertolfen', 'Ilochburgund', 'Murtenthor'}",562,"{'Buben', 'Rathhauses', 'Imobersteg', 'Schnegg', 'Schinkengasse', 'Reichsburg Nydeck', 'Aarinsel', 'Sant Vincenzen', 'Schloss Hagcnwyl, ELOC', 'Bern.237', 'Reichsburg', 'Caplanei', 'Bathsmanual', 'Diesser', 'Illingen', 'Eigistorf', 'Laupen Gümmenen', 'Hübschi', 'Baleien', 'Camerais', 'Aula', 'Vincenzenkirchlein', 'Bern Stadtbibliothek', 'Fr', 'Dornbühl', 'Haldenberg', 'Cfyrislcf', 'Sciiaffhausen', 'Leu', 'Münsterbau Ulm', 'Fol', 'Vincenzen', 'St. Antoni', 'Bourguillon', 'Trlhsli', 'Nideck Bern', 'Antonierkirche', 'Malazige', 'Baumgarton', 'Haspelgssli', 'Museum Stantz Münsterbuch', 'Rathhaus Freiburg Schloss Romont', 'Mn', 'Sursee Spreuerbrlicke', 'Pontes pag', 'Marienburg', 'Mülinen Helvetia', 'Reichenbach', 'Tscharner-Diesbach', 'Frutiggarten', 'Cronica berno pag', 'Babylon', 'Bern Imobersteg', 'Israel', 'Messen', 'Mnster', 'Marien', 'Mathus', 'Montpellier', 'Holligen L8t', 'Fontes III Nr Fontes III Nr 351 Messmer', 'Morgarten', 'Mossmer Burgerspital', 'Kappelen', 'Rheinfelden Schaffhausen', 'Düsseldorf', 'Borns', 'Münsterplatz', 'Badhaus Marsili', 'Krauchthal', 'Zähringischcn', '- hauses', 'Judengasse', 'St. Maria', 'Blumistein', 'Constanzerbisthums', 'Stalden Oberhalb', 'Krattingerhause', 'Smniswald', 'Nellenburg', 'St. Maria Magdalenen', 'Rathsmanual', 'Nideckbrcke Fontes', 'Altenryf', 'Rothhaus', 'Ivirchendienst', 'Gerbernviertel', 'Muttor', 'Diessbacli', 'Kantonstheil Born', 'Ilurde', 'Frienis', 'Edelstein', 'Alte Muttor', 'Helvetia', 'Tuchlaube', 'Thorbergs', 'Räthe', 'Wirthshaus', 'Bubenbergsthrli', 'Mühloberg', 'Münsters', 'Hagcnwyl', 'Armbrustschützenmatt', 'Römer', 'Aarlinie', 'Bern.225', 'Bernern', 'Capitol Wappen Balm', 'Stadtthor', 'Rh Das Haus', 'Altorthnmskunde', 'BrodSchaalen', 'Gothik', 'Schübelcnmatte', 'Stadtaufwärts', 'Korns', 'Klosterhof', 'Iimno', 'Diessbach Capell', 'Museum Born', 'Fontos III Nr 390 Fontes III Nr 400 Fontes III Nr 405 Fontes III Nr 406 Fontes', 'Buiyorf', 'Lion Bern', 'Kreuzmatte', 'Rmligen', 'Klosterkirche', 'Sclipflin', 'Capitol III', 'Nied SpitalDocumcntenbucli', 'Hochburgund', 'Altenbe', 'brugg', 'Bern Stift Dito Dito', 'bern', 'Teilrodel', 'Entengraben', 'Vüfflens', 'Spreuerbrlicke', 'Capelle der Matte', 'Rggisberg', '- cenzen-Jahrzeitbuch', 'Ita', 'Pfenningen', 'Kram', 'Bonstetten', 'Mhloberg', 'Dudelsackpfeifferbrunnen', 'Chrtzgasse', 'Nordfaijade', '-', 'Bern bach', 'Schloss Nydeck', 'Rüthen', 'Deutschen Orden', 'Wattcnwyl', 'Schlsser', 'Fontes III Nr Fontes Nr 199 Fontes III Nr 233', 'Golattenmattgassthor', 'Därstetten', 'Blutthurm.41', 'Haldenberg Schosshalde', 'Tudengasse', 'niederbrugg', 'Siechenhaus', 'Miltenberg', 'St Maria', 'Baden Aargau', 'Münchenbuchsee', 'Sandeck', '- thores', 'Kln', 'Sandstein', 'Rütte', 'Thorberghaus', 'Würzburg', 'Bader Graben', 'Münsterbucli', 'LateinSchule', 'Rtitti', 'Stecks Manuscript Burgerspital Bern Studers Justingor', 'St. Gilgencapell', 'Röwe', 'Tentenberg', 'Bornischcs', 'Savoyer', 'Fribourg', '- hannsen', 'Vfflens', 'Jordanhauses', 'Pfisternhaus', 'Faucigny', 'Genf', 'Bern Schaubriefe Testamentenbuch', 'Schwyz', 'Burgunder Feld', 'Ilabsburg', 'Aar', 'Ursanne Amsoldingen', 'Nideckbrcke', 'Bern St Vinconzen', 'Grauholz', 'Lit pag', 'Berner', '- maasse', 'Ilelvetien', 'Dienstadel Burglehens', 'Moudon', 'Storchen', 'Maria-Magdalenen', '- Markt', 'Laupon', 'Zrich', 'Dom', 'Sddeutschland', 'Schnegka', 'Herzogenbuehsee', 'Krattigenhaus', 'Kriegsrath', 'Tschudis Chronik', 'Bmplitz', 'Altenbergstrssehens', 'Golatten', '- cenzen', 'Steffisburg', 'pag', 'Rothgiesser', 'Tellen', 'Mnsigen', 'Marienthalkloster', 'Schwaben pag', 'Bremgartens', 'Strassenlauben', 'Vallis', 'St. Maria-Magdalenenkirche', 'Strassburgern', 'Zhringen.309', 'Kirchhf', 'MarschaU Trimouille', 'Udelbuch pag', 'Rittcrordeus', 'St Gilg', 'Riffli', 'Gottesackers', 'Brem', 'Mlinen', 'Oltigen', 'Mnchenbuchsee', 'Staatsarchiv Bern', 'Münchwyler Guggisperg', 'Dito', 'Acussere', 'Trub', 'Kilchhof', 'Deutschordens', 'Rödel', 'Lanzhut', 'Altisliofcn', '- cenzen-Sakristei', 'Chrützgasse', 'Strass', 'Sanct Vincenzen', '- mannien', 'Holligen Trachselwald', '- lenthor', 'Bellina', 'Zürichs', 'Deutschen Ordens Der Graben', 'Langenstein', 'St Gilgencapell', '- gssli', 'Jjausanne', '- clieneck', 'Alb Kurz', 'St. Gallen', 'Niedertolfen', 'Ilochburgund', 'Murtenthor', 'Schlosshof', 'Bümplitz', 'Kfichthurm', 'Süddeutschland', 'Gsgen', 'Drnach', 'Rue', 'Anshelm', '20Pfd', 'Könitz', 'Biffli', 'Bubenbergraines', 'Reich', 'Rebberg Altenberg', 'Frienisberghaus', 'Hirschengraben', 'Miislin', 'Elggcr', 'Klösterli', 'Grneck', 'Kapellbrücke', 'Susthaus', 'Urodfii', 'Truberhaus', 'Alpenrosen', 'Nydeckkirclie', 'Kfichthunn', 'Ram', 'aare harabe Stifts', 'Nürnberg', 'Neustadt', 'Nideckbrcke.49', 'Aarseite', 'Imoborsteg', 'Zwingelhof', 'Bongars', 'Ulm Gulden', 'Gallen', 'Werkschuh', 'Palästina', 'Vincenzon', 'Mittelalters Schwaben', 'St. Didier', 'Cap', 'Knitz', 'Dominikanerkirche', 'Del Schweiz', 'Niederlassungsplatz', 'pag Fontes', 'Eiendenherberge', 'Weingarten', 'Zrichkrieg', 'Giermont', 'Burg Nideck', 'Ghrtzgassen', 'Greyerz', 'Armbrastercapelle', 'Bern Val Aiishelm', 'Zähringen', 'Val Aiishelm', 'Gasse', 'Bubenbergs', 'Berner Altenberg', 'Brunnen', 'Wendelstein', 'Venner-Manual', 'Chrtz', 'Strttlingen', 'Neubrcke', 'Biello', 'Signau Snmiswald', 'St. Michael-Altar', 'Rosengarten Frutiggarten', 'Alt-Missivenbucli', 'Rue Bastionen', 'Sant Görgiencapelle', 'Palstina', 'Jetzers', 'Köln', 'Gysenstein', 'Courtine', 'Pfrundhaus', 'Frauenkirche', 'Froiburg', 'St. Andreasabond', 'Dornbhl', 'Baselthor', 'Meclitildens', 'Eschen Ahorne', 'Bern Solothurner', 'Bali', 'Bern Missiven', 'Bernensis', 'Lützelflüh', 'Schenkenbrunnen', 'Prcssel', 'Burgdorfstrasse', 'Rathhaus Stalden', 'Brunnadern Wittigkofen', 'Breitenrain', 'Simson', 'Frischinghaus Wattenwyl von Rüm', 'Niedersiebcnthalbuch', 'Aarann', 'Chur Malters', 'Schnberg', 'Chavannes', 'Egle', 'Gysensteinviertel', 'Stadtchronik', 'Schweiz Museum', '- bergsthrli', 'Spalenthor', 'Elisabethenaltar', 'Apostelflgurcn', 'Steingruben', 'pag Pontes', 'Einigen', 'Rectoratslande', 'Dito Blatt', 'Mlsen', 'Berne Walthard', 'Archers', 'Burgdorf Bern', 'Jegistorf Münsigen', 'Brienz', '- burg', 'Prag', '- brlin', 'Altes Schloss Schloss Stäflis', 'Zähringischen Burg', 'Vatikan', 'Hofstatt', 'Spnichlmch', 'Saane', 'Blatt III Blatt', 'Obergerbern', 'Bubenbergrain', 'Diesbach Schweiz', 'Vincenzen-Kirchhof', 'Bernthor', 'Sitteralda', 'Nothdurft', 'Ritters Senn', 'Geldnoth', 'Kal', 'Nr Höfchen', 'Luzerns', 'Bern VII', 'Deutsch-Spruchbucli', 'Batzen', 'Thürme', 'Unter-Wankdorf', 'Steinfuhrungen', 'Zhringen', 'Antoni', 'Hem', 'Blutthurm', 'Alten Bern', 'Armbrustercapelle', 'Käfichthunn', 'Bipp', 'Busse', 'Letzi', 'Harnischthurm', 'Cronica', 'Richterstuhles', 'Freiburger Münster', 'Vincenzenkirche', 'Pontes', 'Ersnne', 'RedingBiberegg', 'Treib', 'Gmmencn', 'Michaelscapelle', 'Sanct Antonien', '- bach', 'Stadtmühle', 'Schattseite', 'Vincelizenkirche', 'Helvetia sacra', 'Wurstemborgcr', 'Schleuse', 'Kirchengeräthe', 'Bern-Buch', 'Bubenbergsthürli', 'Burgistein', 'Mnsterplatz', 'Aarenhalde', 'Rath', 'Ravenspurg', 'Scharnachthai', 'Berchtold', 'Grendel', 'Boos', '- pen', 'Bern Tillior', 'Lind', 'Gremaud Memorial Frybourg', 'Montfaucon', 'Christi', 'Strassberg', 'Kirchhöf', 'Wrttemberg', 'Golattenmattgass', 'Kersatz', 'Ilormannsgasse', 'Kien', 'Hofstatt Cuno Münzmeisters', 'Bruck', 'Del Buchsee', 'Seedorf', 'Munoth', 'Wrzbrunnen', 'Balm von Bargen', 'Go', 'Optingen', 'Lütschenbaches', 'Brin', 'Haus Moudon', 'Dsseldorf', 'Bttikon', 'Herzogthums Schwaben', 'Bern DeutschSpruchbucli', 'Scherzligen', '- kirche', 'Wangen', 'Reichsvogt', 'Wyerhaus', 'Kleinhchstetten', 'Brssel', 'Alterthums', 'Tliürme', 'Jo', 'Cfottez', 'Deutschorden', 'Hagenau', 'Almendingen', 'Sant Niclausen', '- landsgasse', 'Sedorf', 'Mass', 'Almedingen', 'desBrwen', 'Königsfelden', 'Del Stalden', 'Genf Lausanne', 'Fuss Länge', 'Mar ziele', 'Cauton Fribourg', 'Dieser Glockenthurm', 'Heimberg', 'St Yincenzen', 'Seftigen', 'Langhaus', 'Knigsfelden', '- chen', 'Wallis', '- cenzenkirche', 'Rcctorates', 'Brunnaderns', 'Marmorstein', 'Capellen', 'Frauencapelle', 'Nrenberg', 'Stadtmülile', 'Bisthum Constanz', 'St. Antonien', 'St Michels', 'Mulesei', '- aderns', '- bau', 'Wien', 'Haller', 'Warmbiichli', 'Winterthur', 'Bern Schweiz', 'Konol', 'Savoy', 'Teutonia', 'Thorberg haus', 'Kantons Born', '- brugg-Graben', 'Thurm', 'Noth', 'Leutpriesterei', 'Greda', 'Roc', 'Niederwall', 'Bern Blatt', 'Broisgau', 'Muri Stettlen Vechigen', 'Montcnachs', 'Mueshafenlocal', 'Mittellwen', 'Haus Nr Stalden', 'Wirtli', 'Bron', 'Ratlihaus', 'ElsassBurgund', 'Vincenzenkirchhof', 'Sd', 'Schloss Worb', 'Rtte', 'Donjon Burgfried', 'Schosshalde', 'Bern Rathsmanual', 'Fry', 'Rüggisberg', 'St. Vineenz', 'Vincenzenmnsters', 'Vintzencien', 'Vintzencie', 'Der Stalden', 'Zeerleder III Tafel', 'Berclitold', 'Wattenwyl-Pourtalcs', 'Plepp Stadtplan', 'Thurmes', 'Wertlienstein', 'Rerns', 'Beim Sommerleist', 'Grindelwald', 'Reich Reichsvogt', 'Löhner', 'Metallwerth', 'Metzgernbrunnen', 'Font.es', 'Aussatzhause', 'Mies', 'Ilausfa', 'Zhringerbrunnen', 'Reichenstein', 'Emmenlinie', 'Metzg', 'Egerdongass', 'Snmiswald', 'Monstranz', 'Innocenz', 'Kirchhofmauer', 'Muleren', 'Schloss Gösgen', 'Ramseierloch Nideckbriicke', 'Kurzengasse', 'Verzel', 'Buudesrathliauses', 'Aarabhangs', 'Lonstorf', 'Bren', '- thunn', 'Fagade', 'Guggisperg', 'Berno', 'Baselwind', 'AltMissivenbuch', 'Marienthal Vallis sancta Maria Inselschwestern Dominikanerinnen', 'Worblaufen', 'Hausthür', 'Inselgasse', 'Sant Lucretientag', 'Interlakenhaus', 'St Vin', 'Hauensteins', 'StrassenfaQaden', 'Büren Bern', 'Christoffels', 'Aargau', 'Musegg Luzern Haus', 'Mslin pag', 'Montfaueon', 'Signau', 'Hettiswyl', 'Brunnadern Bernhardsbrunn', 'Schwarzwald', 'Reitschulhof', 'Mattenareal', 'Niedersulgen', 'Reichsland', 'Jahrzoitenbuch', 'Nürenberg', 'Steffanshalden', 'Feste Thun', 'Berner Burgdorf', 'Mosesbrunnen', '- leins', 'Geist Spital', 'St Antonis', 'Burggarnison', 'Rinkoldingen', 'Schatt', 'St. Vincenzenkirche', 'neuenburg', 'Btikon', 'Drstetten', 'TIeiliggeistkirche', 'Ramseierloch Brücke', 'Schloss Burgdorf', 'Nrnberg', 'Viktualien', 'Gottesacker', 'Indiana', 'Klösterlein', 'Runs', 'Wurstemberger', '- hfli', 'Aarlauf', 'St. Antonius', 'Deutsch-Spruohlmch', '- bank', 'Bern Fontes III', 'Mrit', 'Manuels', 'Fontes pag', 'Münsingen', 'Eisass', 'Mueshafens', 'Aarufer', 'Futtcrvorrtlie', 'Delphinat', 'Steininbruggraben', '- berg', 'St. Burgund', 'Belp Rümlingen', 'Sehinkengasse', 'Niclausen', '- cenzenkilch', 'Menschenkoth', 'bubenberg', 'Frauhnmnen', 'Mittellöwen', 'pag pag', 'Murten Pfund', 'Bernisches', 'gath', 'Amsehn', 'Knigsfeldon', 'Siebenthal', 'NioderSpitalUrkundon', 'CtusjDieiold chLllinc', 'Bern Dito', 'Vincenzenbau', 'Goncil', 'Dentenberg', 'Stadtmauer', 'Hollanc', 'Tcdlingen', 'WeibelnCapelle', 'Gln', 'Schwende', 'Predigerkirche', 'Ale', 'Brunnaderen', 'Pfd', 'Sässliaus', 'Cloak', 'Grgiencapelle', 'Bürens', 'Zrichs', 'Büren', 'Der Grendel', 'Krumme Weg', 'Worb Kachelofen', 'Kuventhal', 'Kleinwabern', 'Rothenburg', 'Bern OberSpitalurkunden', 'Born VIII', 'Glns', 'Fiussufer Bogen', 'Burgundia', 'Mritgasse', 'Colmar', 'Münstergrundrisses', 'Könitz Belp', 'Constanzischen', 'Bärenhäusli', 'Reding-Biberegg', 'Brwenhaus', 'Bern pag', 'Vincenzienbuw', 'Wattenwyl Stadt', 'Bern Studers Justingor', 'Udelzins', 'Allgemeinen Kirchenvisitation', 'marais Moor', 'Künigsfeldon', 'Wattenwyl', '- ligen', 'Scbinkengasse', 'Sclmltheiss', 'Bern Blatt Stettier', 'Friburg', 'Haus Nr Mattenenge', 'Münster', 'Euss', 'Yoreins', 'Aare Seftigen', 'Sacristei', 'Eugubio', 'Mauensee', 'Fryburg', 'Christoffelthurm', 'Mauorn', 'Strättligen WyJ Worb', 'Schlsschen', 'Pfisternhauses', 'Nieder', 'BeideStuben', 'Cloaken', 'Clages Thurm', 'Ursenbastion', 'Romainmotier', 'Klapperläubli', 'Mlinens', 'Diesbach Wappens', 'Saano', 'Bern Fontes', 'Sckingen', 'Schultheiss', 'Wuhrdamm', 'Montferrat', 'Muesliafen Documeutenbucli', 'Haus Stör', 'Burgau', 'Schloss', 'Dörnach', 'Könitz Born', 'Hohenstaufen', 'Ried', 'Fuss', 'Strasse', 'St. Leonhard', 'Stadtelironik', 'Ferner', 'Brens', 'Rathes', 'Dcutsch', 'Vin', 'Ltschenbaches', 'Zoüngen', 'Erlachs', 'Mittelalters', 'Castilien', 'briiggo', 'Eptingen', '- chenstein', 'Mechtild', 'Münsterbau', 'Todtentanzes', 'Käficbthurm', 'Michaelis', 'Müserie', 'Siohe Capitol', 'Bern Messmer Inselspital', 'Jerusalempilger', 'Poitiers', 'Stadttheil', 'Vincenzenhoupt', 'Balm', 'Sanctimonialium', 'Maladers', 'Berchtold Bern', 'Burgdorf Burgund', '- bachtlmrm', 'Bern BernBuch', 'Vincenzenbauhtte', 'Petersinsel', 'Der Altenberg', 'Museum Original histor Museum', 'Dudels', 'Bcrchtold', 'Bremgarten Reichenbach', 'Rtlien', 'Abendlande', 'Kachelofen', 'Sissach', 'Burgrecht', 'Thrraen', 'Rm', 'Boner', 'Armbruster', 'Andere Thürme', 'Albreeht', 'Worms Hagenau', 'Hilf Gottes', 'Nydeckbrücke', 'Klosterzimmor', 'Kappel', 'Rtti', 'Derselbe', 'Rthenbach', 'Buwes', '- lingen', 'St. Gilg', 'IJrau', 'St Franciscus', 'Zürich', 'Chorweibels', 'Musegg', 'NiederSpitalDocumentenbucli', 'Habsburg', 'Montenacli', 'Peterlingen', 'Vincenzenkirchen', 'Steinen', 'Stengel', 'Wyler', 'EgerdonGasse', '- lattenmattgasse', 'Burgistein Belp', 'Unser Klösterlein', 'Weiher', 'Wrzburg', 'Wurstembergor', 'St. Moritz', 'Altenberg Wankdorf', 'Predigerkloster', 'Sutz', 'Lengenberg', 'Cln', 'Gerberngraben', 'Haspel', 'Messmer', 'Hettiswyl Rüggisberg', 'Bern Tafel', 'Bärengraben', 'Bhmen', 'Vechigen', 'Machicoulis', 'Nied', 'Hochstetten', 'Vincenzenstiftes', 'Tellrödel', 'Bern Blatt DeutschSpruchbuch 1639 Durheim', 'Heil Geist', 'Cöln', 'Stantz', 'Rathsbeschluss', 'Haspelgässli', 'Hilden', 'Buiyüorf', 'Scheidemauer', 'Preussen', 'Zürich Luzern', 'Heiligen Geist', 'Sant Vintzencien', 'Trachselwald', 'Aegerdon-Gasse', 'Stffis', 'Sulgeubachgegend', 'Kies', 'Judenthurm', 'Franziskanerkloster', 'Moos', 'Allmend Wankdorf', 'Nied SpitalDocumentenbuch Staatsarchiv Bern', 'Blatternhause', 'Dominikanerkloster', 'Alt-Udelbuch pag', 'Fontos', 'Tabor', 'Hessen', 'Romont', 'Egerdon-Gasse', 'Neuenegg', 'Schtteweg', 'DiesbachCapelle', 'Bern Anshehn', 'Jacobsherberge.276', 'Deutschen Ordens', 'Müslin', 'Matte', 'Pfalz', 'Schloss Holligen Messmer Burgerspital', 'Berns.81', 'Mnsters', 'Ehgraben', 'Mainmertshofen', 'Gmmenen', 'Schloss Vüfflens', 'Malters', 'Pfalzgrafen Rhein', 'Rebberg', 'Kapellbrcke', 'Kirchenscliatz', 'Bann', 'Deutschherren', 'Rümmlang', 'Ruventhal', 'Pferdeschwemme', 'Märitgasse', 'Avemaria', 'Ivng', 'Blumenstein', 'Oberes Thor', 'FrauenDominikanerklöster', 'Schill', 'Khlewyl', 'Bern Blatt Fontes', 'Archiv', 'Nideckbrücke', '- silithor', 'Wurstemborgcr Landschaft Born', 'Schloss Stäffis Hauptthurm Schloss Stäffis Vorwerk Schloss Büron Solothurn', 'Leutkirclie', '- cenzen-Chorherrenstift.146', 'Bach', 'Ulmer Thurmausbaues', 'Nothfalle', 'Breitenrains', 'Ostermundigenstein', 'llathhaus Räth', 'Wurstemberger Landschaft Bern', 'Grüneck', 'Anshelms', 'Klingenberg', 'Schloss Reichenbach', 'Münsterkirche', 'St.', 'Studors', 'Savoyens', 'Konolfmgen', 'Büttikon', 'Anslielm', 'Walthard Description Berne', 'Uebrigens', 'ponte nostro', 'Brwenliaus', 'Schatfhausen', 'Capelle', 'Born Liebenau', '- Sulgen', 'Rmmlang', 'Brückeneinganges', 'Tüchlin', 'Sumiswald Docunientbuch', 'Affenzunft', 'Stett', 'Mnsingen', 'Käfichthurm', 'Kienthal', 'Museum Berns', 'Pest', 'Haus Hof', 'Ltzelflh', 'Commercienhaus', 'Rathus', 'Bargen', 'Brüssel', 'Kriegsnoth', 'Solothnrn', 'Niedergerbern', 'Halde', 'Haus von Niedergerbern', 'Engelhof', 'Thürmchen', 'Valeria', 'Capelli Niederwangen', 'Tedlingen Frienisberg', 'Chrütz', 'Born Th', 'AegerdonGasse', 'Rh', 'Simmenthal', '- gasse', 'Spitalhof', 'Wallisern', 'Sitten', 'Frybourg', 'Giebelfagade', 'Rtschmund', 'Stadtkirche', 'WattenwylPourtalcs', 'Waarenbahn', 'Basel, ', 'Ursanne', 'Vincen', 'Böhmen', 'Schellhammers', 'Kirchhofs', 'Missiven', 'Sultan', 'Klosterkornhaus', 'Wonne', 'Peter', 'Jegistorf', 'Schauplatzgasse', 'Rossmarkt', 'Ramseierloch Nideckbrücke', 'Elsass-Burgund', 'Capelle St Michaelis Capelle', 'Aventicum', 'Forst', 'Vincenzenstift', 'Mittelalters Deutschland', 'Gren', 'Neubau', 'Yincenzen', '- cenzenschatz', 'Eschenbach', 'Riggisberg', 'St. Michael', 'Fluh', 'Leprose', 'Museum Bern', 'Thorfusses', 'Gras', 'Haus der Johanniter', 'Freiburg Breisgau', 'Neuenburg Hof', 'Rougemont', 'Nydeckbrcke', 'Erlaclierhofes', 'Canton Frybourg', 'Kanton', 'Ruhenthal', 'Bern Deutsch Ord', 'Rosengarten', 'Mslin', 'Helvetfen', 'Mhren', 'Mariencapelle', 'St Vinccnzentapete', 'Nord Süd', 'StUdtewesen', 'Aarwangen', 'Nydeck', 'Franceybad', 'Baar', 'Steinhölzli', 'Fusse', 'Säckingen', 'Born pag', 'Beatusbrunnen', 'Schützenmattbrünnlein', 'Münsterplatzes', 'Neuenegg Sternenberg', 'Rechberg', 'Könitzer Kirche', 'Nord', 'Kreuzgasse Ring', 'Thüringen'}",1120
16485496,101815,"{'Zilil', 'Schweiz', 'Italien', 'Neuenburg', 'Aarberg', 'Lindenhof', 'Freiburg', 'Ins', 'Bielersee', 'Michigan', 'Broye', 'Deutschland', 'Thorberg', 'Bernerland', 'Moosland', 'Siselen', 'Bern', 'Bieler', 'Monthey', 'Witzwil', 'Murtensees', 'Kerzerz', 'Tannenhof', 'Kallnach', 'Yorkshire', 'Belgien'}",26,"{'BernNeuenburg', 'Bielersees', 'Neuenburgersees', 'Schlake', 'Bureanx Bern', 'Grasansaat', 'Platanenhof Wohnhaus', 'Kußhof Wohnhaus', 'Ivöniz', 'Seestrandboden', 'Seestrandes', 'St Johannsen', 'Emmentals', 'Jura', 'Deutschland, SLOC', 'TaiHieilllOf', 'Lindenhof Wohnhaus', 'Wohlthat', 'Großen Mooses', 'GampelenCudrefinstraße', 'Avenigstens', 'Neuhof Wohnhaus', 'Wasserstraße', 'InsWitzwil'}",24,"{'Torfland', 'Landstrae', 'Lisclie', 'St. Witzwil', 'Torf', 'AYitzwil', 'Brenntorf', 'Hochmoor', 'Raygras', 'Gampelen-Cudrefinstrae', 'AVitzwil', 'Schilf', 'Pis', 'Bern-Neuenburg', 'Biel', 'Kies', 'Moos', 'Mooses', 'Deutschland, ', 'Ins-Witzwil', 'Tamraworth', 'Witzwyl', 'AIoos', 'Niederungsmoor', 'St. Bern', 'St. Johannsen', 'Liselie', 'Moose', 'Moosrasen', 'Pretorf', 'Gampelen'}",31,"{'Torfland', 'Bielersees', 'Schlake', 'Bureanx Bern', 'Grasansaat', 'Landstrae', 'Platanenhof Wohnhaus', 'Lisclie', 'Kußhof Wohnhaus', 'Brenntorf', 'Ivöniz', 'Raygras', 'Gampelen-Cudrefinstrae', 'Schilf', 'Pis', 'Seestrandes', 'Emmentals', 'Biel', 'Mooses', 'Deutschland, ', 'TaiHieilllOf', 'Lindenhof Wohnhaus', 'Tamraworth', 'Witzwyl', 'Niederungsmoor', 'Moose', 'Liselie', 'Avenigstens', 'Gampelen', 'Großen Mooses', 'InsWitzwil', 'BernNeuenburg', 'Neuenburgersees', 'St. Witzwil', 'Torf', 'AYitzwil', 'Hochmoor', 'AVitzwil', 'Seestrandboden', 'St Johannsen', 'Bern-Neuenburg', 'Jura', 'Kies', 'Deutschland, SLOC', 'Moos', 'Ins-Witzwil', 'Wohlthat', 'AIoos', 'GampelenCudrefinstraße', 'St. Bern', 'St. Johannsen', 'Moosrasen', 'Neuhof Wohnhaus', 'Pretorf', 'Wasserstraße'}",55
11025076,10991,"{'Schweiz', 'Kyburg', 'GurnigelS', 'Erlenbach', 'Thunersees', 'Thun', 'Kirchdorf', 'Scharnachthal', 'Bubenberg', 'Sicbethal', 'Thunersee', 'Thier', 'Genf', 'Doldenhorn', 'Burgund', 'Basel', 'Siebethal', 'Bern', 'WalliS', 'Schadau', 'Lausanne', 'GuggiSberg', 'Frutigen', 'Belpberg'}",24,"{'Stockhorn', 'Thierachern', 'May', 'Brandiö', 'Oberland, SLOC', 'Blumistein', 'Schloß Wimmis', 'BlümliSalp', 'Morize', 'Aar', 'Niesen', 'Gurnigelbad', 'Schloß Strätligen', 'Alpenketre', 'Amsoldingen', 'KyburgLauffenburg', 'Alpen Bern', 'Haus Oberhcrren', 'WimmiS', 'Dieser Berg', 'Zähringen', 'Sicbethalö', 'Thnnersec RechtS', 'Mauritius', 'Freyen Hof', 'Scherzlingcn', 'Schreckhorn'}",27,"{'- menthalS', 'Kyburg-Lauffenburg', 'Graffen', 'Marqmrd', 'Bubcnberg', 'Scharnach', 'Stockhorns', 'Weis', '- achcrn', '-', 'Sicbenthale', 'Bertha', 'Burgistcin', '- ricd', '- senburg', 'St. Burgund', 'Erlach', 'Brandi', '- thal', 'Berner', 'Oestreich', 'Bernern', 'Grusisperg', 'Gerzcnsee', 'Bern, ', 'Zhringen', 'Frutigcn', 'Lutcrnau', 'Sim', 'Alpen'}",30,"{'- menthalS', 'Kyburg-Lauffenburg', 'Stockhorn', 'Graffen', 'Thierachern', 'May', 'Brandiö', 'Marqmrd', 'Bubcnberg', 'Scharnach', 'Stockhorns', 'Oberland, SLOC', 'Blumistein', 'Weis', '-', '- achcrn', 'Schloß Wimmis', 'BlümliSalp', 'Sicbenthale', 'Morize', 'Bertha', 'Aar', 'Niesen', 'Burgistcin', '- ricd', 'Gurnigelbad', '- senburg', 'Schloß Strätligen', 'St. Burgund', 'Alpenketre', 'Amsoldingen', 'Erlach', 'KyburgLauffenburg', 'Brandi', 'Alpen Bern', '- thal', 'Berner', 'Oestreich', 'Haus Oberhcrren', 'WimmiS', 'Dieser Berg', 'Bernern', 'Grusisperg', 'Gerzcnsee', 'Sicbethalö', 'Bern, ', 'Zähringen', 'Zhringen', 'Frutigcn', 'Lutcrnau', 'Mauritius', 'Thnnersec RechtS', 'Freyen Hof', 'Sim', 'Alpen', 'Scherzlingcn', 'Schreckhorn'}",57
20313901,396339,"{'Neuengasse', 'Altenberg', 'Walt', 'Hauptgasse', 'Augsburg', 'Lan', 'Kesslergasse', 'Twann', 'Bubemberg', 'Litzi', 'Murten', 'Kyburg', 'Balm', 'Interlaken', 'Reichsburg Nideck', 'Krypta', 'Vechigen', 'Swartzenburgs', 'Freiburg', 'Marzili', 'Jordan', 'BERN', 'Stalden', 'Vienne', 'Schwanau', 'Nideckkirche', 'Kleinburgund', 'Europa', 'Muri', 'Gugler', 'Attiswil', 'Burgunds', 'Spitalgasse', 'Wangental', 'Kornmarkt', 'Avers', 'Hormanns', 'Schwarzenburg', 'Sulgenbach', 'Landerons', 'Lyon', 'Neapel', 'Berlin', 'Landshut', 'Friburg', 'Diesbach', 'Murtenstrasse', 'Aareufer', 'Oberhofen', 'Lausanne', 'Eisass', 'Tedlingen', 'Morges', 'Herrengasse', 'Schweiz', 'Zeughausgasse', 'Wabernstrasse', 'Ober', 'Bernerhof', 'Waadt', 'Gerechtigkeitsgasse', 'Predigergasse', 'Waldau', 'Kircli', 'Erlenbach', 'Oberes Spital', 'Tettingen', 'Rom', 'Freiburgstrasse', 'Strassburg', 'Schaffhausen', 'Oberdiessbach', 'Niklausen', 'Paris', 'Baden', 'Swaflantsgasse', 'Kirchdorf', 'Verona', 'Bubenberg', 'Orient', 'Kreuzgasse', 'Konstanz', 'Zurzach', 'Uetendorfberg', 'Allmendingen', 'Rodt', 'Nidouw', 'Burgund', 'Veielihubel', 'Ensing strasse', 'Burgdorfs', 'Wattenwil', 'Bern', 'Neuenstadt', 'Greierz', 'Wettingen', 'Viktoriastrasse', 'Florenz', 'Haag', 'Ulm', 'Egerdongasse', 'Junkerngasse', 'Murtensee', 'Breisgau', 'Aarbergergasse', 'Freiburgs', 'Signau', 'Frienisberg', 'Aare', 'Berne', 'Hindel', 'Sizilien', 'Savoyen', 'Kiental', 'Brunngasse', 'Luzern', 'Allmend', 'Brem', 'Aarstrasse', 'Solothurn', 'Burgdorf', 'Nydegg', 'Lindnach', 'Holligen', 'Bielersee', 'Genfergasse', 'Biel', 'Boiligen', 'Frankreich', 'Gerbergasse', 'Matte', 'Krauchtal', 'Genf', 'Ostrand', 'Grasburg', 'Bremgartenwaldes', 'Schosshalde', 'Fuss', 'Kirchgasse', 'Lieb', 'Schwyz', 'Abendland', 'Wabern', 'Bremgarten', 'Michaelsinsel', 'Brunnadern', 'Nirwen', 'Mariental', 'Alpen', 'Habsburg', 'Kiburg', 'Hochburgund', 'Turmau', 'Ligerz', 'Payerne', 'Postgasse', 'Bethlehem', 'Elfenau', 'Kalchegg', 'Bremgartenwald', 'Belp', 'Aarberg', 'Golattenmattgasse', 'Marktgasse', 'Berns', 'Stallikon', 'Bubengasse', 'Badgasse', 'Thun', 'Riieggisberg', 'Weissenstein', 'Grindelwald', 'Jura', 'Deutschland', 'Unterwalden', 'Thunstetten', 'Naples', 'Hasli', 'Rhein', 'Holligenstrasse', 'Gerenstein', 'Ostschweiz', 'Basel', 'Konstantinopel', 'Nideckturm', 'Aachen', 'Amthausgasse', 'Montenach', 'Reiclien', 'Homberg', 'Kramgasse', 'Gambach', 'Wimmis', 'Grasburg Laupen', 'Wallis', 'Stadtbach', 'Saane'}",197,"{'Wendelstein', 'Haus Köniz', 'Barfüsser', 'erinspita', 'Barfüsserkirdihof', 'Oberspital', 'Bern Burgund', 'Hotellaube', 'St Vincenzen Chorherren', 'Erlacherhof', 'Judengasse', 'Haus Haus', 'Bollingen', 'Einsiedeln', 'Käfigturm', 'Donnerbühl', 'Turmfuss', 'Rlide', 'Hasle Inderlappen Undersewen Frutigen', 'Arburg', 'Stetten', 'Holligen Der Fussweg', 'Michelistürli', 'Zofingen', 'Nideckbrücke', 'Aargaus', 'Dominikus', 'Bern Bern', 'St Petersinsel', 'Frienisbergerhauses', 'Deutschen Orden', 'Köniz', 'Sense Krongut', 'Martinimarktes', 'Ueberrest', 'Deutschordenshauses', 'Ruwental Ruhetal', 'Därstetten', 'Spital Oberes Spital', 'Judentor', 'Wädenswil', 'Köln', 'Schwarzwasser', 'Trambahnhofes', 'Murten Darin', 'Muristalden', 'Bernerlande', 'Ehehafte Benützungsrecht Steg', 'Bieler', 'Nideck Justinger', 'Hotel Pfistern', 'Haspelgässchens Felde', 'Fmtigen', 'Kapellenstrasse', 'Nideck', 'Simmentals', 'Münsingen', 'Opfingen', 'Franciscenordens', 'Gerwern', 'Münster', 'StaldenKlapperläubli', 'Oberbüren', 'Brunnmatt', 'Niessbrauch', 'Stadtbachs', 'Pfistern', 'Kirchenfeld Marzili', 'KirchgasseKesslergasse', 'NäherWabem', 'Dornbühl', 'Judenfriedhof', 'Grimsel', 'Dornhühl', 'Ufermauer', 'Prcdigcrklosters', 'Münsterfriedhof', 'Michahelistürli', 'KönizstrasseEffingerStrasse', 'Münchenbuchsee', 'Niederlanden', 'Gerberlaube', 'Basel Freiburg', 'Limpach Emme', 'Chorherrentreppe', 'Münchenwiler', 'Thun Burgdorf', 'Spital Geist', 'Schütteweg', 'Geistkirche', 'St Georgentag', 'Münsters', 'Hentschu', 'Hotellaube Zwiebelngässchen', 'NeuengasseRyffligäss', 'Simmental', 'Kirchhof', 'Schmieden III Metzgern', 'SchwäTzenburg', 'Der Berg', 'Oberwangen Jammertal', 'Bärenbrunnen', 'Morlotläubli', 'Brunnadern Erblehen', 'Laupen', 'Südabhanges', 'Oberhasli', 'Klösterli', 'Jegenstorf Hindelbank', 'Spitalackers', 'Diesbach Münsingen', 'Nr Kramgasse', 'Münsterbau Stein', 'KäfiggässchenWaghausgasse', 'Der Stadtbach', 'Gerberngrabens', 'Interlakenhaus', 'Weissenbühhveges', 'Swartzenburg', 'Yverdon Moudon', 'Tuchfenster', 'Gümmenen', 'Deutsche Haus', 'Staldens', 'Saanen', 'St Vin', 'Messmer Insel', 'Sulgenbach Schermen', 'UL', 'Bern Schweytzerland', 'St Jago Compostella Spanien', 'Köniz Bümpliz', 'Kleinen Schanze', 'Tschachtlans', 'Burgkapelle', 'Hessen', 'Konglocke', 'Nüwenstatt', 'Sulgen Köniz', 'Vogteischlössern', 'Diespaeh', 'Biglen Hochstetten', 'Lötschenbach', 'Heiliggeistkirche', 'Savoyer', 'Barfüsserordens', 'Siebenten Dreissigsten', 'Nürnberg', 'cenzenLeutkirche', 'Optingen Ober', 'St Vincenzen', 'Toiftfg Fraubrunnen', 'Egidius', 'Nideckhügel', 'Ostermundigen', 'Kirchgasseite', 'Schwerte', 'Hauptstrassenzug', 'stettbach', 'Seftigen Tedligen Spiez', 'Costentzer', 'Hist Museum', 'Nidecklaube', 'Westfront', 'Haus Stalden', 'Mattenenge', 'Palästina', 'Isenhutshaus', 'Murten Bern', 'ElsassBurgund', 'Stadtgrabenmauer', 'Wendelstein alz', 'Wohnburg', 'Dörnach', 'Niedersulgen', 'Hegau', 'Dittlingers', 'Hotels Bellevue', 'Zürich', 'Haus Savoyen', 'Torbergerhaus', 'Graßburg', 'Heiliggeistkirehe', 'Leutkirche', 'Eichwald', 'Giimmenens', 'Metzger', 'Johanneskirche', 'Marzilitor Ober', 'Mtkilchen', 'Rodt Verlag Frandce', 'Predigerkirche', 'Klosterkirche', 'SenseSaanelinie', 'Nideckbrückenanfahrt', 'Schegko', 'Berner Oberland', 'Arura Aare', 'Vergl Tiirler', 'Schänzli', 'Bürren', 'Bildhauer Maler', 'Minsters', 'Deutschordenshaus', 'Ritterschlag', 'Aarebrücke', 'Belpberg', 'Chorherrenstift', 'Waisenhausplatz Kornhaus', 'Welti Fontes', 'Aussdinitt', 'Armbrusterkapelle', 'brugg', 'St DominiciOrdens', 'Yperntuch Ellen', 'Scharnachtal Turm', 'Museum Vergl Rodt', 'Kirchhof Münsterplatz', 'bern', 'Altenberg Strassen', 'Weiberkefi', 'Louppen', 'Haus der Bela', 'Münsterbau', 'Bubenbergtürli', 'Christophoms', 'Der Münsterbau', 'Friedbühl', 'Amsoldingen', 'Nideckbriicke', 'Stettmühli', 'Obersimmental', 'Worblen', 'Bremgarten Muri', 'Das Münster', 'Bröwenhause', 'Seftigen', 'Golattenmattgassturm', 'Mosesbrunnens', 'Fischbank', 'Schlossgut Muri', 'Der Graben', 'BERN, SLOC', 'Zähringen', 'Bümpliz', 'Hofstatt', 'Weiler Nidegg', 'Predigertor', 'Aaremitte', 'Bätterkinden', 'Engehalbinsel', 'Haus Gerechtigkeitsgasse', 'Gasse', 'Wendelsteine', 'Barfüsserkirche', 'Rüeggisberg', 'Murten Gümmenen', 'Der Schultheiss', 'Neuenbürg', 'Galgenbühl', 'Thüringen'}",261,"{'Bieln', 'Hormannsgasse', 'Imobersteg', 'Junkern', 'Kornhaus', 'Unterwankdorf', 'Rotwil', 'Vincenzen-Mnsters', 'Zrich', '- steinquadem', 'Messmer', 'Commerce', '- lattenmattgasstor', 'St. Maria', '-', 'Fridau', 'Michaelstag', 'Rodts', 'Ehgrben.61', 'Jammertal', 'Mnchringen', 'Reichsgut', 'Kfiggsschen-Waghausgasse', 'Hindelbank', 'Nideck-Burggrabenbrcke', 'kaim', 'Vincenzenmnster', 'Udelzins', 'Schou', 'Drnach', 'Neuenbrg', 'Anshelm', 'Hochstetten', 'Acherum', 'Palstina', 'Sonnseite', '- dorfhlzli', '- bank', '- ligen', 'Zoll', 'Terfrid', 'Selanden', 'Limpach', 'Manuels', 'Esche', 'Ringoltingen', 'uffart', 'Rathaus', 'Reggisberg', 'St. Jago', 'Kirchhofs', 'Dreiberg', 'Petri', 'Harnischschau', 'Junkem', '- lantzgassen', 'Siechenhaus', 'Safoy', 'Weissenbhhveges', 'Yverdon', 'Scharnaehtal', 'Ltschenbach', 'Kniz', 'Fryburg', 'Schweli', 'Kngsfeld', 'Steffisburg', 'Srassburg', 'Baselwind', 'Welti', 'Erladi', 'Neuenburg', 'Juras', 'Kien', 'Nidegg', 'Bol', 'Brgg', 'Judica', 'Alp', 'Dornhhl', 'Wankdorffeld', '- berg', 'Seedorf', 'Bmpliz', 'Savoy', 'Batzen', 'Vincenzen', 'Chrtzgass', 'Kln', 'Schauplatzgasse', 'Erlach', 'Go', 'Inselgasse', 'Teutonia', 'Bellevue', 'Sulgen Kniz', 'Vincenzenkirche.70', 'Tunika', 'Stein', 'Mnchenwiler', 'Optingen', 'Elsass-Burgund', 'Beinhaus', 'Bernern', 'Romfart', 'Attinger', '- und Niedersulgen', 'aim', '- dorf', 'Holland', 'Rm', 'Zhringen', 'Klsterli', 'Crtzgasse', 'Neubau', '- bachwald', 'zirka', 'Georgentag', 'Gengenbach', 'Graburg', 'Emme', 'Burg', 'Ebenda', 'Diesbaeh', 'Kocher gasse', 'vonWattenwil', 'Tentenberg', 'Luxemburg', 'Crist', 'Zempi', 'Altschultheiss', 'Diebold', 'Ava', 'Vergl', 'SchwTzenburg', 'Rain', 'vincula', 'Speichergasse', 'Nwenstatt', 'Ehgrben', '- lantsgasse', 'Schnzli', 'Gras', 'Schtteweg', 'Schwaben', 'Ostermontag', 'Wippingen', 'Mnsingen', 'Mlinen', 'Jegenstorf', 'Zwingelhof', 'Mnchenbuchsee', 'Sekingen', '- deron', 'Schegkenbrunngasse', '- lingen', 'St. Petersinsel', 'Faucigny', '- cenzen-Leutkirche', 'Grimmenstein', 'Egerdon', 'Malatzy', 'Fischmarkt', 'St. Didier', 'Vincenzenkirche', 'Kanton', '- mnsters', 'Landeron', 'Biglen', 'Uri', 'Oberpfistem', 'Costenz', 'Egerdengassen', 'Nidau', 'Oberbren', 'Worb', 'Egerden', 'Burgenstein', 'Gurzelen', 'Martin', 'St. Petrus', 'Mnster', 'Jiuikerngasse', 'Niedergerbern', 'Mnsters', 'Vin', 'Hormannsgassen', 'Spanien', 'Bela lag', 'Kreuzgasse-Kirchgasse', 'Sachsen', 'Hyspanien', 'Solottorn', 'Knizstrasse-EffingerStrasse', 'Krsch', 'Tellrodel', '- bach', 'Krattingen', 'Fontes', 'Tenten', 'Schattseite', 'Tuf', 'Johanni', 'Aarebrcke', 'Schw', 'Schweytzerland', 'Niki', '- burg', 'Sulgen', 'Breitfeld', 'Drstetten', 'Mnsterfriedhof', 'Mhleberg Balm', 'obern Junkerngasse', 'Berner', 'Bern-Stadt', 'Altreu het', 'Utzigen', 'Berchtolds', '- cenzenbau', 'Gisenstein', 'Terfeten', 'Neuhaus', 'Mritgasse', 'Barfsserkirdihof', 'Mnsterplatz', 'Bern, ', 'Moudon', 'Bern Band', 'Bonstetten', 'Geissen', 'Aarau', 'Wyss', 'Ueten', 'Kirchhfli', 'Nrnberg', 'Gerberngraben', '- gasse', 'Kirchgasse-Kesslergasse', 'Thring', '- hard', 'Mies'}",242,"{'Hormannsgasse', 'Imobersteg', 'Junkern', 'Haus Köniz', 'Vincenzen-Mnsters', 'Barfüsserkirdihof', 'Oberspital', 'St Vincenzen Chorherren', '- lattenmattgasstor', 'Rlide', 'Mnchringen', 'Drnach', 'Neuenbrg', 'Martinimarktes', 'Anshelm', 'Deutschordenshauses', 'Ehehafte Benützungsrecht Steg', 'Hotel Pfistern', 'Fmtigen', 'Rathaus', 'Reggisberg', 'Dreiberg', '- lantzgassen', 'StaldenKlapperläubli', 'Brunnmatt', 'Oberbüren', 'Scharnaehtal', 'Ltschenbach', 'NäherWabem', 'Dornbühl', 'Judenfriedhof', 'Ufermauer', 'Gerberlaube', 'Limpach Emme', 'Nidegg', 'Bol', 'Brgg', 'Hentschu', 'Simmental', 'Kirchhof', 'Bärenbrunnen', 'Morlotläubli', 'Südabhanges', 'Savoy', 'Vincenzen', 'Chrtzgass', 'Erlach', 'Klösterli', 'Jegenstorf Hindelbank', 'Teutonia', 'Sulgen Kniz', 'KäfiggässchenWaghausgasse', 'Gerberngrabens', 'Der Stadtbach', 'Rm', 'Gümmenen', 'Burg', 'Bern Schweytzerland', 'Diesbaeh', 'Burgkapelle', 'Kocher gasse', 'vonWattenwil', 'Nüwenstatt', 'Ava', 'Nürnberg', 'Nwenstatt', 'Egidius', 'Zwingelhof', 'Haus Stalden', 'Palästina', 'Schegkenbrunngasse', 'ElsassBurgund', '- lingen', 'Zürich', 'Haus Savoyen', 'St. Didier', 'Torbergerhaus', 'Biglen', 'Uri', 'Worb', 'Bildhauer Maler', 'St. Petrus', 'Mnster', 'Armbrusterkapelle', 'Altenberg Strassen', 'Tellrodel', 'Weiberkefi', 'Fontes', 'Aarebrcke', 'Schweytzerland', 'Niki', 'Mhleberg Balm', 'obern Junkerngasse', '- cenzenbau', 'Gisenstein', 'Barfsserkirdihof', 'Zähringen', 'Bern Band', 'Wyss', 'Gasse', 'Kirchhfli', 'Gerberngraben', 'Murten Gümmenen', 'Kirchgasse-Kesslergasse', '- hard', 'Mies', 'Wendelstein', 'Kornhaus', '- steinquadem', 'Messmer', 'Commerce', 'Erlacherhof', 'Judengasse', 'Haus Haus', 'St. Maria', 'Bollingen', 'Einsiedeln', 'Donnerbühl', 'Turmfuss', 'Rodts', 'Ehgrben.61', 'Stetten', 'Michelistürli', 'Jammertal', 'Zofingen', 'Reichsgut', 'St Petersinsel', 'Schou', 'Hochstetten', 'Palstina', 'Spital Oberes Spital', 'Sonnseite', '- dorfhlzli', 'Judentor', 'Terfrid', 'Wädenswil', 'Köln', 'Trambahnhofes', 'Esche', 'Murten Darin', 'uffart', 'Bernerlande', 'Nideck Justinger', 'Yverdon', 'Pfistern', 'Kirchenfeld Marzili', 'KirchgasseKesslergasse', 'Grimsel', 'Dornhühl', 'Prcdigcrklosters', 'Srassburg', 'Baselwind', 'KönizstrasseEffingerStrasse', 'Erladi', 'Chorherrentreppe', 'Geistkirche', 'Judica', 'Alp', 'Münsters', 'Hotellaube Zwiebelngässchen', 'Dornhhl', 'NeuengasseRyffligäss', 'Brunnadern Erblehen', 'Inselgasse', 'Bellevue', 'Tunika', 'Stein', 'Mnchenwiler', 'Bernern', '- und Niedersulgen', 'Interlakenhaus', 'Weissenbühhveges', 'Deutsche Haus', 'Staldens', 'Saanen', 'St Vin', 'Messmer Insel', 'Emme', 'St Jago Compostella Spanien', 'Köniz Bümpliz', 'Tschachtlans', 'Hessen', 'Sulgen Köniz', 'Vergl', 'SchwTzenburg', 'Siebenten Dreissigsten', 'Speichergasse', 'cenzenLeutkirche', 'Optingen Ober', 'Schtteweg', 'Kirchgasseite', 'Wippingen', 'Seftigen Tedligen Spiez', 'Costentzer', 'St. Petersinsel', 'Niedersulgen', 'Graßburg', 'Heiliggeistkirehe', 'Leutkirche', 'Eichwald', 'Giimmenens', 'Oberpfistem', 'Mtkilchen', 'Klosterkirche', 'SenseSaanelinie', 'Nideckbrückenanfahrt', 'Arura Aare', 'Vergl Tiirler', 'Egerden', 'Burgenstein', 'Gurzelen', 'Martin', 'Minsters', 'Jiuikerngasse', 'Deutschordenshaus', 'Mnsters', 'Ritterschlag', 'Hormannsgassen', 'brugg', 'Scharnachtal Turm', 'bern', 'Knizstrasse-EffingerStrasse', 'Louppen', 'Tuf', 'Christophoms', 'Der Münsterbau', 'Friedbühl', '- burg', 'Nideckbriicke', 'Drstetten', 'Obersimmental', 'Bremgarten Muri', 'Das Münster', 'Schlossgut Muri', 'Bern, ', 'Hofstatt', 'Weiler Nidegg', 'Bonstetten', 'Engehalbinsel', 'Haus Gerechtigkeitsgasse', 'Barfüsserkirche', 'Nrnberg', 'Der Schultheiss', 'Neuenbürg', 'Galgenbühl', 'Unterwankdorf', 'Rotwil', 'Barfüsser', 'Bern Burgund', 'Hotellaube', '-', 'Hasle Inderlappen Undersewen Frutigen', 'Dominikus', 'Nideckbrücke', 'Aargaus', 'Kfiggsschen-Waghausgasse', 'Hindelbank', 'kaim', 'Vincenzenmnster', 'Deutschen Orden', 'Ruwental Ruhetal', 'Därstetten', '- bank', 'Zoll', 'Selanden', 'Schwarzwasser', 'Limpach', 'Manuels', 'Muristalden', 'Kapellenstrasse', 'Nideck', 'St. Jago', 'Simmentals', 'Opfingen', 'Münsingen', 'Franciscenordens', 'Junkem', 'Siechenhaus', 'Niessbrauch', 'Münchenbuchsee', 'Welti', 'Münchenwiler', 'Juras', 'Schmieden III Metzgern', 'SchwäTzenburg', 'Oberwangen Jammertal', '- berg', 'Bmpliz', 'Laupen', 'Batzen', 'Kln', 'Oberhasli', 'Spitalackers', 'Diesbach Münsingen', 'Romfart', 'Swartzenburg', 'Holland', 'Zhringen', 'Klsterli', '- bachwald', 'Graburg', 'Ebenda', 'Tentenberg', 'Luxemburg', 'Crist', 'Vogteischlössern', 'Diebold', 'Diespaeh', 'Lötschenbach', 'Heiliggeistkirche', 'Savoyer', 'Schnzli', 'Nideckhügel', 'Schwaben', 'Schwerte', 'Ostermontag', 'Hauptstrassenzug', 'Mnsingen', 'Nidecklaube', 'Mattenenge', 'Stadtgrabenmauer', 'Wohnburg', 'Faucigny', 'Hegau', 'Grimmenstein', 'Egerdon', 'Metzger', 'Vincenzenkirche', 'Johanneskirche', '- mnsters', 'Rodt Verlag Frandce', 'Predigerkirche', 'Oberbren', 'Schänzli', 'Niedergerbern', 'Belpberg', 'Bela lag', 'Kreuzgasse-Kirchgasse', 'Yperntuch Ellen', 'Museum Vergl Rodt', 'Kirchhof Münsterplatz', 'Solottorn', 'Krsch', '- bach', 'Haus der Bela', 'Schattseite', 'Bubenbergtürli', 'Schw', 'Sulgen', 'Amsoldingen', 'Mnsterfriedhof', 'Berner', 'Worblen', 'Altreu het', 'Bröwenhause', 'Utzigen', 'Fischbank', 'Berchtolds', 'Der Graben', 'Neuhaus', 'Mritgasse', 'Mnsterplatz', 'BERN, SLOC', 'Bümpliz', 'Moudon', 'Predigertor', 'Geissen', 'Aarau', 'Wendelsteine', 'Rüeggisberg', '- gasse', 'Bieln', 'erinspita', 'Zrich', 'Käfigturm', 'Fridau', 'Michaelstag', 'Arburg', 'Holligen Der Fussweg', 'Bern Bern', 'Nideck-Burggrabenbrcke', 'Frienisbergerhauses', 'Udelzins', 'Köniz', 'Sense Krongut', 'Ueberrest', 'Acherum', '- ligen', 'Ringoltingen', 'Bieler', 'Haspelgässchens Felde', 'Kirchhofs', 'Gerwern', 'Petri', 'Münster', 'Harnischschau', 'Safoy', 'Weissenbhhveges', 'Stadtbachs', 'Kniz', 'Fryburg', 'Schweli', 'Kngsfeld', 'Steffisburg', 'Münsterfriedhof', 'Michahelistürli', 'Niederlanden', 'Basel Freiburg', 'Neuenburg', 'Thun Burgdorf', 'Schütteweg', 'Kien', 'Wankdorffeld', 'St Georgentag', 'Der Berg', 'Seedorf', 'Schauplatzgasse', 'Go', 'Egerdengassen', 'Vincenzenkirche.70', 'Optingen', 'Elsass-Burgund', 'Beinhaus', 'Nr Kramgasse', 'Münsterbau Stein', 'Attinger', 'aim', 'Yverdon Moudon', '- dorf', 'Tuchfenster', 'Sulgenbach Schermen', 'UL', 'Crtzgasse', 'Neubau', 'zirka', 'Georgentag', 'Gengenbach', 'Kleinen Schanze', 'Konglocke', 'Zempi', 'Altschultheiss', 'Biglen Hochstetten', 'Barfüsserordens', 'Rain', 'vincula', 'Ehgrben', 'St Vincenzen', '- lantsgasse', 'Toiftfg Fraubrunnen', 'Gras', 'Ostermundigen', 'Mlinen', 'Jegenstorf', 'stettbach', 'Hist Museum', 'Mnchenbuchsee', 'Sekingen', '- deron', 'Westfront', 'Isenhutshaus', 'Murten Bern', 'Wendelstein alz', 'Dörnach', '- cenzen-Leutkirche', 'Dittlingers', 'Hotels Bellevue', 'Malatzy', 'Fischmarkt', 'Marzilitor Ober', 'Kanton', 'Landeron', 'Costenz', 'Nidau', 'Schegko', 'Berner Oberland', 'Bürren', 'Vin', 'Aarebrücke', 'Chorherrenstift', 'Spanien', 'Waisenhausplatz Kornhaus', 'Welti Fontes', 'Aussdinitt', 'Sachsen', 'St DominiciOrdens', 'Hyspanien', 'Krattingen', 'Tenten', 'Münsterbau', 'Johanni', 'Breitfeld', 'Stettmühli', 'Bern-Stadt', 'Seftigen', 'Golattenmattgassturm', 'Mosesbrunnens', 'Terfeten', 'Aaremitte', 'Bätterkinden', 'Ueten', 'Thring', 'Spital Geist', 'Thüringen'}",503
22615000,106554,"{'Hasel', 'Linth', 'Attishvlz', 'Waadt', 'Aare', 'Murten', 'Jerisberg', 'Neuenburg', 'Aarberg', 'Solo', 'schweiz', 'Solothurn', 'Freiburg', 'Wynau', 'Bielersee', 'Altreu', 'Oberaargau', 'Nennigkofen', 'Karlsruhe', 'Broye', 'Attisholz', 'Morgenthal', 'Aarbcrg', 'Rhein', 'Nicca', 'Meienried', 'Koblenz', 'Svlothurn', 'Murteu', 'Ridau', 'Bern', 'Staad', 'Nidau', 'Pieterlen', 'Estavayer', 'Aarethal', 'Murtensees', 'Aargau', 'Saane', 'Buren', 'Murtensee', 'Seeland'}",42,"{'bifurcation Aar', 'Neuenburgersee', 'Aar Sarine', 'Neuchâtel', 'canal Hageneek Aar', 'Bienne Neuchâtel Morat', 'Kaiitons Freiburg', 'Lüßligen', 'Sizung', 'Aar entre Berg Buren Staad', 'Büren', 'Zihl', 'Aare Saane', 'Oberaargaus', 'Ausfüh', 'Broye Alles', 'Bielersee AarbergHag', 'SuchardChallandes', 'Leußligen', 'AarbergHagenekkanal', 'BasseThièle', 'lac Bienne', 'Jura', 'Bern, SLOC', 'Aar entier', 'Lac Broyé', 'Sugiez', 'Alpes', 'Bundesgesez', 'Chevroux', 'Bienne', 'Soleure', 'Vollziehuugskommissiou', 'Mehrwerth', 'Aaare Leberberg', 'Aarbettes', 'Cantons', 'Cantons Bern', 'Gümmenen', 'lacs Morat Neuchâtel Bienne', 'Möser', 'BürenAttisholz', 'Hagnekkanal', 'Wangenried Berten', 'Canton', 'Waadt Freiburg', 'Pieterienmoos', 'BasseThièle Nidau'}",48,"{'Euime', 'Scherz', 'Leberberg', 'Brvye', 'cirka', 'Drbe-Moos', '-', 'Suchard-Challandes', '- see', 'Sau deck', 'Sauge', 'Frei brg', 'Frschelz', 'Br.ni', 'Blsch', 'Arch', 'Moosgegendcn', 'Sense', '- burg', 'Frei', 'Berten', 'Moos', '- burgersee', 'Neuenburger', 'Mooses', 'Pesta', 'Steinebachthal', 'Leuligen', 'Attis', '- moos', 'Kanton', '- thurn', 'Aarberg-Hag', 'Neuen brg', '- nekkanal', 'Bern, ', 'Frei brg Waadt', 'Berit', 'Pieterlentnoos', '- holz', 'Wangenried', 'olo thurn', 'Emme', 'St. Gallen', 'Bren', 'Bzberger'}",46,"{'bifurcation Aar', 'Aar Sarine', 'Leberberg', 'Kaiitons Freiburg', 'cirka', '-', 'Aar entre Berg Buren Staad', 'Suchard-Challandes', 'Zihl', '- see', 'Sauge', 'Frei brg', 'Frschelz', 'Ausfüh', 'Broye Alles', 'Blsch', 'Arch', 'Sense', 'Leußligen', 'Frei', 'Bern, SLOC', 'Aar entier', '- burgersee', 'Neuenburger', 'Mooses', 'Steinebachthal', 'Leuligen', 'Bundesgesez', 'Alpes', 'Kanton', '- thurn', 'Vollziehuugskommissiou', 'Mehrwerth', 'Cantons', '- nekkanal', 'Aarbettes', 'Cantons Bern', 'lacs Morat Neuchâtel Bienne', 'Berit', 'Pieterlentnoos', 'Hagnekkanal', 'Wangenried Berten', 'Canton', 'Wangenried', 'olo thurn', 'Bren', 'BasseThièle Nidau', 'Neuenburgersee', 'Euime', 'Scherz', 'Neuchâtel', 'Bienne Neuchâtel Morat', 'canal Hageneek Aar', 'Brvye', 'Drbe-Moos', 'Lüßligen', 'Sizung', 'Büren', 'Aare Saane', 'Sau deck', 'Oberaargaus', 'Br.ni', 'Bielersee AarbergHag', 'SuchardChallandes', 'AarbergHagenekkanal', 'Moosgegendcn', 'BasseThièle', '- burg', 'lac Bienne', 'Jura', 'Berten', 'Lac Broyé', 'Sugiez', 'Moos', 'Pesta', 'Attis', '- moos', 'Chevroux', 'Bienne', 'Aarberg-Hag', 'Soleure', 'Neuen brg', 'Aaare Leberberg', 'BürenAttisholz', 'Bern, ', 'Gümmenen', 'Möser', 'Frei brg Waadt', '- holz', 'St. Gallen', 'Emme', 'Waadt Freiburg', 'Pieterienmoos', 'Bzberger'}",94
8000232,155043,"{'Hirslandcn', 'Bricnzersee', 'Meiringens', 'Engstringen', 'Bleiringen', 'Lnzerir', 'Zollikon', 'Davos', 'Rurmaims', 'Sclamisott', 'Fischenthal', 'Amerika', 'Lungern', 'Ramsen', 'Ilntcrhallau', 'Samadcn', 'Jena', 'Meiringen', 'Muri', 'Acschi', 'Langnau', 'Neapel', 'Wipkingcn', 'Alpbachcs', 'Wintcr', 'Berlin', 'Sevelen', 'Maschwanden', 'Mciringens', 'Mciringen', 'Schweiz', 'Grimsel', 'Meningen', 'Ober', 'Waadt', 'Kloten', 'Italien', 'Haslethales', 'Fraucnfeld', 'Veltheim', 'Fluntern', 'Meiringcn', 'Paris', 'Ottcnbach', 'Ncuenstadt', 'Oalvsston', 'Sissach', 'Stein', 'Bern', 'Herisau', 'Algier', 'Staad', 'Saanen', 'Riffcrswcil', 'Dicpoldsau', 'England', 'Aargau', 'Obcrhaslc', 'Oberhaslc', 'Freudenstadt', 'Rotterdam', 'Gadmcn', 'Moskau', 'Oberhasle', 'Egg', 'Schwcllbrunn', 'Tamins', 'Ncukirch', 'Obcrhasle', 'Frankenhauscn', 'Langnan', 'Thal', 'Bellinzona', 'Frankreich', 'Griechenland', 'Mciringe', 'Hlnlenvalde', 'Genf', 'Grindctwald', 'London', 'Dlciringcns', 'Kirchgasse', 'Jenaz', 'Wabern', 'Kirchlindach', 'Schleins', 'Worb', 'Chur', 'Wordamerika', 'Meyringerhof', 'Chalais', 'Glarus', 'Liestal', 'Hedingen', 'Mettmcnstctteu', 'Rapperswhl', 'Alpbach', 'Ollon', 'Beringen', 'Turgi', 'Oberbalm', 'Wildegg', 'Schasshausen', 'Hausen', 'Langcnthal', 'Bnrgdorf', 'Baar', 'Brienz', 'Thun', 'Maloja', 'Guttanncn', 'Gstaad', 'Grindelwald', 'Hasleberg', 'Bergen', 'Waldkirch', 'Mcirinqen', 'Rndcnz', 'Scheidegg', 'Wciningen', 'Homberg', 'Meyringen', 'Wimmis', 'Haslebcrg'}",124,"{'Chalais Wallis', 'Kooista', 'Braudversicherungsanstalt', 'Basel Basel', 'Graubündcn', 'Belgien Niederlande', 'Naturschönheitcn', 'Haus Haus', 'Rudenz', 'Victoria', 'Setamisot', 'amcrika', 'Großen Rathe', 'Kerns Hötel Titlis Engelberg', 'Föhnstnrm', 'St Fiden', 'Bächtelcn', 'St Gallen Ragaz', 'OberMuhcn', 'Meiringen Eiseubolgen', 'Privatwohnnngc', 'Graubünden', 'Febr', 'Sächseln', 'Schulhans', 'BernFr', 'Münster', 'Schnlhans', 'Waschhaus', 'Amthanses', 'St Stephan', 'Hausen Thun Biet', 'Brod', 'Fr', 'Helfcns', 'Schattenhalb', 'SoodAdliswcil', 'Rämismühle', 'LiitzelfliihGoldbach', 'Rüti', 'Hütten', 'Wildcnman', 'Lerstch', 'Ehaurdefonds', 'Postburea', 'Rorcrsisr', 'Bern Stadt', 'Vuvsralsr', 'Ebnat', 'Nußbaumcn', 'Llont', 'Nontrsux', 'Rüschlikon', 'Hülfsconiitcs', 'Alignementspla', 'Loloßira', 'Comitcschatznng', 'Schöfflrsdorf', 'Wädensweil', 'Hanse', 'Aligncmentspla', 'Nürnberg', 'Rebstein Ladir', 'Montreux', 'Hombrcchtikon', 'Kiloqr', 'Bußnanq', 'Ringgcnberg Grindelwald', 'Lavasta 8anta Argentinien', 'Wildenmann', 'Nidau Zürich', 'Weichdachnngcn', 'Gasthöfc', 'Wiirglcr', 'Wimmis Acschi Jnterlaken', 'Mißrechnuug', 'Brandkassc', 'Amthans', 'Zürich', 'Gebäutichkcitcn Mciringen', 'Großen Rath Jan', 'England Griechenland', 'Oirarmsü', 'Alpbachschlucht', 'Irrthum', 'Vereinigten Brandkassc', 'Fcldbäckerci', 'Rcgicrnngsrathes', 'Feucrs', 'Kiesen', 'BnchsDorf', 'Zürichsec', 'Siechenplatz', 'Fiilfscoiniles', 'Apfclbänme', 'Kubikinhalt', 'Spiez', 'Oollsots', 'HiilfScomitcs', 'Aareschlucht', 'Rud Masse', 'Borwcisnng', 'Oulsns Roliallsiis', 'Wildcnmann', 'Pompeji', 'Albligen', 'Ausland Deutschland Frankreich', 'Bümpliz', 'Meningen, SLOC', 'Thnncrsee', 'DavoserZcitung', 'Südamerika', 'Bnndesrath', 'Matrazen', 'Rußland', 'Großen Rath', 'Brnnigbahn', 'ConcertErtrag'}",118,"{'Lnfclfingcn', 'Evang', 'Klein', 'Buchs', 'Thuriren', 'Bcatcnberg', 'Weggis', 'Wyl', 'Bliren', 'Fehrallorf', 'Kreuchen', 'Thapngcn', 'Pruntrut', 'Send', 'Herrlibcrg', 'Teslin', 'Zrichsce Send', 'Unterstra', 'Mnchen', 'Hinweil', 'Untcrheid', 'Bcrncrkolonie', 'Beuggcn', 'Rcnnwcg-Zrich', 'Altenbnrg', 'Lcnzbnrg', 'Schwarzenburg', 'Gcs', 'Basel-Stadt', 'tzelvetia', 'RuMno', 'Guttannc', 'Snrsec', 'Tablat', 'LiUbano', 'Schiipfheim', 'Fraucnfcld', 'Rtiinchlvcilen', 'Hirzcl', 'Sigrislvyl', 'Wer', 'Schwanden', 'Ostiasso', 'Oflrinqen', 'Wiuterthur', 'Zinilisberg', 'Rorbas', 'St. Stephan', 'Fidcris', 'Licbcsstencr', 'Wyachcngrabcn', 'Sood-Adliswcil', 'Diibcndorf', 'Zollbrck', 'BischoftzcU', 'Tesstn', 'Willisau', 'Winterthur', 'Ausland', 'Strcngclbach', 'Eriswyl', 'Jnncrtkirchen', 'Biet', 'Oicggisbcrg', 'Ireiburg', 'Erlach', 'St. Bcatenbcrg', 'Sarncn', 'Blnig', 'Scebcrg', 'Greifcnscc', 'Miillhcini', 'Helvoeia', 'Scenge', 'Neuenstadt', 'Obcrcntfeldc', 'Mtlischtzen', 'Walpersivhl', 'SchwarMbmg', 'Laufenburq', 'Schleithcim', 'Tessin', 'Graubndcn', 'Anstersihl', 'Ablentschen', 'Bcz', 'Vigls', 'Lanfenburg', 'Konolfingen', '8anta', 'Adclboden', 'Wezikon', 'Wichtrach', 'Gcrzcnsec', 'Murgcnthal', 'Horgcu', 'Huqclhofen', 'Murtcn', 'Meningen, ', 'Mhtethalwald', 'Bron', 'Gallen', 'Bcrncr-Kolvnic', 'Zuz', 'Tcuffcnthal', 'Wald', 'Frankfurt Leipzig', 'Andclfingen', 'Wengcrnalp', 'lten', 'Kulm-Rcinach', 'Sd', 'Loloira', 'Giswpl', 'Liitzelfliih-Goldbach', 'Romanshorn', 'Uri', 'Rothkrcuz', 'Cie', 'Rladrctsch', 'Emmishofcn', 'Falcheren', 'Rcfshauscn', 'Rothcnburg', 'Zrichsec', 'Biiuiplih', 'Natura', 'Schloivhl', 'Briittisellcn', 'Gschenen', 'Meikirch', 'Ger', 'Voqelsang', 'Messen', 'Biberach', 'Acgyptcn', 'Vren', 'Mnster', 'Hopflaniwald', 'Santiago', 'Lenzburg', 'Steinen', 'Jnncrtkirchcn', 'Dorfgasse', 'Bchtelcn', 'Leugnn', 'Zug', 'Iltcukirch', 'Bryner', 'Hottingcn', 'Rud', 'Uhenstorf', 'Grellingcn', 'Ncumnstcr', 'Irulianapolis', 'Kandergrund', 'St. Fiden', 'Gadmen', 'Auszersihl', 'St. Moritz', 'Brcmgartcn', 'avannss', 'Ostschweiz', 'Bnrqdorf', 'Obwalden', 'Blterkindcn', 'Turbcnthal', 'Mllheim', 'Villmcr', 'IlioMio', 'Dorncckbrugg', 'Nontlaucon', 'Crefcld', 'Ninncdvrs', 'Kulm', 'Alexandricn', 'Jsliko', 'Obcrricdcn', 'Nidwalden', 'Guofen', 'Valparaiso', 'Ddingen', 'Brunnen', 'Jscltwald', 'Schftland', 'Rorschach', 'Wdensweil', 'Oulsns', 'Heiden', 'Lattcrbach', 'RapperswUl', 'St. Maria', 'Schncuwerd', 'Thnrgau', 'Paulo', 'Snmiswald', 'Mlstau', 'Schlipfen', 'Brasilien', 'Alpnach', 'Aarburg', 'Zofingen', 'Sdamerika', 'Zraggcn', 'Mederlimineitthal', 'Meilen', 'Stalden', 'Argentinien', 'Ouater', 'Kriens', 'Berach', 'SchulcBerg', '^', 'Niederwcnigcn', 'Thalweil', 'St', 'Tnrbcnthat', 'Rodcrsdorf', 'Gstcig', 'Miinchwylcr', 'Brcnzikofcn', 'Richtcrsivcil', 'Aegeri', 'Fettan', 'Erlcnbach', 'Gallcr', 'Obcrhofcn', 'Mannenbach', 'Haslern', 'Schaffhauscn', 'Hofstetten', 'Bren', 'Lenzbnrg', 'Obersiinmenthal', 'Bnchs-Dorf', 'Dresden', 'Rmismhle', 'Ursenbach', 'Bnrgschi', 'reiburg', 'A.', 'Bern.Fr', 'Berncr', 'Basel-Land', 'Lichtenstcin', 'Baselland', 'Dbendorf', 'Ztg', 'Stroppcl', 'Trachselwald', 'Sannen', 'Worblaufen', 'Oranson', 'Ooeuanx', '- Kiesen', 'Fraubrunnen', 'Oorninnno', 'Knrzdorf', 'Obsee', 'Baden', 'Gontcnschwbl', 'LLetzikon', 'Hirschthal', 'Othmarsingcn', 'Thurgau', 'Luzerncr', 'Rtaycnfeld', 'Zrnrgdors', 'iltont', 'Grindclwald', 'Illinois', 'Frciburg', 'Riedtwhl', 'Meili', 'Oberstra-Zrick', 'llovkrao', 'Muhen', 'Hnibach', 'Riedernz', 'Ocrlikon', 'Klaras', 'Dern', 'Regsauschachen', 'Sind', 'Birkcnthalwald', 'Slraburg', 'Dlciringcn', 'Ges', 'Jelsberg', 'Ninoolru', 'Urtsoturk', 'Thayngen', '- gcrlafingcn', 'Hohflnh', 'Wildeqq', 'Oinoinnati', 'Stilli', 'Vitznan', 'Hasle', 'Signau', 'Octweil', 'Kourtelarq', 'Nouou', 'Weyland', 'Grlitz', '- lafingcn', 'Brgger', 'Nubaumcn', 'Burgdorf', 'Seehof', 'Gladbach', 'Mrniaugci', 'Ringgcnbcrg', 'Jnsclhtcl', '- rucd', 'Itnterwalden', '- thur', 'Appcnzell', 'Hephata', 'Ovilo', 'Biciringen', 'Wicdikon', 'Rhcinfelden', 'Rhcinprovinz', 'Obcrricd', 'Bnselland', 'Zofinqc', 'Nteiringen', 'Roscnlauibad', 'liulls', 'Rcichenbach', 'Jnkwhl', 'Geltcr', 'vi', 'Rheiuthal', 'Jesum', 'InonFrciburg', 'Belp', 'Aarberg', 'Arleshcim', 'Lrachsclwald', 'Langenthal', 'Enge Send', 'Malters', 'Htten', 'Bcni', 'Tcssin', 'Sarvin', 'Jnterlaken', 'Lanpe', 'Schlvyz', 'Graubnden', 'Summ', 'DielSdorf', 'Niedersimmenthal', 'Rdcrswyl', 'Krcischa', 'Nrnberg', 'Vrnntrnt', 'Greifswald', 'Bumn', '- hasle', 'stein', 'Nicdersch', 'Lenk', 'Assvltcrn', 'Reinach', 'Niederlande', 'Murten', 'Jegcnstorf', '-', 'Gn', 'Richtersweil', 'Dollikon', 'Kirchbcrg', 'Freiburg', 'llntcrsecn', 'Holz', 'Ryken', 'Mcy', 'I-ranbrnnnen', 'Wagenhausen', 'Gisikon', 'Schmitten', 'Wcnoclshcim', 'Bnszland', 'Oberricd', 'Selzach', 'Laufen', 'Bergn', 'Berneck', '- und Nieder', 'Gttingcn', '- lienvercin', 'Rhcinfcldcn', 'Nsels', 'Sennwald', 'Meiringe', 'Urnsch', 'Weiningen', 'Davos-Platz', 'Sccgrbcn', 'Straburg', 'Secwis', 'Ringgenbcrg', 'Krcuzlinqcn', 'Hcrisau', 'Frauenfcld', 'Morschach', 'Appen', 'Altdorf', 'Jgis', 'Kilchbcrg', 'Alairis', 'Bayern', 'Eisenbolgen', 'ThttN', 'Gcscllsch', 'Wollishofen', 'Ziclcbach-Obcr', '- berg', 'Rhcinfeldcn', 'Bmpliz', 'St.', 'Rcbstcin', 'Laupen', 'Walzenhauscn', 'Melgien', 'Volksst', 'Nicdcrlenz', 'Leiigcn', 'llztvnl', 'Konstanz', 'Hirzel', 'Delsberg', 'Rschlikon', 'lVIustaxlia', 'Obcrriedcn', '- Wyl', 'Wigoldingcn', 'Balsthal', 'Snlzniall', 'Luzcrn', 'Obcrstra', 'Knacht', 'Mcnzingen', 'Schtzen', 'Diemerswyl', 'Schmyz', 'Lstlingen', 'Metlincnstcltcn', 'Wildersivhl', 'Ennctbrgcn', 'Iosolavo', 'Wattwyl', 'Galleu', 'Snfemvnl', 'Aarwangcn', 'F-ebr', 'Luzern', 'AttiSwhl', 'Mittelamerika', 'Airolo', 'Reigoldswhl', 'Madiswpl', 'Riiegsau', 'Hofwyl', 'Seen', 'Otiindlischwand', 'Lrrach', 'Gcmcinntz', 'Freibergcn', 'Biel', 'Scelisberg', 'Gebern', 'Bottenwyl', 'Raulinss', 'Konstanzcr', 'Habstetten', 'Kappe', 'Ncucnegg', 'Balstbal', 'Ladir', 'Riiti', 'Wyna', 'Delsbcrg', 'Scvclen', 'Glarncrvcrein', 'Clioins', 'Stadtkasic', 'Unlcrbach', 'Norschach', 'Schwyz', 'Lauf', 'Varia', 'Diebbach', 'Nenenstadl', 'Eggiwrst', 'Seon', 'Frcibnrg', 'Belgien', 'Schochcrswyl', 'Biilach', 'Gro', 'Rschegg', 'T', 'Stallikon', 'Gcm', 'Rohr', 'Lavasta', 'Kantons', 'Calsrina', 'Wcngi', 'Ncnhanscn', 'Obcrwyl', 'Aarg', 'Griitlivcrcin', 'Jnnertkirchcn', 'Solothurncr', 'Obwaldcn', 'Sigitau', 'Wohlhnusen', 'Lhach', 'Suhr', 'Nidwaldcn', 'Basel', 'Bricnz', 'Secgrbcn', 'Courtelary', 'Schweiz.', 'Oftringen', 'Helvctia', 'Rh', 'Pfr', 'Mnsapolis', 'Bern-Land', 'MolliS', 'Neu', 'Aarau', 'HeriSau', 'Grstfcld', 'Rheiiihcssen', 'Buren', 'Pruntrnl', 'Amriswql', 'Petersburg', 'Schwarzen brg', 'Tagbl', 'Zrich', 'Waldcnburg', 'Hittnau', 'OastasoZira', 'Tnrgi', 'Brugg', 'Obcrburg', 'liviran', 'Wylerli', '- see', 'Zcininqen', 'Grabs', 'Schuls', 'Gernsbach', 'Gyscnstein', 'Honcgger', 'Adliswyl', 'Laax', 'Rheineck', 'Riesbach', 'Arth', 'Schinznach', 'Hintcrcgg', 'Baselstadt', 'Ragaz', 'AppcnzcllA.', 'Ruland', 'Hombrechtikon', 'Enge-Zrich', 'Athen', 'Hauskoll', 'Rcucnstndt', 'Gbersmunenthal', 'Erlnch', 'Ziefcn', 'Mogels', 'Luzcin', 'Ncigoldstvnl', 'Offenbach', 'Staus', 'Udligenschivyl', 'Frutigen', 'Kllikcr', 'Ridnu', 'Stettlen', 'Oberstocken', '- ringcn', 'Nordamerika', 'Kniz', 'Heimenschwand', 'Aaran', 'Wrttemberg', 'Steffisburg', 'Riehen', 'Weilingen', 'Jnterlakcn', 'Cham', 'Schiipfhcim', 'Thierachcrn', 'Iltznach', 'Neuenburg', 'Oiattikon', 'Rom', 'Horgcn', 'Walda Wohlen', 'Schaffhausen', 'Muntern', 'Schaffhauseu', 'Appcnzcll', 'Schfflrsdorf', 'Frntigcn', 'Bubendorf', '- thal', 'Rnschlikon', 'Schtvyz', 'Biber', 'Mcnstken', 'Zrick', 'Brittnau', 'Badcner', 'Uster', 'Kaltbrunn', 'Goldswhl', 'Grub', 'Saanm', 'Wangen', 'Beatenberg', 'Lcuqqcrn', 'Grtlivercin', 'Lcnzigc', 'Mnnedorf', 'Jnnertkirchen', 'Schlo', 'Lozwpt', 'Riiti-Tann', 'Bcnken', 'Iratigm', '8anlsy', 'Marlhalen', 'Mnchaltorf', 'Rain', 'Oortaillod', 'Quodlibet', 'pontrsmna', 'Schwarzcncgg', 'Bzbcrg', 'Wolsbalden', 'Echo', 'Degersbcini', 'Altstcttcn', '- ninger', 'Aarbarq', 'Solothurn', 'Liverpool', 'Stnttgart', 'Hinter-Egg', 'Rahnfliih', 'Midau', 'Schaffhansen', 'Osnua', 'Ennetbadcn', 'Lcnzburg', 'Pfffikon', 'Goldaucrn', 'Aargauer', 'Safenwyl', 'Bascllandschaftl', 'Mcttmen', 'Blaun', 'Embrnch', 'Appenzell', 'Rosenberg', 'Nidau', 'parnnxin', 'Zollikofcn', 'Mnchcnbuchsce', 'Trimbach', 'Lauterbrunncn', 'Stfa', 'Odessa', 'Rohrdorf', 'Menziken-Burg', 'Zlvei', 'Kllikcn', 'Sumnm', 'GraSwyl', 'Walliscllcn', 'Aadorf', 'Aarwangen', 'Bcrncr', 'Snlzbcrg', 'Rothrist', 'Grtlivcrcin', 'Matten', 'Imiar', 'Dictwpl', 'Utzwyl', 'Ilinlsrvelier', 'Manncrchor', 'Gais', 'Flawpl', 'Lammen', 'Deutschland', 'Bibcrstcin', 'Huttwril', 'Bern-Stadt', 'Groffaffoltcrn', 'Seftigen', 'Frth', 'Goldswyl', 'Wnngcn', 'Olultsau', 'Cci', '- 449 amcrika', 'Meirittgen', 'Ringgcnberg', 'Klingnau', 'Ulr.Stcudlcr', '8inppcrSiv', 'Bricnzwylcr', 'Wollishofeu', 'Oirarms', 'Tuttlingen', 'Leutwyl', 'Ober-Muhcn', 'Mnnchcnbuchsce', 'Pcstalozzi', 'St. Gallen', 'Leipzig', 'Emnicnbriicke', 'Hcrzogenbuchsec', 'Pietcrlen', 'Wallis', 'Gsgcn', 'Rti'}",743,"{'Chalais Wallis', 'Lnfclfingcn', 'Evang', 'Basel Basel', 'Graubündcn', 'Klein', 'Buchs', 'Thuriren', 'Bcatcnberg', 'Naturschönheitcn', 'Weggis', 'Wyl', 'Victoria', 'Bliren', 'Fehrallorf', 'Kreuchen', 'Thapngcn', 'Pruntrut', 'Send', 'Herrlibcrg', 'Teslin', 'Zrichsce Send', 'Unterstra', 'Mnchen', 'Hinweil', 'Untcrheid', 'Bcrncrkolonie', 'Beuggcn', 'Rcnnwcg-Zrich', 'Altenbnrg', 'Lcnzbnrg', 'Schwarzenburg', 'Gcs', 'Basel-Stadt', 'tzelvetia', 'RuMno', 'Guttannc', 'Snrsec', 'Tablat', 'LiUbano', 'Schiipfheim', 'Fraucnfcld', 'Rtiinchlvcilen', 'Hirzcl', 'Sigrislvyl', 'Wer', 'Sächseln', 'Schwanden', 'Ostiasso', 'BernFr', 'Oflrinqen', 'Waschhaus', 'Wiuterthur', 'St Stephan', 'Zinilisberg', 'Rorbas', 'St. Stephan', 'Fidcris', 'Fr', 'Licbcsstencr', 'Wyachcngrabcn', 'Sood-Adliswcil', 'Diibcndorf', 'Zollbrck', 'BischoftzcU', 'Tesstn', 'LiitzelfliihGoldbach', 'Willisau', 'Winterthur', 'Ausland', 'Strcngclbach', 'Eriswyl', 'Wildcnman', 'Jnncrtkirchen', 'Biet', 'Oicggisbcrg', 'Ehaurdefonds', 'Ireiburg', 'Erlach', 'St. Bcatenbcrg', 'Rorcrsisr', 'Sarncn', 'Blnig', 'Scebcrg', 'Greifcnscc', 'Miillhcini', 'Helvoeia', 'Nußbaumcn', 'Scenge', 'Neuenstadt', 'Llont', 'Obcrcntfeldc', 'Mtlischtzen', 'Walpersivhl', 'Rüschlikon', 'SchwarMbmg', 'Laufenburq', 'Schleithcim', 'Tessin', 'Graubndcn', 'Anstersihl', 'Ablentschen', 'Alignementspla', 'Bcz', 'Loloßira', 'Schöfflrsdorf', 'Vigls', 'Hanse', 'Lanfenburg', 'Konolfingen', '8anta', 'Adclboden', 'Wezikon', 'Nürnberg', 'Wichtrach', 'Gcrzcnsec', 'Murgcnthal', 'Horgcu', 'Huqclhofen', 'Murtcn', 'Meningen, ', 'Mhtethalwald', 'Bron', 'Gallen', 'Bcrncr-Kolvnic', 'Zuz', 'Tcuffcnthal', 'Wald', 'Frankfurt Leipzig', 'Andclfingen', 'Wengcrnalp', 'lten', 'Kulm-Rcinach', 'Sd', 'Zürich', 'Loloira', 'Giswpl', 'Liitzelfliih-Goldbach', 'Romanshorn', 'Uri', 'Rothkrcuz', 'Cie', 'Emmishofcn', 'Falcheren', 'Rcfshauscn', 'Rothcnburg', 'Zrichsec', 'Biiuiplih', 'Natura', 'Schloivhl', 'Briittisellcn', 'Gschenen', 'Meikirch', 'Ger', 'Voqelsang', 'Messen', 'Biberach', 'Acgyptcn', 'Vren', 'Mnster', 'Hopflaniwald', 'Santiago', 'Lenzburg', 'Steinen', 'Jnncrtkirchcn', 'Dorfgasse', 'Bchtelcn', 'Zürichsec', 'Leugnn', 'Zug', 'Iltcukirch', 'Fiilfscoiniles', 'Bryner', 'Hottingcn', 'Rud', 'Spiez', 'Rud Masse', 'Uhenstorf', 'Grellingcn', 'Ncumnstcr', 'Irulianapolis', 'Kandergrund', 'Oulsns Roliallsiis', 'St. Fiden', 'Gadmen', 'Auszersihl', 'St. Moritz', 'Brcmgartcn', 'Ausland Deutschland Frankreich', 'avannss', 'Ostschweiz', 'Bnrqdorf', 'Obwalden', 'Blterkindcn', 'Turbcnthal', 'Mllheim', 'Villmcr', 'IlioMio', 'Dorncckbrugg', 'Nontlaucon', 'Crefcld', 'Ninncdvrs', 'Kulm', 'Alexandricn', 'Jsliko', 'Obcrricdcn', 'Nidwalden', 'Guofen', 'Valparaiso', 'Ddingen', 'Brnnigbahn', 'ConcertErtrag', 'Brunnen', 'Jscltwald', 'Schftland', 'Rorschach', 'Wdensweil', 'Oulsns', 'Heiden', 'Haus Haus', 'Lattcrbach', 'RapperswUl', 'Schncuwerd', 'Thnrgau', 'St. Maria', 'Snmiswald', 'Gsgcn', 'Schlipfen', 'Mlstau', 'Brasilien', 'Rudenz', 'amcrika', 'Großen Rathe', 'Alpnach', 'Aarburg', 'Zofingen', 'Sdamerika', 'Zraggcn', 'Mederlimineitthal', 'Meilen', 'Stalden', 'Argentinien', 'Ouater', 'Kriens', 'Berach', 'SchulcBerg', '^', 'Niederwcnigcn', 'Thalweil', 'Tnrbcnthat', 'Rodcrsdorf', 'St', 'Gstcig', 'Miinchwylcr', 'Graubünden', 'Brcnzikofcn', 'Richtcrsivcil', 'Aegeri', 'Fettan', 'Schulhans', 'Erlcnbach', 'Gallcr', 'Obcrhofcn', 'Mannenbach', 'Haslern', 'Schaffhauscn', 'Hofstetten', 'Bren', 'Lenzbnrg', 'Obersiinmenthal', 'Bnchs-Dorf', 'Brod', 'Ursenbach', 'Bnrgschi', 'reiburg', 'Rmismhle', 'Helfcns', 'A.', 'Bern.Fr', 'Berncr', 'Basel-Land', 'Lichtenstcin', 'Großen Rath', 'Baselland', 'Dbendorf', 'Ztg', 'Stroppcl', 'Trachselwald', 'Sannen', 'Worblaufen', 'Ooeuanx', '- Kiesen', 'Oranson', 'Fraubrunnen', 'Oorninnno', 'Knrzdorf', 'Obsee', 'Baden', 'Gontcnschwbl', 'LLetzikon', 'Hirschthal', 'Othmarsingcn', 'Thurgau', 'Luzerncr', 'Hütten', 'Rtaycnfeld', 'Zrnrgdors', 'iltont', 'Grindclwald', 'Illinois', 'Frciburg', 'Riedtwhl', 'Meili', 'Oberstra-Zrick', 'llovkrao', 'Muhen', 'Hnibach', 'Riedernz', 'Ocrlikon', 'Klaras', 'Dern', 'Regsauschachen', 'Sind', 'Birkcnthalwald', 'Slraburg', 'Dlciringcn', 'Ges', 'Jelsberg', 'Ninoolru', 'Urtsoturk', 'Thayngen', '- gcrlafingcn', 'Hohflnh', 'Wildeqq', 'Wädensweil', 'Oinoinnati', 'Stilli', 'Vitznan', 'Hasle', 'Signau', 'Octweil', 'Kourtelarq', 'Nouou', 'Weyland', 'Grlitz', '- lafingcn', 'Brgger', 'Rebstein Ladir', 'Montreux', 'Nubaumcn', 'Burgdorf', 'Bußnanq', 'Wildenmann', 'Nidau Zürich', 'Seehof', 'Gladbach', 'Mrniaugci', 'Brandkassc', 'Amthans', 'Ringgcnbcrg', 'Jnsclhtcl', '- rucd', 'Gebäutichkcitcn Mciringen', 'Itnterwalden', '- thur', 'Appcnzell', 'Hephata', 'Ovilo', 'Biciringen', 'Wicdikon', 'Rhcinfelden', 'Rhcinprovinz', 'Obcrricd', 'Bnselland', 'Zofinqc', 'Nteiringen', 'Roscnlauibad', 'Rcgicrnngsrathes', 'liulls', 'Rcichenbach', 'Jnkwhl', 'Geltcr', 'vi', 'Rheiuthal', 'Siechenplatz', 'Jesum', 'InonFrciburg', 'Belp', 'Aarberg', 'Arleshcim', 'Lrachsclwald', 'Langenthal', 'Enge Send', 'Malters', 'Htten', 'Bcni', 'Tcssin', 'Sarvin', 'Borwcisnng', 'Jnterlaken', 'Albligen', 'Lanpe', 'Schlvyz', 'Graubnden', 'Summ', 'DielSdorf', 'Niedersimmenthal', 'DavoserZcitung', 'Rdcrswyl', 'Krcischa', 'Nrnberg', 'Vrnntrnt', 'Rti', 'Greifswald', 'Bumn', '- hasle', 'stein', 'Nicdersch', 'Lenk', 'Assvltcrn', 'Reinach', 'Kooista', 'Niederlande', 'Murten', 'Jegcnstorf', '-', 'Gn', 'Richtersweil', 'Dollikon', 'Kerns Hötel Titlis Engelberg', 'Kirchbcrg', 'Freiburg', 'St Fiden', 'llntcrsecn', 'Holz', 'Ryken', 'Bächtelcn', 'OberMuhcn', 'Mcy', 'Paulo', 'I-ranbrnnnen', 'Wagenhausen', 'Gisikon', 'Schmitten', 'Privatwohnnngc', 'Wcnoclshcim', 'Bnszland', 'Oberricd', 'Selzach', 'Laufen', 'Bergn', 'Febr', 'Berneck', '- und Nieder', 'Gttingcn', '- lienvercin', 'Rhcinfcldcn', 'Nsels', 'Sennwald', 'Meiringe', 'Urnsch', 'Weiningen', 'Davos-Platz', 'Sccgrbcn', 'Straburg', 'Secwis', 'Ringgenbcrg', 'Krcuzlinqcn', 'Hcrisau', 'Frauenfcld', 'Morschach', 'Appen', 'Altdorf', 'Jgis', 'Schattenhalb', 'Kilchbcrg', 'SoodAdliswcil', 'Rämismühle', 'Alairis', 'Bayern', 'Eisenbolgen', 'ThttN', 'Gcscllsch', 'Wollishofen', 'Ziclcbach-Obcr', '- berg', 'Rhcinfeldcn', 'Bmpliz', 'St.', 'Rcbstcin', 'Laupen', 'Walzenhauscn', 'Melgien', 'Volksst', 'Nicdcrlenz', 'Leiigcn', 'llztvnl', 'Konstanz', 'Postburea', 'Hirzel', 'Delsberg', 'Rschlikon', 'lVIustaxlia', 'Obcrriedcn', '- Wyl', 'Wigoldingcn', 'Balsthal', 'Bern Stadt', 'Snlzniall', 'Vuvsralsr', 'Luzcrn', 'Obcrstra', 'Knacht', 'Mcnzingen', 'Nontrsux', 'Schtzen', 'Diemerswyl', 'Schmyz', 'Hülfsconiitcs', 'Lstlingen', 'Metlincnstcltcn', 'Wildersivhl', 'Ennctbrgcn', 'Iosolavo', 'Wattwyl', 'Galleu', 'Snfemvnl', 'Aarwangcn', 'F-ebr', 'Hombrcchtikon', 'Luzern', 'AttiSwhl', 'Mittelamerika', 'Airolo', 'Reigoldswhl', 'Kiloqr', 'Madiswpl', 'Riiegsau', 'Hofwyl', 'Seen', 'Otiindlischwand', 'Lrrach', 'Gcmcinntz', 'Freibergcn', 'Biel', 'Scelisberg', 'Gebern', 'Bottenwyl', 'Raulinss', 'Konstanzcr', 'Weichdachnngcn', 'Gasthöfc', 'Wimmis Acschi Jnterlaken', 'Mißrechnuug', 'Habstetten', 'Kappe', 'Ncucnegg', 'Ladir', 'Riiti', 'Wyna', 'Delsbcrg', 'Scvclen', 'Balstbal', 'Glarncrvcrein', 'Clioins', 'Stadtkasic', 'Großen Rath Jan', 'Unlcrbach', 'Norschach', 'Schwyz', 'Lauf', 'Oirarmsü', 'Varia', 'Alpbachschlucht', 'Irrthum', 'Vereinigten Brandkassc', 'Diebbach', 'Nenenstadl', 'Eggiwrst', 'Seon', 'Frcibnrg', 'Feucrs', 'Belgien', 'Schochcrswyl', 'Kiesen', 'Biilach', 'Gro', 'Rschegg', 'T', 'Stallikon', 'Gcm', 'Rohr', 'HiilfScomitcs', 'Lavasta', 'Kantons', 'Aareschlucht', 'Calsrina', 'Wcngi', 'Ncnhanscn', 'Obcrwyl', 'Aarg', 'Griitlivcrcin', 'Jnnertkirchcn', 'Solothurncr', 'Obwaldcn', 'Sigitau', 'Wohlhnusen', 'Lhach', 'Suhr', 'Nidwaldcn', 'Basel', 'Bricnz', 'Bümpliz', 'Secgrbcn', 'Meningen, SLOC', 'Courtelary', 'Thnncrsee', 'Schweiz.', 'Oftringen', 'Südamerika', 'Helvctia', 'Rh', 'Pfr', 'Mnsapolis', 'Bern-Land', 'MolliS', 'Neu', 'Aarau', 'Matrazen', 'HeriSau', 'Grstfcld', 'Rheiiihcssen', 'Buren', 'Pruntrnl', 'Amriswql', 'Petersburg', 'Braudversicherungsanstalt', 'Schwarzen brg', 'Tagbl', 'Zrich', 'Hittnau', 'Waldcnburg', 'Belgien Niederlande', 'OastasoZira', 'Tnrgi', 'Brugg', 'Obcrburg', 'liviran', 'Wylerli', '- see', 'Zcininqen', 'Grabs', 'Schuls', 'Setamisot', 'Gernsbach', 'Föhnstnrm', 'Gyscnstein', 'Honcgger', 'Adliswyl', 'Laax', 'Rheineck', 'Riesbach', 'Arth', 'Schinznach', 'Hintcrcgg', 'St Gallen Ragaz', 'Baselstadt', 'Meiringen Eiseubolgen', 'Ragaz', 'AppcnzcllA.', 'Ruland', 'Hombrechtikon', 'Enge-Zrich', 'Athen', 'Hauskoll', 'Rcucnstndt', 'Gbersmunenthal', 'Erlnch', 'Ziefcn', 'Mogels', 'Luzcin', 'Münster', 'Ncigoldstvnl', 'Offenbach', 'Schnlhans', 'Amthanses', 'Staus', 'Udligenschivyl', 'Frutigen', 'Kllikcr', 'Ridnu', 'Stettlen', 'Oberstocken', '- ringcn', 'Nordamerika', 'Hausen Thun Biet', 'Kniz', 'Heimenschwand', 'Aaran', 'Wrttemberg', 'Steffisburg', 'Riehen', 'Weilingen', 'Jnterlakcn', 'Cham', 'Schiipfhcim', 'Thierachcrn', 'Iltznach', 'Neuenburg', 'Oiattikon', 'Rom', 'Horgcn', 'Walda Wohlen', 'Rüti', 'Schaffhausen', 'Muntern', 'Lerstch', 'Schaffhauseu', 'Appcnzcll', 'Schfflrsdorf', 'Frntigcn', 'Bubendorf', '- thal', 'Rnschlikon', 'Schtvyz', 'Biber', 'Mcnstken', 'Zrick', 'Brittnau', 'Badcner', 'Uster', 'Kaltbrunn', 'Ebnat', 'Goldswhl', 'Grub', 'Saanm', 'Wangen', 'Beatenberg', 'Lcuqqcrn', 'Lcnzigc', 'Grtlivercin', 'Mnnedorf', 'Jnnertkirchen', 'Schlo', 'Lozwpt', 'Riiti-Tann', 'Comitcschatznng', 'Bcnken', 'Iratigm', '8anlsy', 'Marlhalen', 'Mnchaltorf', 'Rain', 'Oortaillod', 'Aligncmentspla', 'Quodlibet', 'pontrsmna', 'Schwarzcncgg', 'Bzbcrg', 'Wolsbalden', 'Echo', 'Degersbcini', 'Altstcttcn', '- ninger', 'Aarbarq', 'Solothurn', 'Liverpool', 'Stnttgart', 'Hinter-Egg', 'Rahnfliih', 'Ringgcnberg Grindelwald', 'Lavasta 8anta Argentinien', 'Midau', 'Wiirglcr', 'Schaffhansen', 'Osnua', 'Ennetbadcn', 'Lcnzburg', 'Pfffikon', 'Goldaucrn', 'Aargauer', 'Safenwyl', 'Bascllandschaftl', 'Mcttmen', 'Blaun', 'Embrnch', 'Rosenberg', 'Nidau', 'Appenzell', 'parnnxin', 'Zollikofcn', 'Mnchcnbuchsce', 'Trimbach', 'England Griechenland', 'Lauterbrunncn', 'Stfa', 'Odessa', 'Fcldbäckerci', 'Rohrdorf', 'Menziken-Burg', 'BnchsDorf', 'Zlvei', 'Kllikcn', 'Sumnm', 'GraSwyl', 'Walliscllcn', 'Aadorf', 'Aarwangen', 'Bcrncr', 'Snlzbcrg', 'Rothrist', 'Grtlivcrcin', 'Matten', 'Imiar', 'Dictwpl', 'Apfclbänme', 'Kubikinhalt', 'Utzwyl', 'Oollsots', 'Ilinlsrvelier', 'Manncrchor', 'Gais', 'Flawpl', 'Lammen', 'Deutschland', 'Bibcrstcin', 'Huttwril', 'Wildcnmann', 'Bern-Stadt', 'Groffaffoltcrn', 'Seftigen', 'Frth', 'Pompeji', 'Goldswyl', 'Wnngcn', 'Olultsau', 'Cci', '- 449 amcrika', 'Meirittgen', 'Ringgcnberg', 'Klingnau', 'Ulr.Stcudlcr', '8inppcrSiv', 'Bricnzwylcr', 'Wollishofeu', 'Oirarms', 'Tuttlingen', 'Leutwyl', 'Ober-Muhcn', 'Mnnchcnbuchsce', 'Pcstalozzi', 'St. Gallen', 'Leipzig', 'Emnicnbriicke', 'Bnndesrath', 'Hcrzogenbuchsec', 'Pietcrlen', 'Wallis', 'Rußland', 'Rladrctsch', 'Dresden'}",861
7312733,38373,"{'Schweiz', 'Bern'}",2,"{'Berwitt, SLOC', 'Gemsindewcsens', 'Bern Stadt', 'Schweiz Bern'}",4,"{'Wald', 'Ausland', 'Nov', 'Kanton', 'Jo Fr', 'Westschweiz', 'Bern, '}",7,"{'Wald', 'Berwitt, SLOC', 'Ausland', 'Nov', 'Kanton', 'Bern Stadt', 'Gemsindewcsens', 'Jo Fr', 'Westschweiz', 'Bern, ', 'Schweiz Bern'}",11
5711988,1821449,"{'Axalphorn', 'Utzenstvrf', 'Sef', 'Leberberg', 'Hupercrde', 'Klein', 'Worblausen', 'Madiswyl', 'Sulz', 'Erlacherbergs', 'Jsenfluh', 'Krummbach', 'Aarthal', 'Kuiolienon', 'Lindenhof', 'Golvbach', 'Girisberg', 'Heid', 'Grimselsees', 'Gutenthann', 'Stesfisburg', 'Thalgut', 'Willisan', 'Handegg', 'Burgunds', 'Aarbcrg', 'Nessenthal', 'Engelberg', 'Schweighof', 'Planalp', 'Lohnstorf', 'Hauriberg', 'Lerchenberg', 'Spiggenbach', 'Gampelen', 'Tiesbach', 'Walperswhl', 'Hauenstein', 'Flumenthal', 'Germanien', 'Golengrund', 'Selhosen', 'Engstlenalp', 'Haldenberg', 'Vgl', 'Jcherts', 'Wendschatzgasse', 'Fcrenbalm', 'Mettlen', 'Schweselberg', 'Saxetenthal', 'Leu', 'Uetendorfbcrg', 'Erlach', 'Gntenburg', 'Ruchwyl', 'Filialdorf', 'Vreistenstein', 'Emmen', 'Eutlebuch', 'Limpbach', 'Rychcnbach', 'Engstligen', 'Oechtland', 'Habspurg', 'Altishofen', 'Mosenried', 'Burghorn', 'Rumendingen', 'Diebolds', 'Ersigen', 'Sternenberg', 'Lutherthal', 'Grafenried', 'Ileschinen', 'Biglcnthal', 'Buttenried', 'Castelen', 'Urwyl', 'Klcindorf', 'Oberland', 'Chirelbach', 'Hochthal', 'Lauffenbad', 'Krummbachthal', 'Achsalphorns', 'Zngeh', 'Ncutencn', 'Altcnberg', 'Jensbergs', 'Reichenbach', 'Breitlauinen', 'Tschuggen', 'Hermrigen', 'Maienbach', 'Wingreis', 'Simmen', 'Kurzeneybach', 'Wandt', 'Dalmhorn', 'Oberbipp', 'Illaeiis', 'Liotis', 'Affoltcrn', 'Meikirch', 'Messen', 'Bielersce', 'Gomerkinden', 'Dornach', 'Ormonds', 'Lauterbach', 'Burglauenen', 'Lenkthal', 'Stuckishausrain', 'Kalchofen', 'Riedbach', 'Schwefelberg', 'Mcikirch', 'Engstlenthal', 'Daatelenhorn', 'Trubschacheu', 'Jettendorf', 'Wyssachen', 'Sustenhorn', 'Rnegsau', 'Jpsach', 'Kranchthal', 'Worbleubach', 'Haste', 'Linden', 'Leuenberg', 'Helveticas', 'Madretsch', 'Soloth', 'Frauenfeld', 'Nenenstadt', 'Kappelen', 'Meienried', 'Kaltenberg', 'Rudswyl', 'Waldkilcheu', 'Landiswyl', 'Lindach', 'Meykirch', 'Gcmmi', 'Krattigen', 'Littisbach', 'Knabenwaisenhaus', 'Neifiswyl', 'Rhone', 'Wattfluh', 'Tiemtigen', 'Frutisey', 'Aesche', 'Enggistein', 'Deiswyl', 'Krauchthal', 'Roselanithal', 'Gibelegg', 'Mumenthal', 'Seebach', 'Judengasse', 'Fcrmelthal', 'Afilfgau', 'Alpnach', 'Schwendi', 'Dietcrswyl', 'Ins', 'Lslisoa', 'Bleiken', 'Karlsruhe', 'Stalden', 'Petronellenbalm', 'Staubbach', 'Jordanshaus', 'Smniswald', 'Plattenhorn', 'Lanpen', 'Reinfeld', 'Heimritz', 'Schweden', 'Sigriswyl', 'Napperswyl', 'Tedningen', 'Engihalde', 'Ntederdorf', 'Schonegg', 'Galgenfeld', 'Stockhorn', 'Mattland', 'Frienis', 'Solvthurn', 'Kosthofen', 'Obermatt', 'Uebeschi', 'Simmenth', 'Fraubrunnen', 'Alp', 'Vvrd', 'Ncuenstadt', 'Scharnachthal', 'Haubcnberg', 'Thalwaud', 'Frutigerthal', 'Durgergem', 'Frciburg', 'Bernern', 'Ganlibach', 'Oranien', 'Rotthalgrat', 'Staldens', 'Saanen', 'Otierbach', 'Buchegg', 'Balln', 'Vehweid', 'Fallenbach', 'Emme', 'Alpbachs', 'Bannwald', 'Port', 'Magglingen', 'Andernach', 'Oberhosen', 'Trimstein', 'Bumbach', 'Lichtenfels', 'Fri', 'Adelbodcn', 'Zaunwald', 'Mannenberg', 'Birchiwald', 'Afser', 'Diemtig', 'Dampfwyl', 'Savoyen', 'Schangnan', 'Thuner', 'Gerolsingen', 'Brunngasse', 'Walliserfehde', 'Zwieselberg', 'Landvogtei', 'Epsach', 'Ningoltingen', 'Frizenbach', 'Brandis', 'Austrocknng', 'Jnnerbergs', 'Staufenfeld', 'Steinbergs', 'Chalons', 'Grindel', 'Welschland', 'Steckholz', 'Sydenb', 'Tennlimatt', 'Mushafen', 'Bettelried', 'Lindenfeld', 'Zunfthaus', 'Egerden', 'Burgenstein', 'Triftenbach', 'Marienthal', 'Lombachthurm', 'Hochburgund', 'Hospiz', 'Grastburg', 'Guttannen', 'Bremgartenwald', 'Belp', 'Aarberg', 'Lyst', 'Langenthal', 'Lengnau', 'Riviera', 'Hornhos', 'Frutigthal', 'Weyermannshaus', 'Breithorn', 'OotorsperA', 'Vingelz', 'Obervorf', 'Thunersee', 'Rhein', 'Gahnbach', 'Belpmoos', 'Tirano', 'Knechenwyl', 'Fritzenbach', 'Gutenbrunnen', 'Bolligerberg', 'Holzerflnh', 'Bonstetten', 'Homberg', 'Riedburg', 'Gibelbach', 'Leuzigen', 'Aanvangen', 'Steinbach', 'Seewli', 'Scherzlingeu', 'Adelbodenthals', 'Faulhorn', 'Waltrigen', 'Murten', 'Golperlanibach', 'Sanctsch', 'Ansheim', 'Ueste', 'Wytenberg', 'Jammerthal', 'Engelhorn', 'Aarbach', 'Zutzwyl', 'Vinrenzcnstift', 'Hindelbank', 'Fischbach', 'Oldenhorns', 'Kleinburgund', 'Radolfshorn', 'Altorf', 'Nichisberghof', 'Tcsscnbcrg', 'Vestihubel', 'Ringoldswyl', 'Mayenthal', 'Noflen', 'Oeschseite', 'Rochefort', 'Heimw', 'Ncnenbnrg', 'Unterbalm', 'Fanlhorn', 'Seeberg', 'Arnensee', 'Erlinsburg', 'Bollwerk', 'Siechenhaus', 'Suldthal', 'Tedlingen', 'Limpachs', 'Ringgenbcrg', 'Schweiz', 'Ober', 'Lonvulet', 'Egerschwand', 'Habkern', 'Oberbottigen', 'Waldau', 'Eriz', 'Ahra', 'Heimischwand', 'Wynau', 'Gasternth', 'Engstlenbach', 'Hohniesen', 'Laupen', 'Nuffhausen', 'Wankdorf', 'Lanbeck', 'Voltigen', 'Wyttenbach', 'Faulenbach', 'Lauterbrunnen', 'Toggenburg', 'Wirthsch', 'Limpachbad', 'Spreitlauibachsteg', 'Kienthals', 'Niidlen', 'Neuburgnnd', 'Steruenberg', 'Duchsee', 'Valm', 'Alpiglen', 'Langentbal', 'Guggisbergs', 'Scheuerhof', 'Jnselgau', 'Tentenberg', 'Breisgau', 'Wyssa', 'Marchbach', 'Dieboldswyl', 'Presteneck', 'Alpengebirge', 'Ratol', 'Gondiswyl', 'Biezwyl', 'Endlisberg', 'Sumiswald', 'Melchnau', 'Rinderwald', 'Dorsbach', 'Diemerswhl', 'Lochenbergs', 'Biel', 'Dungelberg', 'Genf', 'Wyningen', 'Grindelwaldthal', 'Brunnenbach', 'Grasburg', 'Oberwald', 'Brieuzersee', 'Schwyz', 'Oeschen', 'meunsborA', 'Reulisgrat', 'Burgdors', 'Zauaqenried', 'Rorimoos Rohrmoos', 'Gcmmenalp', 'Portugal', 'Tbun', 'Steinart', 'Zollikofen', 'Engstlensee', 'Eicht', 'Gurnigel', 'Waadtland', 'Mentscheleu', 'Aar', 'Wels', 'Jnselgasse', 'Niesen', 'Hermannswyl', 'Berchtolshof', 'Friesen', 'Sulgen', 'Grauholz', 'Solotburn', 'Utzigen', 'Maggen berg', 'Unterheid', 'Basel', 'Schonried', 'Schwcndi', 'Murtensees', 'Kienth', 'Frieuisberges', 'Rohrberg', 'Neneneck', 'Oberburg', 'Jseltwald', 'May', 'Oeschiuenth', 'Oeyen', 'Schauenburgs', 'Albersthorn', 'Eyfluh', 'Tschentenbach', 'Meiersmaad', 'Emmenthal', 'Bonderbach', 'Tedligen', 'Bowyl', 'Breitenberg', 'Spitalgasse', 'Rotthal', 'Neueuburg', 'Bcrggnt', 'Koblenz', 'Neichenbach', 'Sulgenbach', 'Grasbnrg', 'Gamchialp', 'Lanterbrunnenthals', 'Landshut', 'Lotzwyl', 'Simmeneck', 'Oberhofen', 'Birchi', 'Lungernihal', 'Frutigen', 'Bucheggbergs', 'Barschwand', 'Ammerzwyl', 'Stettlen', 'Bitzberg', 'Ricdburg', 'Golzwyl', 'Twannberg', 'Meiniswyl', 'Kilchberg', 'Steffisburg', 'Zinkenstock', 'Kienholz', 'Wisiisburg', 'Engersbach', 'Langerenalp', 'Abendberg', 'Niedern', 'Rom', 'Scheuren', 'Bodenzingen', 'Kandergrnnd', 'Attiswhl', 'Rotenslue', 'Blnmenstein', 'Sanglerbnch', 'Ebnit', 'Brittnau', 'Tribey', 'Altenbergs', 'Seftau', 'Bnrghorn', 'Aeschi', 'Ormondsthal', 'Laubegg', 'Rislaualp', 'Reust Buchholz', 'Buchsgan', 'Blumensteinbad', 'Zumbrunncn', 'Wellhorn', 'Schwarzenbach', 'Bannwvl', 'Aarbergergasse', 'Schwarrenbach', 'Bnbenberg', 'Letschenberg', 'Aeschli', 'Ettenheim', 'Hasenburg', 'Saanenland', 'Obcrhasle', 'Langnan', 'Bittenberg', 'Knrzcnberg', 'Guggisberg', 'Str Langenthal', 'Frutigerbad', 'Balmhorn', 'Jegenstorf', 'Oltigen', 'Hohliebe', 'Haslelandes', 'Bettenhausen', 'Ralligslub', 'Alpenschweiz', 'Schafhansen', 'Gnrnigelbad', 'Schanguau', 'Gotthard', 'Kleinroth', 'OImrunskerZ', 'Wyuau', 'Hoheneck', 'Landeron', 'Obergestelen', 'Widdergalm', 'Lcerau', 'Witemanshans', 'Marchstein', 'Wynberghorn', 'Waltrigenhof', 'Emmenth', 'Dadelishorn', 'Oeschinen', 'Dossenhorn', 'Schwenden', 'Nenbausbad', 'Aarhorn', 'Ernlisburg', 'Mctzgergasse', 'Rothholz', 'Vuliso', 'Rothenfluhwald', 'Langeuthal', 'Gandbach', 'Thun', 'Rumisberg', 'Reichcnbach', 'Helvetiens', 'Psarrdorf', 'Bailstall', 'Schlauchhorn', 'Langenstein', 'Hirzboden', 'Meiringenthal', 'Untcrrhein', 'Steinhaus', 'Buchegkberg', 'Netsch', 'Aarbodenthal', 'Bollin', 'Simmcuegg', 'Murzelen', 'Domodossola', 'Humberg', 'Michelsburg', 'Saxetenthals', 'Thun Jbach', 'Kyburg', 'Interlaken', 'Wyl', 'Kander', 'Zauggenried', 'Ritzli', 'Gurnigelbad', 'Balisalp', 'Bern Std', 'Elsigen', 'Nalm', 'Staldholz', 'Koppigen', 'Wyttcnbachs', 'Luternau', 'Ansoltingen', 'Dorfbach', 'Ringgen', 'Schwanden', 'Faulborns', 'Kaltenbach', 'Erleubach', 'Jchertswyl', 'Battenberg', 'Lanpcn', 'Provence', 'Graswyl', 'Leberbergs', 'Wetterhorn', 'Brcmgartenwald', 'Schwarzenbnrg', 'Italien', 'Worblaufcn', 'Bramberg', 'Gadmcnbach', 'Willisau', 'Berghof', 'Eriswyl', 'Kaiteneggwald', 'Bubenberg', 'Neuenbnrg', 'Tieiu', 'Turbachthal', 'Goms', 'Uttigen', 'Aarziele', 'Rainbach', 'Oeschineuthal', 'Amsel', 'Scherzllngcn', 'Roggwyl', 'Kries', 'Haslach', 'Mynau', 'Licbcgg', 'Fretburg', 'Wiflisburg', 'Kilchdorf', 'Aarbodenthales', 'Vellevue', 'Oeschenbachgraben', 'Eggenwyl', 'Konolfingen', 'Furgialp', 'Horubachgraben', 'Lhronil', 'Ostermundigenberg', 'Melchnan', 'Aarzielethor', 'Raron', 'Eichholz', 'Allmend', 'Gallen', 'Kopingen', 'Kanderthal', 'Jffigenhorn', 'Turbach', 'Hubbach', 'Ruppelsried', 'Kirchgasse', 'Vorimholz', 'Oex', 'Urbachaar', 'Dominikanerkirche', 'Eugi', 'Haslerberg', 'Naria', 'Sulgcneck', 'Loh', 'Maybachhof', 'Bipschal', 'Niederglasbachhof', 'Brunnenhof', 'Egelberg', 'Helvetien', 'Aukenwaag', 'Reicheubach', 'Nennigkofen', 'Achsalp', 'Schoren', 'Jura', 'Lochbachbad', 'Hauben', 'Thunstetten', 'Simmenthals', 'Greyerz', 'Spreitenbach', 'UurKuillon', 'Graffenried', 'Obersimmenthal', 'Oele', 'Escholzmatt', 'Steinibach', 'Herbligen', 'Elsigenbergs', 'Kienersrcuti', 'Muttenalp', 'Jens', 'Bechburg', 'Ramisberg', 'Rustwalde', 'Herzogenbnchsee', 'VL5', 'Lauibach', 'Waltcrswyl', 'Brnnnlein', 'Wickartswyl', 'Walterswyl', 'Liudenfeld', 'Rathhaus', 'Niederbipp', 'Vurgdorf', 'Bartholome', 'Ossemurolm', 'Sandrain', 'Neinisch', 'Berg Thal', 'Alemannien', 'Stusistein', 'Snlgenbach', 'Zofingen', 'Grafenstein', 'Neichenstein', 'Hursclen', 'Lungern', 'Tollhaus', 'Europa', 'Stanbbach', 'Gent', 'Stampbach', 'St', 'Kirchenfcld', 'Marchgrab', 'Gysenstein', 'Saahli', 'Leissigenbad', 'Schauzgrabcn', 'Kurzenbergs', 'Manncnberg', 'Frisching', 'Lauterbrnnnenthal', 'Stoffelbach', 'Klingenthal', 'Hofstetten', 'Marziele', 'Ursenbach', 'Gwatt', 'Scheidwalds', 'Friesenberg', 'Dozigen', 'Gspaltenhorn', 'Wiggiswyl', 'Schinocken', 'Sulgenbach Aarzieleviertel', 'Dettligen', 'Gummenbach', 'Muniberg', 'Brientz', 'Lauterbrunnenthals', 'Senndorf', 'Kranchthalbach', 'Kirchdorf', 'Dreispitz', 'Krattig', 'Thorberg', 'Uetendorfberg', 'Krispalt', 'Seedorfl', 'Tas Thal', 'Lutz', 'Uechtland', 'Sausbachs', 'Nydcck', 'Dietertwald', 'Breitenrain', 'Schnoitwyl', 'Junkerngasse', 'Hiltersingen', 'Augstmatth', 'Orbe', 'Lanbegg', 'Bnrg', 'Dikki', 'Hasle', 'Pfrundland', 'Haldimoos', 'Frienisberg', 'Thalseite', 'Suldbach', 'Kileyalp', 'Reinisch', 'Ammertenthal', 'Niederried', 'Gummenthal', 'Senggen', 'Fanlensee', 'Aspi', 'Leugeuenbach', 'Lueg', 'Ebligen', 'Ueschi', 'Sagibach', 'Bremgarten', 'Aarnser', 'Ahorns', 'Schadau', 'Irsigbach', 'Hermos', 'Brunnbach', 'Tschingelalp', 'Fambach', 'Alpen', 'Waldried', 'Velschen', 'Saauen', 'Gurzelen', 'Engstlen', 'Kumihorn', 'Wannenthal', 'Olt', 'Niedtwyl', 'Neuenburgersee', 'Morgenberghorn', 'Postgasse', 'Langn', 'Bigelbachs', 'Alpbach', 'Elsigbach', 'Dittlingersee', 'Ueberstorf', 'Bettcnhausen', 'Chorbalm', 'Ga', 'Hausen', 'Brienz', 'Jnterlaken', 'Balmen', 'Lauibachs', 'Schafhausen', 'Weiden', 'Albligen', 'Rheins', 'Rothenflub', 'Siselen', 'Lauenen', 'Hofstatt', 'Pieterlen', 'Niedersimmenthal', 'Pillon', 'Oberstcg', 'Saane', 'Latterbach', 'Niesens', 'Heimwesen', 'Tschingel', 'Oberwangen', 'Kand', 'Siguau', 'Vuutchoveu', 'Rcuti', 'Eselmoos', 'Gelmerbach', 'Arnengrat', 'Arnisagi', 'Mieschsluh', 'Jntcrlaken', 'Langmauer', 'Brestenegg', 'Bez', 'Wahleckberg', 'Kileialp', 'Kohlholz', 'Freiburg', 'Teuffenthal', 'Wallenznben', 'Ostermanigen', 'Turheim', 'Fisistock', 'KilchIindach', 'Brienzerberg', 'Gonten', 'Erlen', 'Ezelhofen', 'Llonliisou', 'Oenz', 'Luzernischcn', 'Chirel', 'Bad Putte', 'Sinneringen', 'Sidelhoru', 'Galserberg', 'Teiswyl', 'Hericourt', 'Dittlingen', 'Bunschibach', 'Kaltbrunnenalp', 'Erlenbach', 'Hondrich', 'Nods', 'Grauhorn', 'Gnrnigels', 'Gilbachs', 'Schnerzenbach', 'Altenryff', 'Ladholz', 'Murtner', 'Lnchsmatt', 'Utzingen', 'Semsulos', 'Konstanz', 'Oberhasli', 'Lauterbrnnnen', 'Flinsau', 'Gurnigels', 'Holland', 'Widerberg', 'Bikingen', 'Fluhberg', 'Aeschlenberg', 'Diemerswyl', 'Schanzgraben', 'Allmisberg', 'Gadmeubach', 'Steigelberg', 'Jerusalem', 'Roth', 'Bergbach', 'Wiedlisbach', 'Kicuthal', 'Wahlendorf', 'Jaggisbach', 'Oberhornsee', 'Jllingen', 'Frienisbcrg', 'UtMiistorl', 'Luzern', 'Biberenbach', 'Bipp', 'Winterberg', 'Schangnauer', 'Langenegg', 'Hermiswyl', 'Harnischthurm', 'Mareb', 'Gvldenmattgasse', 'Gals', 'Hasliberg', 'Laancn', 'Grindelwaldthales', 'Kirchcnfcld', 'Grrgi', 'Kohleren', 'Egerdon', 'Konolsiugen', 'Tbunersee', 'Lauterbruuuen', 'Tschangnau', 'Jyengraben', 'Lengnaubach', 'Guttanne', 'Schmadrihorn', 'Bipp Aarwangen', 'Kirch', 'Brunnadern', 'Goldbach', 'Reichenau', 'Mitholz', 'Ncucngasse', 'Niederwyl', 'Oeschberg', 'Tschentenbergs', 'Jbach', 'Stammburg', 'Attiswvl', 'Dlumenstein', 'Laupcrswyl', 'Jungwald', 'Allenbach', 'Saxetenbachs', 'Oberwhl', 'Marktgasse', 'Schulort', 'Spitzenberg', 'Haslilandes', 'Bunkkofen', 'Andern', 'Ueschinen', 'Marsili', 'Buntschibach', 'Emmenthales', 'Marchsteine', 'Lanbeggstalvcn', 'Diem', 'Lindenth', 'BohlaIp', 'Grubi', 'Burgistein', 'Trach', 'Felsenburg', 'Urbachthal', 'Miihlebach', 'Rath', 'Berglistock', 'Duchegg', 'Leukerbad', 'Arni', 'Stampfbach', 'Kramgasse', 'Traubach', 'Guteuburg', 'Torfmarch', 'HuootwnberA', 'Utzen', 'Hsr', 'Tettligen', 'Buren', 'Pieterlenmoos', 'Oenzbach', 'Ebsach', 'Niederey', 'LaupeN', 'Oberdeutschland', 'Wylerfeld', 'Brugg', 'Gelmersee', 'Frittenbach', 'Jttenberg', 'Iseltwald', 'Hohlenwegen', 'Vordorf', 'Rvthhorn', 'Emmenhof', 'Mittenderg', 'Lcuker', 'Schmocken', 'Enetbach', 'Malmisberg', 'Grenchen', 'Salzburg', 'Burgbach', 'Aarthales', 'Heiligenschwendi', 'Kienbach', 'Clavaleyres', 'Kunried', 'Birrmoos', 'Dieboldsbach', 'Emmenthaleralpen', 'Gantfluh', 'Lauenenthal', 'Dettigen', 'Hohmattbsz', 'Eggiwyl', 'Rothenbad', 'Neueneck', 'Herrengasse', 'Brienzwylcr', 'Heimenschwand', 'Aarbergberg', 'Meningen', 'Auswyl', 'Ranfhorn', 'Gerechtigkeitsgasse', 'Sevinenalp', 'Oberaarhorn', 'Kappelcnwald', 'Kien', 'Laubeck', 'Amsoldingeu', 'Bruck', 'Scheidcck', 'Leodegarskirche', 'Diessenberg', 'Schorren', 'Seedorf', 'Rongemont', 'Jakobi', 'Optingen', 'Kalteneggberg', 'Brieuzerberg', 'Birghorn', 'Friesland', 'Umberg', 'Grandson', 'Jffwyl', 'Thierstein', 'Nenenbnrgersee', 'Mirchel', 'Wangen', 'Beatenberg', 'Beatenbergs', 'Reichsvogt', 'Grimselhospiz', 'Ringmauer', 'Thuuersee', 'Hellsau', 'Steffisbnrg', 'Montblanc', 'Scheidwald', 'Engi', 'Aarthals', 'Aare', 'Grindelwaldgletscher', 'Unterseen', 'Obersteg', 'Glitsch', 'Mazwyl', 'Dotzigen', 'Riedli', 'Wallenbuch', 'Kirchthurueu', 'Tellistock', 'Solothurn', 'Wylerseld', 'Eudorf', 'Baggwvl', 'Aargan', 'Freiburghaus', 'Uffgau', 'Staufen', 'Hinteregg', 'Siegristenhof', 'Schaffhansen', 'Ammerten', 'Zeughaus', 'Gentel', 'Walperswyl', 'Tellenbnrg', 'Ferrenberg', 'Nidau', 'Meinisberg', 'Schwarzenmatt', 'Horttbach', 'Ryffenmatt', 'Mistelberg', 'Tschingelhorn', 'Sidelhorn', 'Walkringen', 'Walstenbach', 'Metschhorn', 'Coucy', 'Schilthorn', 'Spanien', 'Wyttenbirke', 'Thierberg', 'Brienzergrat', 'Schindleren', 'Arisbergs', 'Alcherstorf', 'Hauptthal', 'Maycnthal', 'Wigisperghof', 'Jordanshanse', 'Renenegg', 'Bnrgdorf', 'Gastcrn', 'Knrzenberg', 'Heimberg', 'Allenwyl', 'Elsigenberg', 'Julimont', 'Galmatt', 'Delkeskamp', 'Oestlich', 'Stdn Bern', 'Gallien', 'Seftigen', 'Oberlindach', 'Gntisberg', 'Schwanderlamm', 'Std', 'Falchern', 'Leimeren', 'Ottiswyl', 'Senseufcr', 'Wimmis', 'Wallis', 'Uusvln', 'Valeckberg', 'Grindelwaldgl', 'Bergthal', 'Poleren', 'Scheuchzer', 'Biembach', 'Aarbergerthor', 'Hauptgasse', 'Aufrain', 'Schneckenberg', 'Tschin', 'Allmeudb', 'Kirchet', 'Zihl', 'Vriesenberg', 'Zimmlisberg', 'Haslethals', 'Snlg', 'Gauligl', 'Gerlebach', 'Oberdorf', 'Zeitglockcnthurm', 'Oberaargau', 'Rothenstuh', 'Wallisberg', 'Mattstetten', 'Reutigenhubel', 'Kilterf', 'UeMinvile', 'Schwarzenburg', 'Horben', 'Morgenberg', 'Spicz', 'Bachthalen', 'Liebenwyl', 'Hsrn', 'Gilbach Gillbach', 'Brienzling', 'Lyssach', 'Reutigen', 'Rainseld', 'Obergerwern', 'Pletschbach', 'Sackhorn', 'Lllron', 'Metzgernviertel', 'Landshnt', 'Schwarzbach', 'Wien', 'Kernenried', 'Kreuzmatt', 'Steigelschwand', 'Hasli Grund', 'Ochlcnberg', 'Aetikofen', 'Reutebergli', 'Rennendorf', 'Amselberg', 'Eggisberg', 'Nadclfingen', 'Kirchhof', 'Obcrried', 'Radelfingen', 'Konol', 'Mnrten', 'Almeldingen', 'Schwandfeld', 'Weiler', 'Vrem', 'Brienzcrberg', 'Farneren', 'Bickigen', 'Gumiswyl', 'Bundalp', 'Mnri', 'Nohrbach', 'SumiSwald', 'Enzigebirges', 'Tscherlitz', 'Noth', 'Theytingen', 'Ganterisch', 'Arnenberg', 'Obern', 'OpolinZen', 'Tschingelochtighorn', 'Bncheggbergs', 'Mannried', 'Wahlenbach', 'Niederer Spital', 'Tieboldswyl', 'Frutigland', 'Reutihorn', 'Wichtrach', 'Rvthcnfluh', 'Ncnenstadt', 'Rothensluh', 'Tborberg', 'Bolligen', 'Murtcn', 'Pfarrdors', 'Trubschachen', 'Neueuburgersee', 'Altachen', 'Emmenthale', 'Niggadey', 'Erlisberg', 'Sonnenbergwald', 'Ochlenberg', 'Estavayo', 'Urtcnenbach', 'Gasternthal', 'Ofenegg', 'Uri', 'Abthl', 'Villa', 'Holzach', 'Sennbcrgen', 'Schwendibach', 'Wylerholz', 'Scheunenberg', 'Schmadribach', 'Heiligenland', 'Savoven', 'Pf', 'Hsrgr', 'Rtngoldswyl', 'Sugh', 'Allment', 'Lenzburg', 'Sulzberg', 'Totzingen', 'Hochwang', 'Thunersees', 'Iltzenstors', 'Blumeustein', 'Oltschibachs', 'Bonerenschafberg', 'Rud', 'Lombachs', 'Tanbachs', 'Kandergrund', 'Grindelwald', 'Morgenthal', 'Kirchgem', 'Obersteckholz', 'Obersee', 'Obwalden', 'Vusalpa', 'Jncharten', 'Lauenenbach', 'Lammbach', 'Bumbachthal', 'Alboldingen', 'Montenach', 'Schnottwyl', 'Wilderswyl', 'Orpund', 'Huttwpl', 'Freibnrg', 'Arnenhorn', 'Belpbergs', 'Coppingen', 'Kornhaus', 'Reichenstein', 'HaSle', 'Tannialp', 'Selz', 'Leuk', 'Dallbach', 'Snmiswald', 'Farnsburg', 'Aarburg', 'Nasseuberg', 'Kralligen', 'Gutenburg', 'Muri', 'Landorf', 'Gerzensee', 'Muleren', 'Felsenau', 'Utzenstorf', 'Buchen', 'Reinischfeld', 'Griengrube', 'Fahrni', 'Schwcllenmatt', 'Ammertenhorn', 'Lausanne', 'Eggenschwand', 'Goldbachschach', 'Berolswyl', 'Brod', 'Hohburg', 'Schangnau', 'Scherlibach', 'Golaten', 'Zihlb', 'Guggisperg', 'Grimmiberg', 'Worblaufen', 'Tiefithal', 'Bunkhofen', 'Ringoldingcn', 'Oeschinenalp', 'Schwarzwaldes', 'Horrcnbach', 'Paris', 'Baden', 'Oeschenbachgrabens', 'Goldiwyl', 'Staldeu', 'Altenberges', 'Wellenberg', 'Ozenberg', 'Attiswyl', 'Allmendingen', 'Twingherrenstreit', 'Zimmerwald', 'Zimmerzey', 'Fallbachs', 'Zielebach', 'Bottigen', 'Riedstatt', 'Zull', 'Frieswyl', 'Clnniaeenser', 'Aargau', 'Molasse', 'Holzmatten', 'Egerdongasse', 'Zetzenwyl', 'Trunenberg', 'Obcrtheil', 'Seeland', 'Nohrmoos', 'Ganterifch', 'Lchermenwald', 'Erlacherhos', 'Signau', 'Stefsisburg', 'Bigenthal', 'Seehorn', 'Vergl', 'Gellistock', 'Hettiswyl', 'Brienzersec', 'Achliberg', 'Hohlenweg', 'Trnbschachen', 'Speichergasse', 'Walpnrgis', 'Thalgrund', 'Schwarzwald', 'Kleinburgunds', 'Schmabribach', 'Kleindorf', 'Gumi', 'Wippingen', 'Tschertschisbach', 'Berg', 'Vettenalp', 'Gamchenberg', 'Grindelwald Gsteig', 'Merzligen', 'Juterlakcn', 'Weingreis', 'Herrmoos', 'Frankreich', 'Jffigenthal', 'Hirschhorn', 'Mooses', 'Ncidcnbach', 'Eichwald', 'Obsthainen', 'Viuelz', 'Tannhorn', 'Fallbach', 'Escheuthal', 'Wangenried', 'Leissigen', 'Domo', 'Falkenstein', 'Metsch', 'Kippcl', 'Guruigels', 'Brunn', 'Emmenholz', 'Hausenbach', 'Krinenberg', 'Rvbrbach', 'Lindenthal', 'Aar Zihl', 'Tschingelfeld', 'Schillingsdorf', 'Vrienz', 'Ghnrnbergs', 'Kilperg', 'Vuchsee', 'Bohlegg', 'Oesterreich', 'Nytzenbach', 'Lomplunum', 'Kienstein', 'Marchegge', 'Gstaad', 'Gerstenbach', 'Glockhaushorn', 'Jtramen', 'Stadtalp', 'Bibern', 'Albristhorn', 'Bennwyl', 'Scheidegg', 'Glissenbach', 'Gervl', 'Pfarrd', 'Frienisbergerhaus', 'Kerrenried', 'Oberwyl', 'Teuffen', 'Sigger', 'Oey', 'Aar Port', 'Kuhlewyl', 'Brienzersee', 'Brienzersees', 'Schwendelbergs', 'Worblenthal', 'Kop', 'Bachs', 'Stadau', 'Vorder', 'Burgruine', 'Jlliswyl', 'Arnen', 'Farni', 'Hinterbirg', 'Sugy', 'Tschingelberg', 'Gstaaderberg', 'Buchholterbergs', 'Hohfluh', 'Jaberg', 'Schifferdorf', 'Sch', 'Bucheagberg', 'Benzlauibachs', 'Lauenenth', 'Frieslaud', 'Habkernthal', 'Ganbach', 'Heinsberg', 'Aebi', 'Limpach', 'Bromberg', 'Grimselsee', 'Reidenbach', 'Nichenschwendi', 'Wyleroltigen', 'Nydeckgasse', 'Strubeleck', 'Utzistorf', 'Altwyden', 'Leimiswyl', 'Wagisbach', 'Grindelwalds', 'Kramburg', 'Schreckhorn', 'Zikzak', 'Ritterburg', 'Wylcrfeld', 'Aarufer', 'Gadmenbach', 'Buchholz', 'Wanzwyl', 'Lausaune', 'Marfeldingen', 'Rothenfluh', 'Storch', 'Rotthalbach', 'Esch', 'Sulgeneck', 'Plantin', 'Buchsee', 'Wylhof', 'Schauenburg', 'Oltschihorn', 'Twannbach', 'Gelmeralp', 'Burgund', 'Genthal', 'Faulensee', 'Suleck', 'Kaudergrund', 'Suinis', 'Lauenensee', 'Florenz', 'Rosenlaut', 'Wendenalp', 'Thalwand', 'Zollikosen', 'Horns', 'Nenenburg', 'Moosegg', 'Siebenthal', 'Wintereck', 'Oberhasle', 'Emmenthals', 'Mellingen', 'Stockhorns', 'Friefenberg', 'Eymatt', 'Scheideckalp', 'Oeschbach', 'Dentenberg', 'Hofwyl', 'Kriegstetteu', 'Oldenhorn', 'Hsru', 'Mettenberg', 'OllmKsn', 'Ballenberg', 'Harris', 'Dessikofen', 'Bergestbach', 'Oberried', 'Alteuberg', 'Grimmenstein', 'StolliburA', 'Egerten Gasse', 'Granholz', 'Kirchlindach', 'Vllll', 'Mayenmoos', 'Kappclen', 'Stcrnenberg', 'Str Bern', 'Breitstein', 'Wallenbnch', 'Ritzlihorns', 'Oberer Spital', 'Bucheggberg', 'Kiesen', 'Kornhausplatz', 'Hnttwyl', 'Herzogen', 'Bachalp', 'Pletschenalp', 'Kap', 'Rohr', 'Jffigenbach', 'Gemmi', 'Simmencck', 'Engstlenthales', 'Columba', 'Loraine', 'Dorni', 'Thaleckhorn', 'Str Sumiswald', 'Jtramenberg', 'Doldenhorn', 'Buchschwand', 'Nencnburg', 'Gerenstein', 'Meyelsgrnnd', 'Ramisbergs', 'Neuhaus', 'Avignon', 'Amsoldingersee', 'Aettingen', 'Lanbeckstalden', 'Affoltern', 'Riedstcitt', 'Wylerhorn', 'Aarau', 'Gambach', 'Alwandingen', 'Amsoldingcrsee', 'Stadtbach', 'Meiringens', 'Jensberg', 'Eschli', 'Vinelz', 'Ncncnstadt', 'Balzenberg', 'Japan', 'Oberramsern', 'Eybach', 'Seelibachs', 'Trvmwyl', 'Leuterswyl', 'Tschentenberg', 'Uuspunnen', 'Dieboltsbach', 'Oberhorn', 'Broye', 'Senno', 'Wattenwyl', 'Haslithales', 'Wylerhorns', 'Grafenmoos', 'Habke', 'Schweinsberg', 'Siders', 'Neuenschwand', 'Heidenmauer', 'Vrienzersee', 'IsKistork', 'Suiniswald', 'Kneu', 'Grissach', 'Benzlauibach', 'Gimmelwald', 'Hexensee', 'Oeschinenth', 'Vurgdors', 'Schanenbnrg', 'Verchtolds', 'Herbcrg', 'Hutbach', 'VVeiiAnn', 'Clugny', 'Brienzerbcrg', 'Bartlomehof', 'Scheideck', 'Aetigen', 'Schulbez', 'Lauperswyl', 'Berg Blasenstutz', 'Kramgassc', 'Elsighorn', 'Nieder', 'Aarnfer', 'Schwendelberg', 'Gottstadt', 'Wengenalp', 'Safneren', 'Bern', 'Bigelthal', 'Schleg', 'Bunderbach', 'Hvfuhrcn', 'Twing', 'Eschwyl', 'England', 'Oeschenbach', 'Pfarrdorf', 'Borris', 'Seftigeu', 'Stcrnen', 'Krattigcn', 'IlMNvch', 'Wattenwhl', 'Rothenbach', 'Murtensee', 'Ruwenthal', 'Holzmattcn', 'Schliern', 'Sternibach', 'Simmenlhal', 'Worms', 'Thal', 'Gempenach', 'Fricnisberg', 'Schneeberghorn', 'Bielersee', 'Lamlingen', 'Rohrimoos', 'Geilsbach', 'Rabenthal', 'Freibach', 'Pnbenberg', 'Gwattbach', 'Hohenstaufen', 'Ried', 'Wiesenbau', 'Ncuengasse', 'Pillenberg', 'Meyenried', 'Oeschinenthal', 'Topfstein', 'Balmoos', 'Wittikofen', 'Endweg', 'Vkk', 'Vogtsholz', 'Oedland', 'Kalchegg', 'Gastern', 'Hostatt', 'Ortschwaben', 'Hitzenberg', 'Burgergem', 'Hub', 'Breitenegg', 'Seestr', 'Geisbach', 'Aegerstein', 'Rothkraut', 'Viesch', 'Adelbodenthal', 'Englisbergeck', 'Urbach', 'Murgeten', 'Aarwangeu', 'Simelihorn', 'Aeschlen', 'Biberen', 'Gasternholz', 'Meyringen', 'Lochbach', 'Lenguau', 'Rufshausen', 'Hutbachs', 'Neuengasse', 'Lombach', 'Wolf', 'Twann', 'Bollodingen', 'Wynan', 'Balm', 'Jerisberg', 'Guntcnbach', 'Lnzern', 'Buchseemooses', 'Ramsen', 'Hohgant', 'Alemannen', 'Petcrlingen', 'Lauterburg', 'Niesenhorn', 'Zahlershorn', 'Rothhorn', 'Scherzisbach', 'Waldbach', 'Jaunthal', 'Waltwyl', 'Jselgau', 'Moosberg', 'Telligrat', 'Bidmenhof', 'Kirchberg', 'Rvhrbach', 'Dalmazi', 'Kreuzgasfe', 'Achsetberg', 'Petersinsel', 'Wpnau', 'Wasen', 'Wysbachs', 'Wergisthal', 'Trubbach', 'Huttwyl', 'Brombergs', 'Brunnenthal', 'Entlibuch', 'Gasterndorf', 'Brunnenrain', 'Engelbergs', 'Mnrtensee', 'Herzogenbuchsee', 'Hcimbcrg', 'Thnn', 'Thungschneit', 'Arniberg', 'Girischachen', 'Gelmerhorn', 'Burgrecht', 'Solothurns', 'Ferenbalm', 'Englisberg', 'Plaffehen', 'Rore', 'Simmenegg', 'Dieterswyl', 'Jcnsberg', 'Marbach', 'Burgfluh', 'Jlmen', 'Entlibnch', 'Neuenstadt', 'Bannwyl', 'Tellenburg', 'Zlarberg', 'Guggershorn', 'Kirchbergs', 'Froburg', 'Altisberg', 'Signan', 'Darmstadt', 'Kallnach', 'Jffigbachs', 'Sarmgrromnrvlm', 'Griesbach', 'Schwand', 'Simclihorn', 'Freiburgs', 'Thierachern', 'Nuofhusen', 'Bnrgistein', 'Sandegg', 'Eggberg', 'Tann', 'Nugerol', 'Rotschalpburg', 'Moosseedorf', 'Steinalp', 'Ochlen', 'OltinZeu', 'Alpenstock', 'Jferten', 'Holligen', 'Schnabelburg', 'Murtenwald', 'Gnrnigelberg', 'Weschergrat', 'Gadmenbachs', 'Teufenthal', 'Ransperg', 'Biglen', 'Felsenbnrg', 'Oenzbachthal', 'Worb', 'Lerche berg', 'Habsburg', 'Emmenrain', 'Brieuz', 'Lehn', 'Oberbasle', 'Biberenberg', 'Peterlingen', 'Sundlauenen', 'Ludnigalp', 'Wyler', 'Allmendland', 'Diechterhorn', 'Thalbad', 'Kiesenbach', 'Rohrbachstein', 'Helfenstein', 'Schwarzhorn', 'Hohstuh', 'Reichenbachs', 'Spiez', 'Brope', 'Nontpottum', 'Bnehcggberg', 'Rosenlauibad', 'Augstthal', 'Knnbelalp', 'Gnggershorns', 'Gadmen', 'Pfarrd Melchnau', 'Limmat', 'Bottenbalm', 'Oberglasbachhof', 'Bickingen', 'Uonropos', 'Jagdberg', 'Sutz', 'Gemmenalp', 'Stdn', 'Lengenberg', 'Spissi', 'Engers', 'Haulistahl', 'WalpcrSwyl', 'Mittelland', 'Thuncrsee', 'Gerberngraben', 'Kastlenhorn', 'Winterthales', 'Greyers', 'Altenberg', 'Ufgau', 'Buchholterberg', 'Oltingen', 'Entlebuch', 'Thalbach', 'Vechigen', 'Nadelberg', 'Justisthal', 'Walliswyl', 'Krauch', 'Schelhammer', 'Meiringen', 'Hintisberg', 'Glasholz', 'Gyrizensee', 'Murgenthal', 'Utzlenberg', 'Drettenhorn', 'Bigelbach', 'Schwarzenberg', 'Burgundien', 'Hopsern', 'Gnttannen', 'Nothbach', 'Btz', 'Walke', 'Scandi', 'Hofmatt', 'Laubach', 'Her', 'Grimsel', 'Ringgenberg', 'Phunt', 'Limpbachs', 'OLerhasle', 'Ninggenberg', 'Wolfisberg', 'Std Bern', 'Trachselwald', 'Sannen', 'Grenzberg', 'Triftthal', 'Seelands', 'Herrenschwanden', 'schweiz', 'Brnnngasse', 'Oberlands', 'Diemtigthal', 'Llorillon', 'Faulhorns', 'Uuterseen', 'Balmereckhorn', 'Unterbach', 'Jnnenberg', 'Aigle', 'Riedort', 'Moos', 'Stein', 'Suldhalden', 'Engstligenthal', 'Barnabas', 'Gilbach', 'Tschugg', 'Sigris', 'Dominikanerkloster', 'Leggiswyl', 'Oberthal', 'Staad', 'Zenghausgasse', 'Heustrich', 'Dern', 'Murgeteu', 'Gadmenthal', 'Etivaz', 'Engstligenalp', 'Bittwyl', 'Lochbad Burgdors', 'Roththal', 'Nengg', 'Aberli', 'Saaneu', 'Neuenegg', 'Etivazthal', 'Eritz', 'Kleinegg', 'Sursee', 'Gsteigthale', 'Herzwyl', 'Furka', 'Burgdorf', 'Aergeuw', 'Schernelz', 'Alpenwirthsch', 'Alpenthal', 'Wergi', 'Rhonegletschcr', 'Aarbergs', 'Oppikofer', 'Sanetsch', 'Durheim', 'Wasserwendi', 'Gysnansluh', 'Kriegstetten', 'Kerzers', 'Winzcnried', 'Kaufdorf', 'Lauterbrunnenth', 'Steinhaushorn', 'Rohrmoos', 'Schanguan', 'Aarbergerfeld', 'Aarbodenalp', 'Moutmirail', 'Elfenau', 'Oltschinen', 'Tessenberg', 'Metteuberg', 'Rhonegl', 'Gemsberg', 'Bricnzersees', 'Wohuhsr', 'Haslebergs', 'Benzlauistock', 'Hilterfiugen', 'Ersingen', 'Habkeru', 'Bleienbach', 'Gerolfingen', 'Lnlavaux', 'Hasleberg', 'Unterwalden', 'Schwarrcnbach', 'Frntigen', 'Hafenburg', 'Hasliland', 'Wendenbach', 'Breitfcld', 'Trunengalm', 'Kybnrg', 'Grindel Bach', 'Bucheckberg', 'Schwarzwaldgl', 'Lenk', 'Brenzikofen', 'Bodelein', 'Tessenbergs', 'Agriswyl', 'Bleyenbach', 'Blumenstein', 'Schwabenkrieg', 'Holzbrunn', 'Rothbachs', 'Dettingen', 'Hutmaad', 'Kirchbcrg', 'Seeberghorn', 'Titlis', 'Hinterburg', 'Gottstatt', 'Hormatsgasse', 'Buchsgau', 'Gentelbach', 'Altisperg', 'Heimis', 'Krattigenwald', 'Giebelegg', 'Nothenfluh', 'Lauterbrunnenthal', 'Schwarzwasser', 'Affolteru', 'Su', 'Frutigenthal', 'Schnlbez', 'Wartenstein', 'Diesbach', 'Alpeusce', 'Schowland', 'Breitenrains', 'Amfoldingen', 'Hunziken', 'Hilterfingen', 'Kurzenberg', 'Bonn', 'Blacken', 'Bielcrsee', 'Zeughausgasse', 'Gummborn', 'Oesch', 'Thuncr', 'Etzelkofen', 'Haslethal', 'Haslithal', 'Meiringcn', 'Twingeu', 'Gletscherhorn', 'Wohnh', 'Stcckholz', 'Lochmatt', 'Savoyens', 'Kreuzgasse', 'Borisried', 'Aegelsee', 'Juselgasse', 'Alentzbach', 'Franbrnnnen', 'Tungel', 'Eichbergs', 'Tschenten', 'Schoshaldenho', 'Triesthorn', 'Waldeck', 'Schwarzenegg', 'Senggi', 'Hasleland', 'Gostel', 'Bonderspitz', 'Alchenstorf', 'Erlisburg', 'Jnnerschwand', 'Vubenberg', 'Rothbach', 'Heiliggeistkirche', 'Ezelghofen', 'Schiltwald', 'Sauetsch', 'Thunrrsee', 'Rothorn', 'Metzgergasse', 'Hcimenhausen', 'Rapperswyl', 'Stuckishaus', 'Worbleuthal', 'Langete', 'Wiladingen', 'Kienthal', 'Nydegg', 'Uuterwalden', 'Ulrichs', 'Freimettigen', 'Wachseldorn', 'Tannwald', 'Widenberg', 'Schwadernau', 'Habstetten', 'Sulzen', 'Galliens', 'Bargen', 'Schandeneich', 'Niedersiebenthal', 'Lang', 'Solothnrn', 'Suld', 'Stiegelschwaud', 'Rohrbach', 'Halde', 'Belpberg', 'Faulbach', 'Alchistorf', 'Leugenenbach', 'Golatenmattgasse', 'Wierezwyl', 'Thurnen', 'Aarboden', 'Mettenbergs', 'Luzeru', 'Berns', 'Oberbalm', 'Uetendorf', 'Langcnthal', 'Nidan', 'Ueschinenthal', 'Holwngriolrt', 'Amsoldingen', 'Almeudingen', 'Ahorn', 'Bnchsee', 'Libiens', 'Jegeustorf', 'Brienzwyler', 'Rheinfelden', 'Bleichenbach', 'Nysers', 'Mnrtcn', 'Simmenthal', 'Spengelried', 'Kleindietwyl', 'freiburg', 'Lobsingen', 'Tschingelbach', 'Wallisern', 'Belmont', 'Gsteig', 'Meugistorf', 'Wartburg', 'Lotzweil', 'Hessikofen', 'Otterngrat', 'Jolimont', 'Amerika', 'Laucherngrat', 'Adelbodenthales', 'Heimenhausen', 'Landerswyl', 'Schaugnau', 'Nannholz', 'Twann berg', 'Bachberg', 'Galenstock', 'Langnau', 'Hilterstngen', 'Beatenbach', 'Schulh', 'Oertlibach', 'Oberwallis', 'Steinberg', 'Balmegg', 'Golengrabens', 'Bernstr', 'Guggersborn', 'Walenbach', 'Jnterlakenthal', 'Gellihorn', 'Nydcckkirche', 'Nidfluh', 'Engiwald', 'Weissenburg', 'Waadt', 'Jnnozenz', 'Eschenwald', 'Gurnigclberge', 'Ueschtnenthal', 'Petinesca', 'Schupfen', 'Turbachthals', 'Neuenburg', 'Oberhausen', 'Falkenfluh', 'Hlienisberg', 'Riedtwyl', 'Thurnenmoos', 'Grimselspital', 'Eich', 'Kandersteg', 'Kaltberg', 'Zvllikofen', 'Jegistorf', 'Nenenbnrg', 'Furgi', 'Alblingen', 'Aermighorn', 'Aventicum', 'Durheims', 'Neichenbachs', 'Bowald', 'Lys', 'Sternen', 'Tusstein', 'Husegsee', 'Mnrtenwald', 'Kronenburg', 'Alp Bach', 'Kerzerz', 'Hornbach', 'Rawyl', 'Riggisberg', 'Schlipsen', 'Heimiswyl', 'Thalweg', 'GutiSberg', 'Waldegg', 'Blankenburg', 'Jakobsbach', 'Untcrfeen', 'Mntthorn', 'Stettbrunnen', 'Berg Reicheubach', 'Niederhorn', 'Fluh', 'Jnchhof', 'Kirchenfeld', 'Berneralpen', 'Bad', 'Burghubel', 'Adelboden', 'Augstmatthorn', 'Staufenbach', 'Gombs', 'Aetingen', 'Mehnthal', 'Scherzlingen', 'Rougemont', 'Kirchschwand', 'Hahnenmoos', 'Uctendorf', 'Grasenried', 'Seftingen', 'Laueneu', 'Otterbach', 'Kanton', 'Oegstein', 'Schwandst', 'Spielmatt', 'Rosengarten', 'Wabern', 'Walalp', 'Altachenbach', 'Dicssenberg', 'Scknvendeibergs', 'Jaun', 'Sanetschhorn', 'Laupcu', 'Roussau', 'Tampfwyl', 'Herberg', 'Enetchirel', 'Salvisberg', 'Galserbergs', 'Ligerz', 'Fermelthal', 'Trechsel', 'Niedertheil', 'Aarwangen', 'Grissenberg', 'Manuwyl', 'Chirelalp', 'Nydeck', 'Falken', 'Venzlauibach', 'Buchcggberg', 'Krattingen', 'Rothenflnh', 'Thnnersee', 'Wengi', 'Niklans', 'Deutschland', 'Breitfeld', 'Bncheggberg', 'Hasli', 'Arbelhorn', 'Goldswyl', 'Manneuberg', 'Bricnzwylcr', 'Narrenbach', 'Wynigen', 'Lhrontt', 'Renengasse'}",2415,"{'Rathhauses', 'Alp Baumgarten', 'OberBipp', 'Gammcn', 'Aar Weissenau', 'Bär Kreuz', 'Dorsch Hub', 'Frienisberg Kramburg', 'Längwald Bähnli', 'Fraubrnnneu', 'Emmenthal Ober', 'Känelgaß', 'TurbachTh', 'Gnrzelen Hof', 'Stdn Gurnigelbad', 'Buchmühle', 'Prägelz hkreles', 'ScheidwaldBezirk', 'Burghorn Hinter', 'Büttenbergs', 'Eichihöfe', 'NiederBipp', 'Trimstein Münsingen', 'Röthenbach', 'Roth Horn', 'Pfarrdorfe', 'Bondersattel', 'Abendwald', 'Reichsburg', 'Elsaß', 'St Vgl', 'Dettigen Bremgarten', 'Dürrenroth', 'Glütsch', 'Abthl Schattenhalb', 'Mühleberg Zugeh', 'Schwendihubel', 'Müslithal', 'WildEisigen', 'Geyachbergs', 'Gem JnnerDirrmoos', 'RuchtiHeimathlein', 'Burgdorfer Münze', 'Grindelwald Bußalp', 'FrieswylHubels Frieswyl', 'Rinderwald Frutigen', 'Std Vgl', 'HornbachSchnlhaus', 'Grüuenbachs', 'Waldsberg Luzern', 'BürenAns', 'Sügiez', 'Blumenstein Thierachern', 'Wallis Sept', 'UüttmAsn', 'Bieberach Biberach', 'Türrenberg Kienthal', 'Golatenmattgaßthor', 'Aebtingen', 'München Pfaffen', 'Rosenlanigletscher', 'Kien Worb', 'Wylhof Wyl Mühle', 'Weiler Heiligenschwendi', 'Bütenberg', 'Weiler OberB', 'Nidan Der', 'Schafberg Kihrel Chirel', 'Ztveistmmen', 'Rümligen', 'Strudels', 'Hurselen', 'NiederSimmenthal', 'Gurzelen Pfarrdorf', 'Ursonbnoü', 'Bei Wyler', 'Granholzes', 'Mvvonooli', 'Niederhünigen', 'Mistelacherberges', 'Fr', 'Demnach', 'Brügg', 'Dicßbach', 'Dornbühl', 'Bipp Wiedlisbach', 'Wimmis N', 'Kappelen Hs', 'Gem Wyler Hasle', 'Marziele Marzielethor', 'Gotteshauslente', 'Kaplanei', 'Reinisch Frutigen', 'Abthl Zäziwyl Konolfingen', 'Hotel Nusiguo', 'VölligenKrauchthal', 'OhmgcldSbcamtr', 'Rügen', 'Innere Hsr', 'Jttingen', 'Kabisberges Dürrenroth', 'Gurnigclb', 'Gandeck', 'Gelmer Gälmer', 'Ballenbühls', 'Alpenkette', 'Arlesheim Baselland', 'Alpschelen Alpscheli Berg', 'Aeltcre', 'Schloß Wimmis Jagdberg', 'TwärcnViertel', 'Hasle Hasle', 'Schwanden Dörfch', 'Saanen Rongemont', 'Furggigrats', 'Flüh Fluh', 'AeschlenAlp', 'Arnitzmühle', 'Merkwürdig', 'Hochwald', 'Trüttlisberg Std Lenk', 'Beck Der Körper', 'Tbales', 'Bettenhausen Rütschelen', 'Juchart Dörfch', 'OberAarhorns', 'Wirthsh Kaufhaus', 'NiederSimmen', 'Flühn', 'Balm Dun', 'Thuner Kap', 'Nri Brügglen', 'Hornfluh', 'Gelmersee Grimselpaß', 'Geschtcklichkcit', 'Gächliwyl', 'Reinifch', 'Der Stadtbach', 'Sternenberg Malefizsachen', 'r St', 'Civilsachen', 'Rüschegg Std', 'Grön Scheidwaldbezirk', 'Rümligen Riggisberg', 'Holzerstuh', 'Twann Nidau', 'Münsingcn', 'Zweilütschinen', 'Grüncnberg', 'iTEinwohnergem', 'Willisau Huttwyl', 'Aar der Emme', 'Burgruine Gave', 'Rüwethal Nychigen', 'Nothcnbaum', 'MittlerArni', 'Höhe', 'Thierbergs', 'OberBleiken', 'Bern Abr', 'Psarrd Kerzers', 'Guntenstutz', 'Ballenhans', 'Grafenried Pfarrdorf', 'Urtenen', 'Lauterbrunnen Abthl', 'Bern 1361 Iwrlom', 'SehoßhaldenViertel', 'Rath Solothurn', 'Schwarzhorn Blauengletscher', 'Juch Wald', 'Bach Grindel', 'Hügelreihe', 'Stadtöach', 'Stutz', 'Bärhegcn', 'Hasle Ober', 'Limssoral', 'Llnioüonduoü', 'Gurbrü', 'Freihof', 'Belp Zimmerwald', 'Oberbützberg', 'Wirthshaus Kalchofen', 'Krayligen Kreuzgasse', 'St Jvhannsen', 'Armensacheu', 'Wüschen', 'Alaunschicser Thonschiefer', 'Wald Weiden', 'Patrizier', 'Lüilvüort', 'Ocstlich', 'OIiunoIlinSeu', 'Pfarrhause', 'Jakobshügel', 'Kirchets', 'Sehenswerth', 'Wengi Dorf', 'Wald Märchen Brücke', 'Muri Gümligen', 'Luzern Entlibuch', 'Schönenbühl', 'Burg Stocken', 'St Johannseuhans', 'Grindel Nahe', 'Engistraße', 'Ncsselbank', 'Nordsee', 'Steinberg Schönisey', 'FinsterAarhorn', 'Nüblihorn', 'Fellswall', 'Rüdispach', 'Uri Schwyz', 'VillarsIeUoino', 'Kappelen Weiler', 'Bern Wallis', 'Pfarrhaus und Schloßgut', 'Blümlisakp', 'Büttenberg Nontpottum', 'Weierhof', 'St Hohfluh', 'FranceyBad', 'Bielersee Westlich', 'Gran egg Hof', 'Mauritius', 'Diese Bäuert', 'Stettlen Deißwul', 'Saxetcn', 'Std Solothurn', 'Unspunnen Palm', 'Bielersees Fuß', 'OltingenNeuenburg', 'Bärenloch', 'Hintergasse Hsr', 'AllenwylKosthofenweges', 'Elbechen', 'Franmatt', 'Gwatt Schorren Buchholz', 'Thurm Schlaguhr', 'Freiherrsch Spiez', 'Balm Stettlen Vechigen', 'Jrrenbause', 'Gurtendorfs', 'Brüggen', 'Schultheißcnamt Burg', 'Laui', 'Geißhof', 'Grenz', 'Haslithals', 'Uhrmacherei', 'Hauptstraße', 'WildElsigen', 'Barackenrain', 'Berg Schloß', 'Weiden Bodmen Hsr', 'Mühlethurnen', 'Melcheubühlgnt', 'Vlomesten', 'UnterDießbach', 'Schwarzsee', 'Schlündi', 'Martiöegg', 'Wallis Vgl', 'Grindelwald Haslethal', 'Lötschthal Strahlhorn', 'Allgemeinen Oberland', 'Heidbühl', 'Berggeländes', 'Völligen Abthl', 'Burk Balm', 'Dänemark', 'Limmpion', 'Schöpfs', 'Eisenarbcitcr', 'Drem', 'Attisholz', 'Nüeggisbcrg', 'Bemerkenswerth', 'Gem Laupen', 'Stasel', 'Freundhorn Toldenhorn', 'Jaberg Zügeln', 'St sö Bern', 'Nüderswyl', 'Aeschwald Hof', 'Rohrbach Pfarrdorf', 'Walkringen Höchstetten', 'Bern LoinnMn', 'Wergisthal Wärgisthal Werkhof', 'Bantigen', 'Grat Heimwesen', 'Aarganerheerstraße', 'Thörishaus', 'Langenthal Einwohneru Burgergem Unt', 'Aarbodenthals', 'Brienzergrats', 'Siebenthals', 'Wyßenstaldcn', 'Löwen Mühle', 'Thl Kirchlindach', 'Chlodwig', 'Buchsee Burkard', 'Hochbalm', 'Allenberg Heimwesen', 'Münsterplatz', 'Ompellu', 'IIoMerosbere', 'Horbengut', 'HabsburgLauffenburg', 'St Nrban', 'Tschuepis Tschuppis Haus', 'HuttwylerAllment', 'Schwäbis', 'Bächlen', 'Kander Selten', 'Hirschmatt', 'Amthaus', 'Nuntigen Mazwyl', 'Buchsee Edelknecht', 'Holol', 'Seewel', 'Adelboden Eisenstein Oberhasle', 'Räthe Bern', 'Schwefelbade', 'Außer', 'Donnerbühl', 'Großen Rathe', 'Häuf', 'Nngerols', 'Obrigkeitliches Salzmagazin', 'Knnbel Barheg', 'Wendschatz', 'Kirchenrath', 'Gem Hellsau', 'HabsburgKyburg', 'Münnenberg', 'Krone Gasthof', 'Thieranatomie', 'Thal zerstr Kirch', 'Der Gerweruvi', 'O', 'Kirchets Meiringen', 'Rättli Feld', 'bühl', 'Berg Berg', 'Kühedungel', 'Emnienthal Hub', 'voclesiu Luroero', 'Haus Gütchen', 'Mtigen', 'JlfisViertel', 'StA Amfoldingen Pfarrdorf', 'StA Aarmühle', 'Altels Balmborn', 'Schrattenfluh', 'Rümligen Gelterfingen', 'Bache Kloster Höfe', 'Mittelhäuscrn', 'SchwarzeneckErizstraße', 'Altcrthumsspurcn', 'Thalebene', 'Flachsknltnr', 'Steinbergglctscher', 'Fitzerhorn Bütschifluh', 'Emmenthalstraße', 'Pfrnndeinkommen', 'Vvlkssch', 'Ebendahin', 'Franmattweid', 'Waldstätte', 'Bühlzaun', 'Mahleren', 'Pulvermühle', 'Gsür Adelboden', 'Thälch', 'Berg Birren', 'Dießbach Kirchlindach', 'Walkrin', 'Wohlen Hubel', 'Weißenburgbaö', 'Schafhausen Weiler Souius KU', 'Finsterhenneu', 'GroßHorben', 'Bern Freibnrg', 'Saanenlande', 'Gadmen Thal', 'Wyl Bergschloß', 'Bremgarten Hasle', 'Wirthshaus', 'Räthe', 'Aetschligen', 'Tru bsch', 'Hessikofen Hettiswyl', 'Holligen Käderegg', 'Vortheilhaft', 'Hsr Alp', 'Münsters', 'Hinteregg Hof', 'Frick', 'Hochgebirgs', 'Handeck', 'Abbühl', 'Hünigen', 'Ueber Blattenweid', 'Lüonol', 'Steinberg Hauri', 'Römer', 'Aargan Bern', 'OberDiesbach Konolfingen', 'Todtenkirchhof', 'KauderKanal', 'D', 'Bänderwald', 'Walperswhl Nidau', 'Langenthaler Kap', 'Bühlikofen Stöcken Bühlikofen', 'Leissigen Jnterlaken', 'Wahlerenhubel', 'OomiiiekinAen', 'Neubrücke', 'Aeschi Reichcnbach Frutigen Adelboden', 'Deißwyl', 'Torfstraße', 'Lüterkofen Nennigkofen', 'Roßalp Vgl', 'Kornzehntens', 'Lauenen Gsteig', 'Uebrigcns', 'Mönch', 'Gem Bremgarten', 'BodenBäuert', 'Rüegsau', 'Mattstetten Erlach', 'Stadtthor', 'Brienz Jnterlaken', 'Große Spital', 'Whlerbrücke', 'Brügg Gr', 'Signau Trachsel', 'LsrZos', 'St von Bern', 'Wyleroltingen Gurbrü', 'St Bern Konolfingen', 'Zehntens Gasel', 'Stockenfluh', 'Alpiglen Ober', 'Faulhorus', 'Urtenen Moosseedorf', 'Rothenkasten', 'Wyniger Brücke', 'Rüthihof', 'Nydeckbrückgasse', 'Kramoder', 'Solothurn U', 'Wandfluh', 'LauterAarhorn', 'Ellenberg H', 'Latterbach StWA', 'Kernenried Dorf', 'Heerden Hirten', 'Hauptwachtplatz', 'Holzbrnnn', 'Wetterh', 'Zäzibach', 'Weugen', 'Brunnqueüe', 'BernerAlpen', 'Atigschwende', 'Gradlisberg Hof', 'Franenkloster Brunnadern', 'Lindach Lind', 'Kirchthnrm', 'Neßleren', 'Waldberges', 'Burghorn Vorder', 'Münzsammlung', 'Thun Vurgdorf', 'Erwähnens', 'Gäbelbachs', 'Mühlenen Frntigen', 'Benzenberg', 'Schüppach', 'Burgerspital Bern', 'Lüterkofenbach', 'Brüchli Alp', 'Eichholz Unter', 'Büren zum Hof', 'kinpomi Ai8', 'Graßburg', 'Ried Höfe', 'GtoßMühle', 'Kander Frutigen', 'Klosterkirche', 'Utti', 'Aarberg Affoltern', 'Luternau St Urban', 'Berge Gletscherund Alpen', 'Galgacker', 'Arnezmühle', 'Brandösch Vord', 'Std Weges', 'Waldemmen', 'Gern III Schoren', 'Eigergletscher', 'Teitigen', 'Die Kastlanei', 'Port Bräschgen Preschgen Hsr', 'Martinsdruck', 'Zuoberst Thal', 'Agraswyl', 'Aar Ehemals', 'GroßDietwyl', 'Simmenthal der Wallisergr', 'BlumeusteinBad', 'Scheuß Mett', 'Aeschlen Aetigen Pfarrdorf', 'Der Limpach', 'Twinghaus', 'WyttenbachBiertel', 'Grünenmatt', 'Fluh Höfe', 'Schloß Blau', 'Bümpliz Bümpliz', 'Str den Kurzenberg', 'Ilolpensis', 'Trajan', 'Tomdekan', 'bern', 'Haus Feuer', 'Niederösch', 'WaldXtklioltorn', 'Lauenen Lauibach', 'Seehorns', 'Diemtigen', 'Urtelcngrat', 'Schwarzlütschinen', 'St Patten', 'Hs', 'Urtenen Uiinlelwnnoü NuiiäerotnnKou Münchringen', 'Däfiloch', 'Teißwyl', 'Bürglen Kirchort', 'Bürgleu Nidau', 'Breitholzwald', 'Std Bemerkenswerthe Berge', 'Andern Vitriol', 'Strahlhorn', 'Mööslin', 'HandeckSennhütte', 'Gongtriesthorns', 'Unt', 'Morgarteu', 'JbachHubel', 'Bäuerten Wenge', 'Ausburgerschaft Burg', 'Lyßbachs', 'Schwarzlütschiue', 'Thürmen', 'Trüttlisberg', 'Simmenthal St', 'Mühlebacko', 'Seeflnh', 'Thun Bern', 'Allmeng', 'Koppigen Burgdorf', 'Waag', 'St Bleuerhof', 'Frutigcn', 'Hürnwald', 'Steiget Brücke', 'IüAmvr68', 'Tampfschifffahrt', 'Nuliäork', 'Falkenplätzli', 'Weißcnau', 'Gem Hettiswyl', 'Std Niedburg', 'Zur Linken', 'Brienz Ninggenberg', 'Röthenbach Signau', 'Gummfluh', 'Savoyischer Fcldzug', 'Kurzeugol Kurzengold Hof', 'Schwellenmatt', '2cU', 'Wallis Unter', 'Spittler Pacht', 'Stellhorn', 'Kirchgemei', 'Neunenen', 'Gerzensee Seftigeu', 'Kirchhügel', 'St Sebastians', 'Paßhöhe', 'Oberberges St von Saanen', 'NiederAlchistorf', 'Kleine Länggaß', 'SoümlinAou', 'Hahnenmoosbergli', 'Schwalmeren', 'Mailänderkriege', 'Schulhause', 'ThunAlmeud', 'Burghorns Brienzergrat', 'Hindelbank St', 'Herrenschwandcn', 'Neuenegg Gümmenen', 'Forst Zwieselberg', 'Chamberges Kappelhäuslein Haus', 'Bleienbach Madiswyl', 'Hasle Grund', 'Freigericht Steffisburg', 'Wynigen der Straße', 'Affoltern Radelfingen', 'Mühlau', 'Falchernbach', 'Rüegsau Pfarrdorf', 'Därstetten', 'Hintere Hof', 'Limpach Pfarrdors', 'Thuner Tschuggen', 'Wyken', 'Wildstrnbels', 'Mülenen', 'Tcywarzlütschinen', 'Freigericht', 'Spiez Urk', 'Ackerfeld Wiesen', 'Höben', 'Kirchthurnen', 'obenaus', 'Muschelsaudstein', 'OberBrandhubel', 'Schloßruine', 'Bottigen N', 'österreich', 'Steinmasseu', 'Hornviehs', 'Zur Gem III Mirchel', 'Goldbachs', 'Vränzikofen', 'Gasse Hauptgasse', 'Bargen Pfarrdorf', 'Thurnen Seftigen St', 'Edlen Aarwangen', 'Haus Glissen', 'Kaltenbrunnen Kaltenegg 613 Kaltwasserheilanstalt', 'Spiez Mannenberg', 'Aarhochufers', 'Brienzerkartoffel', 'Jmerins Vllll', 'Tschiugellochtighorn', 'kyburg Urbar', 'Bergs', 'Onxo', 'Tschuppelhäuslein', 'Kunitz Sachsen', 'Münchenbuchsee', 'Thal Grindelwald', 'Spiezwyler', 'Walliser Windspillen Saanen', 'Weißcnburg', 'Kapfenberg', 'Edlen Lindnach', 'Vinelz Bndley', 'Wallis Sonnenkronen', 'Schwarzenegg Goldswyl', 'sw', 'Schiltwaldfluh', 'llmmpion', 'Rebmatt Hof', 'Rnderswyl', 'Aeschlen Hsrn', 'Brügg Brügg', 'Ralligstöcke', 'Habkern Entlebuch', 'InmsolinMn', 'Pieterlen Bremgarten', 'Läusligen', 'Lochseite', 'Heünenschwand', 'Badhans', 'ClnniaeenserOrdens', 'Gauchheil Hsrgr', 'Twannbergs', 'Wohlen Säriswyl', 'NömischeAschentöpfchcn', 'Die Port', 'Hofbez', 'Habkern llnbvlmwn 1275 Uabioüorn 1309 Uaküerron', 'Stellihorn Hochjägihorn', 'Hof Breite', 'Bergjoch', 'Falzenfluh', 'Notottneuv', 'Kapf Rebgut Hsr', 'SchweiU Hof', 'Türrmüble', 'Laucherhorn', 'Füßli Schweiz Museum', 'Aerlenbachbrücke', 'Bättenberg', 'Schangnau Eggiwyl', 'AetigerBerg', 'Argöw', 'Sternwarte', 'Schmiede', 'Simmenegg Bern', 'FcuerS', 'Südalpen', 'Ammannsegg', 'Grindelwald Pfarrd Allmis Hsr', 'Konolfingen Das Pfarrd Walkringen', 'Vucheggberg', 'Välliz', 'Schloß Schadau', 'simmenthal der Lenk', 'Hundshörner', 'Grindelwald Herabstarren', 'OberGurzelen', 'Gsür', 'Helisbühl', 'Bipp Bipp Nieder', 'Verrath', 'Gadmerwasser', 'Entlebuch Burg', 'Gotteshausleuten', 'Gümmenen Laupen', 'Glashütten Gütchen', 'Faulhornkette', 'St Maurizen', 'Wallis Wiewohl', 'Bäuert Entsch', 'Griinsel', 'Wieslandes', 'Naron', 'Zäziwyl', 'Niesen Frutigen', 'Str Burgdorf', 'Biembach Burgdorf', 'Aeschi Neichenbach', 'EngiHalbinsel', 'Haus Kyburg', 'Könitz Pfarrdorfu Bern', 'Münsterthurm', 'Ganligletschers', 'Stoffelsreuti', 'Std Loh Loch Hsr Prasten Marchgraben Haus Achseten', 'Krn Albrist', 'WildStrnbel', 'Niedern Spital', 'Schallenberg', 'Zunfthäuser', 'Lauenenseelein', 'XIII Kapfgut', 'Mittaghorn Vgl', 'Ledi', 'KrMmuMu 1181 IlerMmuMn 1201 Ergs', 'Därstetten Vermuthlich', 'Waldstrom', 'Joch Jochberg', 'Wimmis St Thun', 'Tbnnersee Oberland', 'Bern St', 'Nühnk', 'Saanen Zweisimmen', 'Bade Etivaz', 'Vom Diecht', 'Grimselpasse', 'LauterAarjoch', '3Stdn', 'Wirthsh', 'Ackerweid', 'Emme Emmat lat  mmu Lmmu Lmmmm Linmotu', 'Jaspis Granit', 'Köuiz Abtbl Wabern', 'Diechterhorn Triftenstock', 'Obcrbipp Wangen', 'St Eichi Ober', 'Saone Burgund', 'Lomiwtus', 'Biglen Buchacker Hof', 'Twann Geicht', 'Edlen Rümlingen', 'Langenthal Bern', 'Grächwyl', 'iVurol', 'Erlenbach Nieder', 'Aarganerstraße', 'Wengi Bern', 'Grüsisberg', 'NiederWirtneren', 'Thal St', 'Wohnhsr', 'AltBubenberg', 'NiederGoldbach', 'Kornhansplatz', 'Bruchenbühl', 'Aarberg Schlipsen', 'Feilenderg', 'Str Thun', 'Thnner Kapitels', 'Kastlanei Frutigen', 'Palmwoche', 'Thalgrunde', 'Rindfleischhöhle', 'RomooserEnzi', 'Handeck Gelmerhorn', 'Lauenenbaches', 'Ncichenbach Schloß 608 Neichenbach', 'Hochgsträß', 'Diemtigthales', 'Weißensteingut', 'Zihl Bürgten', 'St Kaltenbrunnen', 'Gandeck Moräne', 'Gottstatt Aegerten', 'Murg Noth', 'Frauenkloster', 'ölomvston', 'Rendlen', 'Franmatthof', 'Alpberge Waldhöhen', 'AnßerOrts', 'Lehn Hsr Roßweg', 'Aarwyl', 'Teufenbach Tiefenbach', 'Std Riedacker Hof', 'Ramscr U', 'Bümpliz', 'Ltmplitx', 'Balmberges', 'Kienholz St', 'Ghürnberg', 'Reichenbach Heutligen', 'Sefilütschinenbach', 'Trunen', 'Neuenegg VLO', 'OberHoblen', 'Leberbergs Jura', 'Thalkessel', 'Kanderffeg Bütschels Häusergr Kan', 'Forstn Welschland', 'Fontenen', 'Pfarrdorf Bümpliz', 'Höfe Hötschigen', 'Landstuhl', 'Bellerive Std von Thun', 'Nessenth', 'Bäuert Kirch', 'Klus', 'Hergisberg Hsr Rauchmühle', 'Taunlihorn', 'Bülikon Hof', 'Büttiosa', 'Sandflnh', 'Sennhütten Schwarzwald', 'KleinErlenbach', 'Weiler Schwenden', 'Gsteig VLO', 'Helferei', 'Rühnkhofen', 'Ebnit Ebnit', 'Bellmund', 'Bäuerten Winkeln', 'Ger Güm', 'Kzunis', 'Bramöergs', 'Pfarrd Thierachern', 'Nöthenbachs', 'Tscheppach Brügglen', 'Rätzliberg', 'St Bern', 'Thonschiefer', 'Spitalbühl', 'Bern Genf', 'Linden Linden', 'Juter', 'Aarbergerstraße', 'St JohannsenUrkunde', 'St Schangnau', 'Thal Wang', 'Aar Bern', 'Aargletscher O', 'Thallenteu', 'Interlak Urk', 'Seewli Seeli', 'Industrie', 'Pfaf', 'Simmcnthal', 'Multenmühle', 'Lüßlingen', 'Gontenbach', 'Blauhaus', 'Oelmühle', 'Hauptthales', 'Bernpfd', 'Eiuwohnergem', 'Spreitlauine', 'Llmlimeüy', 'RüegsauSchachen', 'Könitz Stein', 'Elbezen', 'Probsts Jnter', 'Kollatnr', 'Stdn Weges', 'Sanetschpaß', 'Agy', 'Bemerkenswerthes', 'Fraubruuuen', 'Mühle Nessen', 'Weim bergen', 'Bütschi', 'Bällitz', 'Golzwylersee', 'Trümleten', 'Büetschwyi', 'Jnterlaken Gsteig Jnter', 'Nydcckbrücke', 'Hof Bartholome', 'Halbbrigadc', 'Ländchen', 'Unterwalden Obwalden', 'Std Thun', 'Hohenschwand Bergs', 'Mrtini', 'Illuiollsiibuvk', 'St Georgeutag', 'Frohbergs', 'Bisthums Lausanne', 'Sumiswald Langnau', 'Ackerfelder', 'Alpscheln', 'Aerenbolligen', 'Gasthans', 'UnterUrbach', 'Aeschi Heustrich', 'Bern Luzern', 'Otterbach O', 'Burgistein Edelknecht', 'Gem Kandergrund', 'Zur Abthl Gnttannen', 'Jnterlappen', 'Oberländer Schnee', 'Wirthshaus Schmiede', 'rle Chirel', 'Diemtigthale', 'Schillingen', 'Gem Alchi', 'Räterichsbodeu', 'Oberthorbrücke', 'Oertchen', 'GsteigB', 'Steffisbnrg Thun', 'StTM', 'Stadholz', 'Simmenthal Pf', 'Schilthorn von Lauterbrunnen', 'Schloß Burgdorf', 'Bänert', 'platzgasse', 'Nothfallstube', 'Scheidcstraße', 'Rahnflüh', 'Bremgartens', 'Emme zerstr Lauperswyl', 'Eriswyl Std', 'ScheidgassenViertel', 'Langen', '18Ü0', 'Vütscheleck', 'Dali OberEichi', 'Breitenrain Vgl', 'Furenweid', 'Igel', 'Nydeckbrückenbaues', 'Aar Frauenkappelen', 'Bern Balm', 'Achsetberg Bort Der Stafel', 'Großer Spital', 'Stifts', 'LInioüinbnoü', 'Tundwyl', 'Büttlassen', 'Grindel Bußalp Wärgistabl', 'Lkoullalle', 'Harder Angstmatthorn', 'Nydeckbr Bern', 'Entlibuch Stdn', 'Gem Langenthal', 'UnterWaltrigen', 'Gem Mnri', 'Ochsenkopf', 'Vremgartenwaldes', 'rothe Horn', 'Furkapaß Vgl', 'Bätterkinden Bern', 'Landmarch', 'Büttenberg Gottstatt Abthl Safneren Nidau', 'Hüpfenwald Hupfen', 'Sannen Ober', 'Tracbselwald', 'M §', 'Mänigspitze Menigberg', '356G', 'Uebeschisee', 'Schloß Scheuer Hof', 'Blumenstein Thun', 'Baumgarten Bern', 'Dürrenwald', 'Ried Sch', 'Dießbach Unter', 'Wangen amOenzbach', 'Karthäuser Thorberg', 'Mühlethals', 'OberEmmenthal', 'Haus Zinsmoos Hsr', 'SaanerWald', 'Lroolllünl', 'Frisching Bern', 'Lindenhof Basel', 'Höchstetten Dorsch', 'Gump Tiefe', 'Spitalkirche', 'OumilmZiu', 'Schupf', 'Läber', 'Billigen', 'Gerbe Hubenhof Hueben Lerch', 'Fraubruunen', 'Bäniseck Schafweide', 'Küttikofen Kypberg Mühledorf', 'Staubbachs', 'Thals', 'Gerlafingen', 'Gentelwasser', 'Röthen', 'FarEs', 'Bäuert Hirzboden', 'Karthause Tborberg', 'Gürbe', 'TannenBad', 'Gem Tüscherz', 'Grvßrath', 'Kriesbaum Kirschbaum', 'Weißenburgberg', 'Altenberg Schwarzes', 'Sels Bisth Straßburg Ooäenctork VVinclemis Uetendorf Wimmis', 'Dießbach Abthl Freimettigen', 'Buren Aarberg', 'Stämpflishäusern', 'Tschipperellen', 'Gurnigelbad St', 'Pilatus', 'Schöftland Alb', 'Alfermö', 'OberBützberg', 'Thürings', 'Jaunthales Jann', 'Sünisberg', 'Kappelen Pfarrdorf', 'Dörfch Jfeltwald', 'Feldhof', 'Aarberg Buren', 'Werner Oberlandes', 'Knubel', 'Gunten', 'Hinderlappen Unterseen', 'Armillon Arnenbcrg Arnensee', 'KleinBurgund', 'Biberen Ferenbalm', 'Rothenfluh Balm', 'Englisberg aulistahl', 'Saone', 'Tannenbühl', 'Pfarrd Leissigen', 'Reichenbachbad Bad', 'Teufelsgraben', '6u4om', 'Hölisbühl', 'Uetendorfberg Amsoldinge', 'Burghalde', 'Thunstraße', 'Laudrechts', 'SchützenHans', 'Zum Schulbez', 'Leukerbad Wallis', 'Thalstrecke', 'Nathhauses', 'Wikardswyler', 'Lindenfeld Thörigen', 'Engstlenthale', 'Conr Bnrgistein', 'Seehalten', 'Büe', 'Thun Pulvermühle', 'Heerstraße', 'Netschbühl', 'Lüt', 'Thun von Neutigen von Thierachern', 'kirchl Stifte', 'Jttishäusern', 'Schwarzenegg Wachseldorn', 'Kornhans Th', 'Schweiz Museum von Füßli Jahrg 1795', 'Lütschine', 'Brüggelbach', 'Gasternthals', 'Rüti Wyßenflnh', 'Schwarz Horn', 'Aerlenbach Erlenbach', 'Das Rüggisbcrg', 'Trachselwald DasLandstädtchen Huttwyl', 'Bnchenlaubs', 'Bremgarten Pfarrort Schloß', 'Str Obersimmenthal', 'Brienz Riuggenberg', 'Gürbethal', 'Schupposen', 'GroßAffoltern', 'Gwatt Einigen', 'Fraubrnnnen', 'Bauernod Unter', 'Frienisberges', 'Rebhügel', 'Goßliwyl', 'Gülten', 'Büttschel', 'Rüfenacht', 'Wyler V  H', 'Ibootn', 'Alpenregion', 'Savoyen Gümmenen', 'Münchenwyler', 'Haus Snmiswald', 'Gem Gysenstein', 'Männlifluh', 'St Colombes', 'Bern Stdim', 'N', 'Burgdorser Kap', 'Hint', 'Haus Grünenberg', 'Schenchzer', 'Heimathen', 'Ghürnwald', 'Eichwaldes', 'Bümplitz', 'Hauben Hof', 'Jaberg Word', 'Bäran Spital', 'Jaberg StM 202', 'Edlen Priesen', 'Gem Rumending Rnmedingen', 'Kienthal Frutigen', 'Nunclorvllltt', 'Thurnsn Seftigen', 'Bätterich', 'Bußalpbach', 'Std Kirchdorf', 'Röthihorn', 'Dächlibach', 'Oertchen Riedli', 'Läng', 'Oberwyl Pfarrdorf', 'NiiegsbachViertcl 618 Rücgsegg', 'Wollenindustrie', 'Arnisagi Baldistall Baldenstall Valdistahl urk Balderstal Valdratzstal', 'Aargauerstalden', 'Trnbba', 'Thunerstraße', 'Ried Scheidgassen Niederdorf', 'Unspunuen', 'Enetbach Aenetbach Lnonlbaoli', 'Wynau Pfarrdors', 'UunoinAS', 'Aarjoch O', 'Griesen', 'Krö', 'Villmergen Linden', 'Weißeubnrg', 'Thalboden', 'Gemeindsbczirke Bach', 'Nagelfluhfelseu', 'Negierungsstatthalters', 'Bolligen Bandelier', 'LenkHahnenmoos', 'Jordans', 'Schwarzsee freiburg Seusebez', 'Rüdeli', 'NeuBubenberg', 'Könitz', 'NiederSinnnenthal', 'Stockbornkette', 'LaudiswylBezirk', 'Gampelcn', 'Handeckhütte', 'Murten Neuenburg', 'Rütihof', 'Urathshörnern', 'OberTießbach', 'Vogtrecht', 'Schmalzgrube', 'Dahin', 'Affoltern von Weingarten', 'Judcnkirchhof', 'Königsthal', 'Grien 6rüu', 'Brandösch', 'Brüchli', 'Häftli Büren', 'Beinholz', 'Stadtwaldung', 'Ralligflnh', 'Rohrbach Aarwangen', 'Bürglegut', 'Breitholz', 'Bürglen', 'Psarrdorf Hasle', 'Salzmagaziu', 'Thal Wynigen', 'Hard Höfe', 'Museum naturhistorischcS', 'Münsingen Abthl', 'Büntschbach', 'Tiemtigen Weiler', 'Höble', 'Zum DorfDrittel', 'Schnlhaus', 'Muntigalm', 'Lluvvlozwos Dorf', 'Badwirthsch', 'Geschenenthal', 'Scherli N  O', 'Oltigen Runtigen', 'Büren Wangen', 'Bütikofen', 'Znbchörde', 'Haus Wirth', 'Mühledorf', 'Gersten Garzen Schwarz', 'KerzerS', 'Hagel', 'Klösterli', 'Aarhorns', 'Dorf Teß', 'Bäuert Zwischenflüh', 'Türrmühle', 'Mädenschulcn Töpferwaare', 'Hohwürz', 'Arconciel', 'Nothstaldcnhof Hof', 'Thal Pfarrort Interlaken', 'Urbachsattel', 'Thörishausstr Brücke', 'Wohnh der Halen', '6trsla 6tro 6lIn ors', 'Fahrni Steffisburg', 'Aeschlimanns', 'Mettenbühl', 'Martinsloch', 'Oberried Kerzerz', 'Kloster Museum', 'Feldgcmarknng', 'Gasternholz Gaffern Gempelen Hsr', 'Mura', 'Morlotläubleins', 'Wölflisried', 'Links', 'Falch', 'Limpach Fraubrunnen', 'Freiburg Uechtland', 'Ochsen Wald', 'Schwarzseebade', 'Steinbrüche', 'Ueltschi', 'Süri', 'Jnni', 'Mühlenenstutz', 'Haubenberge', 'Simmenthal Diemtigen', 'Frnttgen', 'Bühlhof Bümpliz', 'Schloß Npdegg', 'N  W', 'Nitzbach Nizbach', 'Bäderberg', 'Gem III Jffwyl', 'Nürnberg', 'Suls Std Reichenbach', 'Abth Schattenhalb Oberhasle', 'Ebnefluh', 'Lei Bern', 'Rüthi Dorf', 'Weinbergs Twann Ligerz Ligerz', 'Bricnz Juterlaken Lauterbrunnen', 'Margels', 'KänelGanterisch', 'Lyß Lyßwald', 'Kaltenherberg Kaltackerberg Weiler', 'Rüegsbach', 'Bergacker ArniBezirk', 'Simme', 'Eigenthum', 'Oenzfall', 'Emme Der Wald', 'Bäuert Achseten Elsigen Engibrücke', 'Affolternstraße', 'Rebgut Wohngeb', 'buchsee Wangen', 'NiederLindachwald', 'Palästina', 'Pfarrd Worb', 'Namscrn O', 'Ferenbalm Jerisberg', 'Wannengrat', 'Dreispitz First der Schwalmeren', 'HubbergViertel', 'Herrsch Toffen', 'Seeland Aarberg', 'Obermatt Feldmoos', 'Haus Savoyen', 'Trachselwald Sumiswald', 'Brnstübel', 'FaLkenfluh', 'Mättenbach', 'Kirchlindach Ober', 'Ocmittntus', 'Gem BernerischMessen', 'Jnterlaken Bern', 'Bargen Kallnach', 'Senfzermatte', 'biMlsee', 'OitinMii', 'Rötheln', 'Gsteig Abthl Wilderswyl AJnterlaken', 'Bolligen Bern Laupen', 'Bern Vergl Bern', 'Eisengrube', 'Affenthal Hsr Brunnacker', 'Tannenwald', 'Glashütten', 'Hornflnh', 'Bütschifluh', 'Pfründlistock', 'Bocken Rebloch', 'Breiti Breite', 'Waldan', 'Balmi', 'Lorraine', 'WRO', 'Kunkel', 'Suleck Vgl', 'französ', 'AlpGils', 'Hsr Mühle', 'Lütschenth', 'Selz Deßwegen', 'Grünenberg', 'Altels', 'Breuw', 'Vern', 'Nidau Walperswyl', 'Dießbach Konolfingen', 'Rathe Bern', 'Distr Buren', 'Thalnngen', 'Frutigcn Reichenbach', 'kertorl', 'Napperstübli', 'emmenthal Alpgem', 'Weißenstein', 'Müufingen', 'St von Thun', 'Dörfch', 'Murtnerthor 160 Murzclen 583 Museum', 'Könizberg', 'Kornamt Urk', 'Saanenlandes', 'Gem arschwaud', 'Haus Scharnachthal', 'Gstaad Saanen Laupen Gümmenen', 'Str Büren', 'Asfoltern', 'ThunAllmend', 'Wohlen Bern', 'Grüniberg', 'Vurghügel', 'Aarmühle', 'Luolioltron', 'KileyAlp Dahin', 'Habkerig', 'Fclsenkluft', 'Fitzers', 'kirchl', 'Gießbach', 'Meiringen Willigen Jsenbolgen Hausen', 'Bucheggberg Kriegstetten', 'Haus Thunstetten', 'Aargletscher Unter', 'Ammertenbach', 'NüthiLängeneyWaldwegs', 'Hohlen Rauchenbühl', 'Krattiggraben Mühle', 'Haslithal Meiringen', 'SimmcnBrücke', 'Schloß Wyl', 'Neuligen', 'Zähringen', '8nneti', 'St Johannscnhaus', 'Brück', 'Niklaus St', 'Klosterhubel', 'Gantrist', 'Forst Forst', 'Diesbach Ober', 'Schuttgeröll', 'Haus Bern', 'Winkelbachmühle', 'Nüthi', 'Wachtthurm', 'Kirschwachs', 'Grimselhöhe', 'Allenlüften', 'Commenthur', 'Buchsce', 'Hof Graben', 'Storchengut', 'Pfarrd Reichend', 'Ferenbalm KleinGümmcnen', 'Käpelli', 'Sollalkelvn', 'Aergöw Aar', 'Baggesens Parthenais', 'Dießenb', 'Langnau Signau', 'Vanel die Saane', 'Lützelflüh Grünhorn', 'Jaberg Kirchdorf', 'Std Ueber Form Muschelsandstein', 'Erlacherhof', 'Brenzikofer', 'Gamchi', 'LioüinAen', 'Grindelwald Thal', 'Bern Rathe', 'Ryffershäusernstutzes', 'Tündenbach', 'Engi Halbinsel', 'Aar Wankdorf', 'Bühl', 'Hohenstollen', 'Alcheufiüh', 'Moos Stadtlehen', 'Ferenbalm Laupen', 'Gsteig der Sattelegg', 'TenfelsKarrweg', 'Roßknubel', 'St Petersinsel', 'Saanen der Hornfluh', 'Väuerten', 'Villa iXova', 'Gampelenmoos', 'Näheres', 'Jordan', 'Haus Bnbenberg', 'Heid Dorf', 'Mühlethal Hsr Mühlen', 'Torfes Gals', 'Spital Tönn', 'Knrzenbergs', 'Affoltern Pfarrdorf', 'Sels Elsaß', 'Rüwethal', 'Bächigut', 'Tscheppach Tschingel', 'Mnristaldens', 'Berggut Berg', 'Das Torf', 'JnnerOrts', 'Keßlergasse', 'Kilchbühl Kilchboden', 'Pfarrd Zugeh', 'Schiedgcrichtssprnch', 'Brodhäusi StWA', 'Obcrlyß', 'Längenbühl', 'LangenthalMelchnaustr', 'Stämpach', 'Metzgergaffe', 'Aarwangen Pfarrdorf', 'Brückfeld', 'Kalchstctten', 'Eschwyl Entschwyl', 'Hsrn Franen', 'Jeusbergs', 'Mühle Säge', 'Aarlamm', 'Diese Burg', 'Eichihöfen', 'Kandersteg Bühl', 'Griesbachsaage', 'Lötschenberg Lötscherberg', 'ThunerAllmeud', 'Stadtrathhause', 'O  N', 'Kriegsegglen', 'Bern Luzern Unterwalden', 'Wimmis, SLOC', 'Buren Ob', 'Iiobu Inmbn', 'Uun  1361 liunitx', 'Fraubr', 'Gümligen', 'Snmpftiefen Schwarzenegg', 'Alpen Egg', 'Herzogenbuchsee Wangen', 'Staldenstr', 'Brienz Aeschi', 'Jnterlaken Hasle', 'Krauchthalmooses', 'Burgistein Margrethen', 'Llmmniun', 'Münzgebäude', 'Burgcrenzicl Altenberg', 'Vincenz St', 'NiederDipp', 'Erlach Neuenburg', 'St Stephan Vgl', 'Bisthums Basel', 'Langenthal Vgl', 'Thörigenmatten', 'Därstetten Nied', 'Schloß Landsitz', 'Lützelflüh', 'Ibten Jahrh', 'JnnerAchseten', 'Nägelisgrätli', 'Rohrbachstein Mittagshorn Rawylhorn', 'Lammerhorn GroßStrnbel', 'Twannsluh', 'Sädelstngen', 'Moos Hsr', 'Alp Engstligen', 'Hasli Rüegsau', 'Kallnach Pfarrdorf Kirchgem Aarberg', 'Simmenthal aushnlsswcise', 'IlinMiiborA', 'Sch 1827 Hsrn', 'Beides Mülinen', 'Eriz der Schwarzenegg', 'Thalsage', 'Aalen', 'Ortsadel', 'Roßhäuscrn', 'Gsteig Bern', 'Ltänderäthe', 'Gimmelwald Mürrcn Ammerten Lauterbrunnen', 'Mühlestcttlenhof Mühlethal', 'Ölten', 'Schneelinie', 'Saanen Gsteig', 'Unterthor', 'Sibnen', 'Folgendes Reuigen Ober', 'Reuß', 'Amsoldingen Pfarrdorf', 'Narrenbach Oeyen', 'Geißenthal', 'Grimsel Juchli', 'Port Sutz Täuffelen Siselen', 'Kalchmatt', 'Mühlebach Twannbach', 'Scmetsch', 'Jochpaß', 'Frutigen Aeschi', 'Urnerlande', 'Buchholz Hsr', 'Sumiswald Joh', 'Bielersees Tüscherz Twann', 'Mühlenen', 'Thierspital', 'Urk Loclox Irculitionum Uoimstorü', 'Oberburg Hasle', 'Leißiggrat', 'Bußwyl', 'Langnau Signau Derselbe', 'HinterFultigen', 'Signau Ehre', 'Aarberg kirch', 'Därligcn', 'Dießbach Hauben Oppligcn', 'Rath Bern', 'Tschugg Abhang', 'Lindenholz Mühle', 'Wildstrubel', 'Lauenenthal Grenze', 'Twärenbach', 'Wichtrach Kiesenbach', 'Bergfeld Hsr Signal', 'Mnhlercn O', 'Schulh O', 'Erlenbach Pfarrdorf', 'BernerAlpcn', 'Fluhsee', 'Boßwyl', 'Thor', 'Wirthshaus Schmieden Gasthof', 'Frieswylstraße', 'Lohnerbergs', 'Badhause', 'Aar Aare', 'Sumiswald Bern', 'Brunnenloch Haus', 'Ueberschwemmcu', 'Alfermee', 'Bernegg Heimwesen', 'St Urban luvlistvtte Innvkst Thnnst', 'Männliflnh', 'Schweiz Museum', 'Walkringen Pfarrdorf Kirchg', 'Than Thangraben', 'Arni HornbachKurzeneygraben', 'Gem Thun', 'Gaulihorns Wellhorns', 'Thales Mäniggrnnd', 'Kirchberg Pfarrdorf', 'Bäriswyl', 'Halbinselterrain', 'Neuenegg Forst', 'St Bcatenberg', 'Rawylpaß', 'Kilch', 'Wynigen Hügli', 'Nathhaus', 'Könizstraße', 'Büren Dieß', 'St Abhang', 'Schwenden Chrinnen', 'Schulhs', 'Dörfch Hsrn', 'WntillMlo', 'Höchst', 'Hnttwyl Std', 'Hochgebirg', 'Murten Kirch', 'Stalden Haus', 'Meyersmad', 'Habbach Wagisbach', 'Ritzlihorn', 'Uuncioltesrviluro', 'Münchringen', 'Gurmels Freiburg', 'Wispillenhorn', 'Sefincnthal Jnter', 'Blapback', 'BürgliWald', 'UnterBühlikofeu', 'Dungelschuß', 'Zinkenstöcken', 'Neubrückrain', 'Langenegg Hos', 'Vom Tschingelhorn', 'Martishubel', 'Stöckl Borisried', 'Freiburg St Murten', 'Afflentscheu', 'Kallnach Kerzers', 'Alp Stierendungel', 'OltinZin', 'Erolswyl', 'Uttigen Thungschneit', 'Lambbad', 'Teltistock', 'Aeuszere', 'Nidau Aarberg', 'Weiler Neßleren', 'Lanencn', 'Belp Längenberg', 'Alferms', 'Scherli Dorf', 'Leißigenberg', 'Burgdorf Bern', 'Büren Urk', 'Dauben', 'Str Wattenwyl Blumeustein', 'Wendenstock Titlis', 'Saanen Vgl', 'Reichenbach Scharnachthal', 'Stürler Bern', 'HopfcrnSchach', 'Geißschwand', 'Obere Stadtgem', 'Scharnachthal Frutigland', 'Bern Fraubrunneu Wangen', 'Siechen Thun', 'Aeschi Ried', 'NiederJbach', 'Alt Brunnadern', 'Oehle Sage Schmiede Stampfe', 'Trütlisberg', 'Std Ried', 'Illptinwnt', 'Burgdorf Haus', 'Felsmauer', 'ArniBezirk', 'Schluchtschule', 'Pfarrdörfchen', 'Std Bern Hindelbank', 'Neuti', 'Wichtrach St Bern', 'Waadtlande', 'KleinBasel', 'Alp Scheideck', 'Schermenholz', 'St Blaise Gampelen', 'Ninderhorn', 'Seftingen Kaufdorf', 'Wimmisbrücke', 'Murten Laupen', 'Ilorllwml', 'bachLindenstr', 'uUnt', 'Krauchthalbach', 'Agiet', 'Brandösch H', 'Trimstein Dörfch', 'Grüsisbergs', 'Eck', 'Bern Uri', 'Lenzburg O', 'St Peter', 'Cluniacenser', 'Das Thal', 'Niederdorf Hinterdorf', 'Röplisried', 'Ikons', 'AarzieleRain', 'Brienzersce Unterseen Jnterlaken', 'Schneit Hof', 'Stockenthal', 'Brunnmühle', 'HasleOtzenberg', 'St Beatenberg', 'Bergschloß', 'Lauperswyl Zollbrücke', 'Melchenbühl', 'Schloßhügels', 'Erlach Das Pfarrd Sifelen', 'Zinkenstöcke', 'Bavweidli Bächi', 'Kehrli Brienz', 'Thun Vgl', 'Thalenge', 'Leimen', 'Völligen Bern', 'Nüncnflnh', 'Affoltern Groß', 'Rufshäusern', 'Erlen Weiden', 'Berner Oberlandes', 'Hochweydenalpen', 'Kuhliwyl Dorf', 'Grafenbühl', 'Rebgut', 'Leißigermarch', 'Von Scherzlingen', 'Saanen Pfarrdvrf Thal', 'Oimmoix', 'Schwarzlütschine', 'Hciligbühl', 'Balisalp Bahlisalp Balsalp', 'Wendenstöke', 'Hypothekarkaffe', 'Altenberg der AltenbcrgViertcl', 'Faulhorn Röthi', 'Leifstgen', 'Bärenbach Bach', 'Rybrücke', 'Münchenbuchsee Fraubrunnen', 'Frutigeuamtsmarch', 'Merzenchumm', 'Büellikofen', 'Längenbergs', 'Sigristenhaus', 'Vineenz', 'Gipsreibe', 'Kantonsgränze', 'Mörigen', 'Lohnstorf Mühlethnrnen', 'Landsitz Hof', 'Gümligen Amselberg', 'Bnrgdorf Kap', 'Wohlen', 'Schmidten', 'Conolfingeu', 'Bühlbubel', 'Lemerkenswerth', 'Gürbetbals Belpmoos Ost', 'Emmenbrücke', 'Zur KirchgemeindeAbtheilung NiederdorfViertel', 'NiederSimmenthal Dürstetten', 'Buchsee Worblaufen', 'Lcnginen', 'Pfarrd Kappelen', 'Kantonsgr Bern', 'Aarhoru', 'Geldnoth', 'Bern Wohleyberg', '1uoobö8puoii', 'Türrenroth', 'Schlößle Schlößli', 'Buchengehölz', 'Kirchbühl', 'Schönthal Hsr', 'Sustenstraße', 'Iaao', 'Aargletscher', 'Hindelbank Kirchberg', 'Aarberg Walperswyl', 'Hürnberg', 'Saanen Das Pfarrdorf', 'Lauterbrunnen Hasle', 'Titlis Unter', 'Niederhäusern', 'Rüderswyl', 'Lüzelflüh Farbschachen Hof', 'Twann Kl', 'Banns', 'Jnu', 'Fluh Hsr', 'WeißenburgBad', 'Gampelen Vgl', 'Berghange', 'Langengletschers', 'Buchcggberges', 'Vühlfeld Hof', 'Krähenbühl', 'Ochsenkops', 'Kirschbanm', 'Altenberg Ammerten', 'Sundlaucnen', 'Guttannen Gadmen', 'Anßerfeld', 'Freiburgerstraße', 'Thalgrundes', 'Wynigen Burgdorf', 'Wyler Grund', 'Bisthums Konstanz', 'Niedersimmenthals', 'Garnbauche', 'Kupferhammer Oel', 'Bauernlande', 'Vrlumünoü', 'Thürme', 'Str Kandersteg', 'Litton', 'Worbstraße', 'Heimwesen Boppigen', 'Adlembühl', 'Landger Zollikofen', 'Str Laupen', 'Worb Stettlen', 'Thierartcn', 'Bikigen', 'Stanffenknubel', 'Gebirgsthal', 'Waldstrvm', 'Seelisbühl', 'Berglistocks', 'Thoren', 'Vrüggfeld', 'Zwirgi', 'Ober Stcckholz', 'Brönni', 'Thunersee Krattigen', 'Glütschbades', 'Spühlibachs', 'St Johaunsen', 'Kyburg Burgdorf', 'Imupsnsis', 'Strahleck', 'Oppligen', 'Querstraße', 'Spiez Brünig', 'Thiermatten', 'Taatelenhorn', 'Kollatnrkirchen', 'Buchen Linden', 'Bähnli Hsr', 'Greuzfelsborn', 'Murtenstr', 'Falkenplätzleins', 'Abthl Uetendorf', 'Bellenkilchen', 'Nydeckbrückc', 'Brunngasse Zeughaus', 'Wabern Engiviertel', 'Aarwangcn', 'Rümligen Kaufdorf', 'Wetterhorn Vgl', 'Waldcantonnemente', 'Weibermarkt', 'Lütschenthal', 'Langeten', 'WelschNeuenburg', 'Str Nern', 'Sehetb', 'Schwerte', 'Nieder Bipp', 'Grindelwald Pfarrd Jsch', 'Brienz Jnterlaken Pf', 'Hahnenmööser', 'Wynigshaus', 'Dammhirschen', 'RüthiSchule', 'Buchenwald', 'Teufelsburg Nüti', 'Landstraße', 'Urbachthals', 'Mohren Zunfthaus', 'Heimath Byfang', 'Triftenstock', 'Gottstatt Nidau', 'Guppenholz', 'Albligen Pfarrdorf', 'Kandcrthal', 'Cartu', 'Burgerraths Bern', 'Schachen Dorf', 'Kiloüon', 'OberSimmenthal Zweisimmen', 'Manuwyl Mannenwyl Dörfchen', 'Anziehendes', 'Schwefelkies', 'AußerKrankenhaus', 'Steffisburg Alchenfiüh Zollikofen', 'Kap Nidau', 'Schonholz', 'Sant JohannesTag', 'Scheideck Grindelwald', 'Gürbeu', 'Mattenhubel', 'Aar Wangen', 'Lauenensees', 'Därstettcn', 'Emme Erstngen', 'Weißenburg', 'Steiger Münsingen', 'SchallenbergWald', 'Grindelwald Lauterbrunnen', 'Glashütte Lauterbrunuen', 'Leinwandsabrikation', 'KalberhöhniThals', 'Gem Gumiswyl', 'Forst Gurzelen', 'Längenberg', 'Müschbachs', 'Haubenholz', 'Schloß Nidau', 'Ilaborlmräi', 'Llmmbrier', 'Ochlmühle', 'Alp Oberaar Aaren', 'MAwrum', 'Güzi', 'Stullen', 'Egernschwand Adelboden', 'Kohlenbehälter Feuer', 'Bürglenwaldes', 'Eisthal', 'Hellisbühl', 'Gem XIV Ochle berg', 'Posthause', 'Herzogem', 'Beatenberg St Pfarrdorf', 'Gem Wyl U', 'Burgdorf Hasle', 'Könitzthal', 'Henkershand', 'Bord', 'Bepterchingcn', 'Rütschelen', 'Wallismatt', 'Albristalp von Fermel', '8uisse', 'OponIonWs', 'Sennhütte', 'Köniz Brügg', 'Kaps Vorder', 'Zeerlederhaus Hof', 'Krauchthal Hsr Bühl', 'Jegenstorf Münchenbuchsee', 'Die Kander', 'Nathsspruch', 'Rutschbach', 'Papiermühle', 'Wohugeb', 'Wald Münchenbuchsee', 'Därligen', 'Thicrreiches', 'Belp Pfarrdorf', 'Grimsel Ober', 'Hauszins', 'Großrath', 'Hasler Landsgem', 'Rhonegletscher', 'thaler Berge', 'Brüttelenbad', 'Ammertenthale', 'Adelbodenthäl', 'Altanen', 'Benzlanistock', 'Morgenberghorns', '686G', 'Pfarrh', 'Tbalhaus', 'Gemmi Weder', 'Str Lützelflüh', 'Einwohuergem', 'Niederwangen', 'Müllerlaube', 'Kühlewyl', 'Romoos Enziberg', 'Qnerkette', 'Saanen Abthl', 'Wendenthal', 'Täuffelen', 'Staatsapotheke', 'Iluerens', 'Außerhos', 'Bubenberg Ruinen', 'Oberwüstenbach', 'III Uebeschi', 'Stähelegg', 'Reckenbühl', 'Erlengebüsch', 'Dinkels', 'Krovllllml', 'Bern Hülfe', 'Hilterfingen Gerzensee', 'Zehntscheuer', 'OberTettigen', 'Buchsee Pfd', 'Pfarrd Ligerz', 'Hsrn Höfen', 'KlvsterleinS', 'Aarganer', 'Ochlenberg Vgl', 'Holligeustraße', 'VonZuzwyl', 'Badegeb', 'Scheidweg', 'ArniBerge', 'Frutigen Adel', 'Dietrichshause', 'Marzili', 'Das Oldenhorn', 'Obstwachs', 'Biet Erlach', 'Schenß', 'Adelrein', 'Gümmencn', 'St Vgl Karmins Rawin', 'StWA', 'Utzenstorf Pfarrdorf Kir chgeme', 'Mäder', 'Belp Gem Kehrsatz', 'Strät', 'Grünenberg Babschwand', 'Hingebungen', 'Pfarrhof', 'Müntschemicr', 'Schönthal', 'Sestigen', 'Müzlenberg', 'Gasternthal Frutigen', 'Oenz Nieder', 'Seeberg Schnerzenbach', 'Baselstraße', 'Leissiggrat', 'Münster Granfelden', 'Ried Hint', 'Bern Vlll', 'Spitalkirchc', 'Bern Der Berg', 'Rothhorn Groß', 'Roßalp', 'GuttannenThals', 'Brönnimaun Egg', 'Wildhorn Laufbodenhorn', 'Rüeggisberg Pfarrdorf', 'Wirthshäuser', 'Schüpbergs', 'Weiler Dittlingen', 'Jtra', 'AußerEmdthal', 'Flugbrunncn', 'Helfereibez Kandergrund', 'Oertli Hof', 'Kander Kandergrund', 'SokeiäöM', 'Wildgerst', 'Vad Fritzenbach Stofselberg', 'Oberönz', 'Weißbachs', 'Oltingen 1413 Weißenau', 'Heutligen', 'Engstlensennhütte', 'Großh', 'Lobstampfe', 'Hünigen Ober', 'Hauptthals', 'PfaffenmoosHölzli', 'Balm Oberwyl', 'Müw', 'Simmeu', 'GsteigThal', 'Geniini', 'Torfes Kien', 'Scheinenalp', 'Dießbach Ober', 'Venner Schmieden', '8ulvgloüenlmr', 'Melchenbnhl', 'stratn', 'Wösch', 'Neuenegg Recht', 'Mühlbach', 'St Leerau', 'Faulhvrns', 'Lyß Rapperswyl', 'Radelfingen Aarberg', 'Aarquelle U', 'Löhrwald', 'Heimenschwandzehntens', 'Bach Schwarzenegg', 'renovirt', 'Bäuerten Niedern', 'Ebendaselbst', 'Langnau Unterdorf', 'Orpund Mett', 'Rebgut Engelberg', 'Löhlisberg', 'Alanuschicfer Hasle', 'Schermenholzes', 'Vüttlosa', 'Rohrbachgraben 613 Rohrmoos', 'Abthl Brügglen Seftigen', 'Bödeleins', 'Bern VuItinMa', 'Der Kirchthurm', 'Gem Bucheggberg', 'Wcißenburg', 'Wohngeb', 'Nöthenbach', 'Laudsch Frutigen', 'KrummenackerWeidli', 'Mannenried Hof', 'Harder nw', 'Frauenkappelen', 'Solothnrnern', 'Rosenlaui St', 'Arbelhorn Spitzhorn', 'Saxeten Stdn', 'Gem Lyß', 'St Gallen', 'Schwanden Dorsch', 'Alterthums', 'Habsöurg', 'Münsingen Tessikofcn', 'Thores', 'Groß', 'Gotthardstraße', 'Antheile', 'NidAu', 'NiederOesch', 'Todtensee', 'Magglingen Nrrooolin', 'Otzenberg', 'Mayen', 'Ligerz Vllll', 'Hursellen', 'St Urban', 'Blankenburg Stdn Bern', 'Egkenbühl', 'Mätteli', 'Hotel Bellevne Hofstetten', 'Burgerrath', 'Xulron', 'Leimeren Hattingen', 'Nüegsau', 'Chorhans', 'Uibi', 'Thalhang', 'Bucholterberg Luoollolter', 'Große Räthe', 'Wasen HornbachViertel', 'Gr', 'Mannenbergs', 'Spitalkapelle', 'Brästenegg', 'Olroukalli', 'OberSimmenthal', 'Frutigen Eggen', 'Hupperlandes', 'Gentelbachs', 'Thuns Waisenhaus', 'Sägisthal', 'Bäuert Gilb', 'Linden Galgeuhübelein', 'Alp Sch', 'Läberu', 'Uebergangs', 'Schneggengaß', 'Büttlosa Bütlosa', 'SustenScheideck', 'Nagelschmiede', 'Abthl Wilderswyl Jnterlaken', 'Lanbholz', 'Bäuert Niedern', 'Götschmannsried', 'Bergweiler', 'Saumweg', 'Burgdorf VII Nied', 'OltenStraße', 'Brienz Pfarrdorf', 'Lausten Hsr', 'Nagelsiuhhügels Ns', 'Bötzingsn', 'Landwirth Oberwangen', 'Oenlilslwmmos', 'St Morizen', 'Jnlande', 'Pintenwirthsch', 'Büetingen', 'Käsichgäßlein', 'Linden Hof', 'Sennberge', 'Kessithurms', 'Münz', 'BachGrindel', 'Hochjägi', 'Bonderspitzes', 'Schreckhorns Gneis', 'OberAarjoch', 'Hof Landsitz', 'Krauchthal Oberburg Wynigen', 'Krambnrg', 'lornstnton', 'Oberhofen Unterscen', 'Hahnenbühl', 'Weißenburgbad Stdn', 'Grindelwald Jnterlaken', 'Guggisberg Pfarrdorf', 'Dürrbach Hof', 'Pfarrd Thunstetten', 'Zäsenberg', 'Steinberg Thierberg', 'Judengasfe', 'Muri Bern', 'Abthl Vorderrüthi Seftigen', 'Gem Oberthal', 'Burgdorfhölzlein', 'Gsteigwyler Gsteig Jnterlaken', 'Spitalbühls', 'Hoh', 'Kuhrechten', 'Alp Breitenwald', 'Büren Ober', 'Mäderhorn', 'Wildeschwand', 'Bütigkofen', 'Von Habkern', 'Sundbach', 'Büren OberBüren', 'Matten Filialdorf', 'Ballenbühl', 'Schloß Hünigen', 'Burgerspitals', 'LauterAarhorns', 'Gländ Güter', 'Rothstaldcnhof Rotthal', 'Fluh Flüh', 'Sömmcrnng', 'Badhaus', 'Belpberg Rüthi', 'Wendenstock', 'Allmendingen Eicht', 'Seitenstraße', 'Kappelen Forst', 'Bramberg Laupen', 'Enzenbühl', 'Rüwethal Frauenkloster', 'Mariä', 'Zollbrücke', 'Alchenflüh Rüedligen', 'Lyßwald', 'Znll', 'Eichenwald des Ober', 'Kirchthurm', 'Reichenbach Frutigen', 'Röthenbachs', 'Bnrgfluh', 'Haus Hs', 'St Jmmerthal', 'Weißenstein Weiler', 'Jlfis Trubschachen', 'Vlololiimmv', 'Mauerhans', 'JschmattenThälchens', 'Kirchhügels', 'Heidbühlgut', 'Bätterkinden', 'Brändlisegg', 'Notschalp Tannlihorn', 'Lohner Vgl', 'Rußland', 'Dtknvvilaro', 'Heimenhausen Stäg', 'Vnrgstalls', 'Hubel Dorf', 'Bettelriedbach', 'UIiokdn 1303 UrMllcolon 1325 Etzli', 'Wachthütt', 'Erlach Olbbatiu', 'Zur Gem III Hub', 'Schloß Erlach', 'Schoßhaldcnholzes', 'Weißenberghorn', 'Kappelen Schup', 'Diablcrets', 'Bußalp', 'AltenbergDrittel', 'Plaffeysn', 'Suldthal Haus', 'Grenchen Mülenen', 'Jmerius Ehemals', 'Dürrenwaldberg', 'Rathhausplatz', 'Obergerwern ZunfthauS', 'Lauter Aargletschers', 'Könitz Muri Ober', 'Landstuhl Sternenberg', 'Twann Uebrigcns', 'Wylerbrücke', 'Dungelbach', 'Ober Simmenthal', 'Bad Wirthschasts', 'Zäringen', 'Brächershäuscrn', 'Negierungsrath', 'Leibgedingeu', 'Gündlischwand', 'Privatschnle', 'Käsershaushof', 'Gem Oberbalm', 'Forst Burkard', 'Dberlande', 'Bifang bivrmel', 'Enzberg', 'Erlach Bern', 'Weißenbach', 'Jegenstorf Pfarrdorf', 'Eriswyl Psarrdorf', 'Kantousgr', 'Wangen N  O', 'Kalchmattenbergs', 'Schneehorn', 'Steigelschwand Stein', 'Aegertenberg', 'Wig Wik', 'Liebiwyl Dorf', 'Faulhorn Vgl', 'Urweid', 'Dittlingersee Bisweilen', 'Bottenklemme', 'Thalweite', 'Gösgeu', 'Hasle Abthl Uetigen Bnrgdorf Std', 'Herzogenönchsee', 'Saxetenthal Jnterlaken', 'Adelboden Ueschtnenthal Vgl', 'Widdcrfeldgrat', 'Aebnitgnt Aebnit', 'Maybach Meyenbach', 'MovsAffvltern Moosbad', 'Biberenflüßcheu', 'Huttwyl Abhang', 'Rüschegg', 'Hügellabyrinth', 'Ortsadel Teß', 'Bergli', 'Gurnigelbade', 'Gadmen Zinkenstock', 'Bremgarten Bern', 'Fraubrunnen Regesten', 'Nüeggisberg', 'Hsrn Wirthshaus Krone', 'Bergkrystalle', 'Schloß Pfarrdorfu', 'St Dieser', 'Aarjoch', 'Schloß Wimmis', 'Diessenhof Landsitz', 'Türrenroth EriswylWyßachengraben', 'Fürstenth Neuenburg', 'Mirchel Hsr', 'Matten Weiler', 'KirchbergEmmenbrücke', 'Ortonanien', 'Rud Aargau', 'Aeffligen', 'Wohnh VII Latterbach', 'Gampchi', 'Schangnan VnmbachTrittel', 'Bützberg', 'Schreckhorns', 'Zihlmattgut Zihlmatt', 'Probst Jnterlaken', 'Beatenberg Habkern', 'Wallfahrtskirche', 'Steg Weg', 'Brünigs', 'St UnterStutz Dörfch Hsrn St', 'äVinclomis', 'Mägisalp', 'Hnndsfluh', 'Bisthum Lausanne', 'Rämisgumm', 'Dietwyl', 'Reichenbach Mülinen', 'Dürrensee', 'Hänglihorn', 'Schneidemühle', 'Adelboden St', 'Kurzenberg Dahin', 'Alterthum', 'Eberh Kyburg', 'Uebergange', 'OberSimmeuthal', 'Kaps Hsr', 'Rud Strätlingeu', 'Riedstätt', 'Harris Harris', 'Zugeh', 'Burgistein Oberwyl', 'Hoheneck Tnrbach', 'Thun Abtheilung Strätligcn Thun', 'Gümmenen', 'Ursenbach Nohrbach', 'Diechterhorns', 'Frießwyl', 'Pörisberg Bürris', 'Lehmbach', 'Tiemtigen Teuffenbach', 'Tietwyl', 'Gstaad Rübeldorf', 'IVootiorswonllo', 'MoosSeedorf', 'Bernerfuß', 'Laudvogtei', 'HornbachKurzeneigraben', 'Güterbez', 'Zeughausplatzes', 'Küttikofen Kunstsaal', 'Sigriswyler Grats', 'MoosAffolternwald', 'Grünen Lützelflüh', '8aiocIurum', 'Gsteig Jnterlaken', 'Hardcr der Aar', 'Berner Alpen', 'Freundhorn', 'Gurnigelba', 'Gem III', 'Thungschueit', 'Eismeer', 'Ormondsthale', 'EmmenthalerFurgg', 'Därligbachs', 'Lütterkofen', 'Fahrni Bnchholterberg', 'Wachholder', 'lenbach St von Wimmis', 'Verraths', 'Filialkirche', 'Gampelen kirch', 'Landgarben', 'Kappeli', 'Selsach', 'Hoburii', 'RiedViertel', 'Vom O', 'Amsoldingen Ober', 'GambachRyffenmattstraße', 'Pipinischen Grafschaft', 'Eschau Scheidegg', 'Aegel', 'Landger Konolfingen', 'Gadmenthale', 'Lsläar', 'Mühlebach', 'NiederSulgen', 'Kirchenthurnen Mühle', 'Holzreichem', 'RauschBach Gsteig', 'SIwrceliiiAvn', 'Worb St', 'Mühlethal', 'Blume Schwändi', 'Morgenbergs', 'Webern Zunfthaus', 'Außerschwand', 'Emmenthal Grenzstock', 'Jffigenthale', 'Bunfahl Bonval Bonfal V', 'Kornmagazin', 'Kandersteg Std', 'lliilllpoiK', 'Bürg', 'Hotel Bellevne', 'Alp Laushütten', 'Ziegelofen Säge', 'Ersigen Oberösch', 'Tägertschi', 'Kirchhöfe', 'Alpen Tschuggen', 'Halbinsel', 'Garstatt', 'Kurzenberg Glasholz', 'Jnterlaken sö Lanterbrunnen', 'Dießbach Hauben Stalden Hünigen', 'Thunstetten Pfarrdorf Aarwangen', 'Wichtrach Ober', 'Mnrgeten', 'Rothhornsattel', 'Jungizehnten', 'St Ilrban', 'Jdyllenlebeus', 'Aelpligletschers', 'Griudelwald Jnterlaken', 'Stcffisbnrg 1276 Job Steffisbnrgl 1279 Rud', 'InZsroe', 'Schloß Landshut', 'NoscnlauiBad Gletscher 614 Noßgartcn', 'Thalkirche', 'Thalfläche', 'Brügglindach', 'Reiffenmatt', 'Brünig', 'St BrienzerRothhorn', 'Güzischwendi', 'Ringgenberg Brienz', 'Schluchttheil', 'Schloß Städtchen', 'Worb Bern', 'Spital St Johannis Jerusalem', 'Breitmoos Ober', 'Natrnm', 'Thal Lauterbrunnen', 'Ranchenbühl', 'Namens Roll', 'Feldweid', 'Nägelisgäßlein', 'Emme Std', 'S  W', 'Schüpbach', 'Weißenan', 'Vvuauei', 'Bargen Wohnh', 'Haus Oesterreich', 'Bergweiler Ober', 'Mattenstege', 'Bruchbühl', 'Hrn Pourtales', 'Brnunaderu', 'Osterrieth', 'Möschberg', 'Schloß Gutenburg', 'Hnbel', 'Pintenschenke', 'llcüon', 'Antonienhauses', 'Pfarrd Messen', 'Frauenbrunnen', 'Schmitt Pilger Einsiedl', 'HasliScheideck', 'Torfbache', 'Haus Kabisberg', 'NiederBützberg', 'Tas Haus', 'Aeckeru', 'Eck Egg', 'Burgisteiu', 'Aaran Zürich', 'Ferenbalm Mühle', 'Hinaufsteigens', 'Schloß Mauern', 'Thurnen Abthl Burgistein Seftigen', 'Freiburger Straße', 'Aarlanfs', 'Tbeil', 'Wigger', 'Seedorf Urnerland', 'St Galler', 'Brünig Lungern', 'Gümligenthälchen', 'Büetigen', 'St Beaten', 'Thunersee Schutthalden', 'Zweisimmen', 'Thals Dahin', 'Von Bächen', 'Höh', 'Schlößli Hof', 'Weißensee', 'Aar znm', 'Gürbenbach', 'Velscheu', 'Grabenstraße', 'Vlll Kalb', 'Kühalp Kirgeli', 'Thalgrnnd Dungel', 'AlpiglenGletscher', 'Suldthals', 'Bütschel', 'Kandersteg Frutigcn', 'Langenthal Langenthal', 'Waldhof Höfe', 'Grindelwald Eiger', 'Münster Gran', '6eIpo slpo orpu', 'Thierachern Thun Langenegg Blattenweid Ober', 'Almenden', 'Einsiedeln', 'Könizth', 'Polern', 'Jahrmärkte', 'Schadau 625 Schafalpen Schallenhaus', 'Buntschibachs', 'Renenberg Grenzstock', 'Wiesenthal', 'Hundsschüpfen', 'Aarberg Seedorf', 'Marechaussee', 'Pulverthurm', 'Melchnau Aarwangen', 'Büttlosa', 'Wachseldorn Wachteldorn Collektrvname', 'HtnterFultigen', 'Pfarrd Vechigen', 'Löffelhof Galgenhof', 'Fräschelz', 'Vord', 'Trimlenbad', 'BuchseeUrk', 'Hürn', 'Kirchhofmauer', 'Sachslenthal Sachslen', 'Engi zerstr Hsr', 'Horben Reuti', 'Ganz', 'Breiten Hof', 'Raths Bern', 'Rüdligcn', 'Sandsteinselsen', 'Wetterlatte', 'Aarstrom', 'KyburgHabsburg', 'Langnau Pfarrdors', 'Untcrthancnberathung', 'perswyl', 'Gangolf', 'Gemcinderath', 'Nenbrücke', 'Lyßbach', 'HabsburgKybnrg', 'Gem Aegerten', 'Rüblenberges', 'München', 'Gastern Frutigen', 'Burgdorf Dieß', 'Thalkesscls', 'Bandstraße', 'Vechigen Pfarrdorf', 'Büntschen', 'JnnerBirrmoos', 'Mübleholz Hof', 'Albristhorns', 'Wurm', 'Aemligenstutzes', 'Müz', 'Lötschthal Wallis', 'Wylerweg', 'Kienthalfurgge Vgl', 'Spiez Niedersimmenthal', 'Juterlaken', 'Münfiugeu', 'Wynau O', 'Windgrabs', 'Stadtthürmen', 'Olisch', 'Diesbach Kiesen', 'HühnerbachViertel', 'Wendengletscher', 'Höchstetten Konolfingen', 'Nägelisg', 'Zollikofcnstraße', 'Riedburg Höfe', 'Rath Haus', 'Jnterlaken Gsteig', 'erDießbach', 'Bondelle', 'Whdenlö', 'Bades Rohr', 'uK', 'Neuhaus Bauerngut', 'Der Glysi', 'Stocken O  N', 'Heerden', 'Habchenwaldes', 'Kirchplatz', 'Hagneck Epsach', 'Rümligen Nieder', 'Schüpberg', 'AlteubergTrittel', 'LuolnIIon', 'Scherlibach Oberbalm', 'Miwrule', 'Selbenzen', 'Alpen Burgistein', 'Guggisberg illontouolün', 'Schloßbergs', 'Walterswylhof Kiltbächlein Walterswvl Boden Hof', 'Gwärtistock', 'Schönislehn', 'Blindenanstalt', 'Rüblihorn', 'Das Pfarr', 'Reichenbach Schloß', 'Rüschbach', 'Ursenbachs', 'FinsterAargletschers', 'Axalp Vgl', 'Thurm BinserenHubel', 'Bielersee Bern', 'Gummen', 'Dürrenflüh', 'Aarberger Thiergarten', 'Hüttlingen', 'Schloß Bipp', 'Euune', 'Schulkadettencorps', 'Arnoldsmühle', 'Holzmühle', 'Schloß Oberhofen', 'Schafeck', 'Sumiswald Eriswyl', 'Schlosses Pfarrhofes', 'Spitzenberg Vgl', 'Römerzeit', 'Ligerz Tüscherz', 'Worblenfall', 'Arnisch', 'Brügglen', 'zcrstr Hsr', 'Walliser Grenze', 'Scheurers Mausoleum', 'VorderEnggistein', 'Beatentoch', 'Gimmelwald III Mürren', 'Hohrain Weiler Hsrn', 'Stadttbeiles', 'Emme Breitenegg', 'Cafo', 'Neumühle', 'St ebendahin', 'aargau', 'Oltigen Oltschenen', 'Faulensee Hsr', 'Gnttannen Abthl Guttannen Oberhasle', 'Vooanalu  äunniliieg', 'Gfäll', 'Haste Hsrn', 'Trechscls', 'Kirchhöreu', 'Saane Laupen Gümmenen', 'Gschneit', 'Zoß', 'Araris', 'Bielerseestraße', 'Bergweiler Schwenden', 'Melchthal Unterwalden', 'Uebcrfluß', 'Privatsamm', 'Reichsland', 'Gwatt Vgl', 'Freuudhorn', 'Lochberg Gridenbergli', 'Schwendi Hsr Stalden', 'Strätlingeu', 'BernerHochgebirges Aara', 'Reisiswyl', 'Sumislväld', 'Reuti', 'Schafrace', 'OberBalm', 'Gem Goldiwyl', 'Den Twing', 'Münchcnbuchsee', 'Bühlhof', 'St Martins Altar', 'Nidau Geistholz', 'Oberhasle Urbachthale', '179S', 'Mühlbachs', 'Wimmis Pfarrdorf', 'Geicht', 'Der Paß', 'Trübtenbach', 'OltinZen', 'Vincentius', 'Buchsee Kirchlindach', 'Gehren Horn', 'Burgdorf Radelfingen', 'Schwarzenburg Seftigen', 'Bern Reun Hsr', 'Einwohnergem Wangen', 'Nydeckkirche', 'Finsterhennen', 'Bräschgengraben', 'Küherhans', 'Steinkohlen', 'GrittdelwalderGismeer', 'Commenthurei', 'Flußes', 'Rüpplisried', 'Svlothnrn', 'III BumbachDrittel', 'BlumensteinBades', 'Niederbipp Wangen', 'Nothach Mühle', 'GanthiVelsen', 'Stockhornkette', 'Flös', 'Bürgle', 'Weiler St Hochalp Hof', 'Affoltern Kappelenbad', 'Alpberges', 'Schongau Schöngan', 'Saanen von Lauenen', 'Psarrsatz', 'Bucheggberges', 'Solothurnerlandstraße', 'Arue', 'Bicrhübeli', 'Eichholz Ban', 'WylerOltigen', 'llotraobiiiAön', 'Mötschwyl', 'Str Saanen', 'Gräthlis', 'Geiß', 'Blümlisalp', 'Gem Koppigen', 'Karthause Thorberg', 'SüdOst', 'Niesen Aeschi Frutigen', 'Seftigen Sternenberg', 'Eisenhammer', 'Thl Ebnit', 'Schüpfen', 'Mühleberg KleinMühleberg', 'Vnrgvogtei', 'Hahnenmoos Hannemoos', 'Wassernoth', 'Berns Jahrh Zollikofen', 'Bern Freiburg', 'Bättwhlholz', 'Nordschwaben', 'Schwarzwassers', 'Marschried', 'UnterD ießbach', 'Bettelberg Nüfiswaldberg Std Lenk', 'Möuchenstein', 'Jnterlakeralpen', 'St Stambach', 'Venncrquartierc', 'Bösingen Oberbalm', 'Riedbad Höfe', 'Biberist', 'Balmberg Hs', 'Ibsnon', 'Stöcklein Bärenried', 'Lazareth', 'Lauinen', 'Freyhaus', 'Ringgenberg Jnterlaken', 'Eckhölzchen', 'Kalberhöhni', 'Gottesacker', 'Niederösch Brügger', 'Eiger', 'Comthurei', 'Glütschbachs', 'Nonbijou', 'Flühlerche', 'Därstetten Pfarrdorf', 'Bern Burgdorf', 'Wartenberg', 'Berges Thl Tannwäldern', 'Lützelstühbrücke', 'Wikhartswyl', 'Bötzingeu', 'Lrunnsn Hof', 'Sack Ufer', 'Aeußern', 'Rebgnt', 'Bächlein', 'Büblweid', 'Rüdlen', 'Knnbel', 'Erlach Fuß', 'Klösterlein', 'Bleiche', 'OberGoldbach', 'VozwAS', 'Emme Lützelflüh', 'Antimoninm', 'Soßau', 'Heustrich Emmen', 'Orvin', 'Zihlbrücke', 'Bisthum', 'Stubenwirthsch', 'Großerlen', 'Dennlergl', 'Buchcggberges Kypbcrg', 'Sannen Vgl', 'Nain', 'Büttlassenhorn', 'Forst und Bann', 'Weißenstein Landgut', 'Sträub', 'Trachselwald Langnau', 'Papiermühlestraßc', 'Gem Thörigen', 'Gasserhans', 'Scheurer Mausoleum', 'Obenher Solothurn', 'Brenzikofen Kiesen', 'Kirchhofmauer Fundament', 'Schneidehorn', 'Haltenberg', 'Münster Wallis', 'Münsingen', 'Rüthi Filialdorf', 'Küblisbad', 'Läger', 'Jura 141teoti6i', 'Nüegsbach', 'Simmenstnrz', 'Hörne', 'Weißbach', 'Napperswyl Aarberg', 'Iloeobuo', 'Zinsmaad', 'Berges Thurnen', 'Wyttenbach Hof', 'LauterAarjoch LauterAargrat', 'Hilterfingen Stocken', 'Aar Man', 'Alp Susten', 'Lütschinen', 'Möriswyl', 'Thurnen Seftigen', 'Mürren', 'Murtenstraße', 'Brodhäusi', 'Riuderhorn', 'Salzbohrvcrsuche', 'Klosterschnle', 'Grauholz Unterweg', 'Wattenwpl 683 Wattenwyl', 'Langenthal Herzogenbuchsee', 'Tannenhof Taubsiummenknabenansialt', 'ZollikofenMünchenbuchseestraße', 'Ludnung', 'Michels Kirche', 'Schützenmatt', 'Stettler Nr', 'Enzi', 'Hessigkofen', 'Vllgitern', 'Str Aarberg', 'Wegscheide', 'Heidenloch', 'Aarbett', 'Frutigen Oey', 'Schwanden O', 'NiederBleikcn', 'Spitalackers', 'OberSeftigen', 'Grath Groth', 'Spieß', 'Panner', 'Jmerins', 'Kander Simmen', 'Lüttiwyl', 'Eiger Mörigen', 'Bern Stadt', 'Gwärtistocks', 'OppligenBerglein', 'Eichbühl', 'Walliser Aletsch', 'Vgl StWA', 'Lhßbach', 'Landerou', 'Hinterbnrg', 'Mürren Ammerten', 'Hippboden', 'Grindclwald Lauterbrunnen', 'Moosegg Höfe', 'Todtenackers', 'Mittellöwen', 'Amthause Fraubrunnen', 'Finsteraarhorn', 'Uassloo', 'Safnern Orpnnd', 'Wiedergalm', 'Reutigen Burg', 'Langensteiu', 'Gletscher Gletscherhorn', 'Oele Reibe', 'Müusterthal', 'BächenBäuert', 'Mühliberg', 'Stühlingen', 'Goldenmattgaßthors', 'Snmiswald Trachselwald', 'Bieberen', 'Kolleren', 'Hiltbrunnen', 'haslethal', 'Hell Mcienried', 'Laushütte', 'Strahlhorn Strahlberg', 'Kaiserthrones', 'Obersteg Bergdörfch', 'Aattvangen', 'Saanebrücke', 'Gsteig Gsteig', 'SnlpiciusBalm', 'Kirchgemeiude', 'Schloß Aarmühle', 'Alpberg Ahorn', 'OstermundigenWorbstraße', 'Bern Std Belp', 'Grünenberg Bnmbach Schangnau', 'FinsterAargletscher', 'Grimselkette', 'Mußmatte', 'Ger Madiswyl Aarwangen', 'Eintheiluug', 'Aeschlen Dahin', 'Bärselbach', 'Kirchgem Oberwyl', 'Dorsch Hsrn Mühle', 'Bern Solothurn', 'Schwärmereien', 'Gsteig Halden', 'Ritter Steffisburg', 'Eichwald UnterHard Haldimoos Haldenmoos', 'Sandegg der Freyburgersträß', 'Thale Man', 'KleinRoth', 'KleinTwann', 'Venner', 'Affoltern Emmenthal', 'Schwalmeren Vgl', 'Engelalp Frutigen', 'Zwiebelngäßlein', 'Moos Baumgarten', 'LyßHindelbankstraße', 'Helvetier', 'Spitalacker', 'Gallus', 'Buchholterberg Wachseldorn', 'Strätlingen', 'Berns urk', 'Oesch N', 'Palästina2', 'Tingstatt', 'Laugenstein', 'Reichenbach Aeschi', 'Schlosse Landshut', 'Kastellan Grasburg', 'Geißhof Hof', 'Walkriugenmooses', 'Predigerkirche', 'Wärgisthalbach', 'Str Huttwyl', 'Bremgarten Wohlen', 'Eigers Breithorn', 'Enze', 'Andristmatti StA Andresmatten Hsr Bärischmatte Barischmatti Hsr Praffen', 'Zollikofen StA Urkundliches', 'Mühlen', 'Scharnachthal Falke', 'OütsI Illusigus', 'Koruamt Bern', 'Schermenwald', 'Koltrrv', 'Irrthum', 'Dungel 7089  Nothhorn 7031 der Dauben', 'Rhone Vgl', 'Güzischw', 'Thunerseestraßc', 'Villen Pillon', 'Haselstauden', 'Das Pfarrdorf', 'Zihl Gampelen', 'Untcrhards', 'Sefineufurgge', 'Liebefeld Landh', 'GoldbachFarbschachenstraße', 'Kastanienbaum', 'Iluclisu', 'Vorder Hof', 'Trnb', 'Thun Ried', 'Bad Oswald St Doset Schlößli Tauberhäusli Schloß', 'Thalseitcn', 'Nawyl Vgl', 'Ahorne Buchen', 'Str Herzogenbuchsee', 'Blöwestatt', 'Kneulibächlein', 'Hohlefluh Felsenwohnung Std Alpen', 'Büttenberg', 'Glütschbach', 'Büren', 'Nhonethals', 'St von Aetigen', 'Engstlenalp Genthal Oberhasle', 'St Johannstag', 'Bowegsthürlein', 'Arar', 'Handeck von Guttannen', 'Hochalpen', 'Balmboden', 'Haus Schwand', 'Thal der Lenk', 'Beru VLU', 'Uttigen Ueten', 'Bokes', 'Nef Bern', 'StegLindach', 'Säntis', 'Drienzerkäse', 'Leconrbe', 'Münsterterrasse', 'Allmendingen Scherzlingen', 'Morillongut', 'Helferci Kandergrund', 'Uevtw', 'H', 'Planalp Blanalp', 'Länggasse', 'Bockigen Man', 'Schöpf', 'Frickstege', 'VVglperirv', 'Längenbühl Länggaß Länggaßvicrtcl', 'Aeschi Leißigen Spiez', 'Stockernfluh', 'Kirchhof Belvedere', 'Worblen', 'Hindelbank Großmann', 'Krummeney', 'Belpbergs Gerzensee', 'Katzensteig', 'Bärau', 'Hohgante Furke', 'Dießbach Bürcn', 'Gießbachs', 'Trachsell', 'Felswalles', 'Amthause', 'Orunä', 'Rümlisberg Hof', 'Weinberg', 'AußerBirr', 'VLU', 'Waldesrand', 'Schweinsberg Schweißberg', 'Gadmcnfluh', 'Juchen Einw', 'Aeschlen 1292 Eschi', 'Suggithurm', 'Kirchgem Languau', 'Oelmichle Huf', 'Bümpliz Pfarrdorf', 'Fischenzen', 'Sumiswald Walteröwyl', 'VorderArnibergs', 'VilmoiinAon', 'Erlach Nonu', 'Germern', 'Achseten', 'Ile', 'Rüeggisberg', 'Felbacker Hof', 'Gampelen Siselen', 'Dem Amtmann', 'Gehrisberg Gerisberg Gersperg Ober', 'HünliWaldhügels', 'Wendelsteins Kirchthurms Frutigen', 'Kuhnisberg', 'Stockenthals', 'Homberg Thun Der Gipfel', 'OZo Nach', 'Diemtigbergli', 'Nagelfluh', 'Bottigen O', 'Lrlombnoli', 'Hasius', 'Solothurn Bern', 'Bäuert O', 'Dorf Biglen', 'Erlenbach N', 'Thalbodens', 'Schnttkegel', 'Den Schneelauinen', 'Gem III Höchstetten', 'Schloß Amtssitz', 'Höchstetten St', 'Bühlikofen', 'Gstaad Std S', 'Hünigen St', 'Oberaargatt', 'Bannwvl Wobub', 'Bern Hindelbank', 'Bern Bern', 'Holzersfluh', 'Köniz', 'St Oeschenbach', 'Haus Vgl', 'Bargen Kerzers', 'Thierachern Bodenzingen', 'Ferenbalm Lanpen', 'Ebersold', 'Saxetenthal Vgl', 'Gletscherbach', 'Thalgelände', 'OberBüren', 'St Amtssitz', 'Schloß Weiler', 'Emme Rüdligen', 'Belp Kehrsatz', 'Pleuerein', 'Adelboden Lauenenthal', 'Bern Seelhofen', 'Frutigstraße', 'Stein Hsr amTschug', 'Dorsch Ns', 'Pfarrbaus', 'St tumbuok', 'Schweizerlandes', 'Kanderholz', 'Frutigen Frutigen', 'Schloß Langenstein', 'Bänert Gadmen', 'Auf Spitze', 'Dotzigen Büren', 'Münster', 'Frienisberg Bern', 'Oberbergfluh', 'Lauenen Berg', 'Oberhofen Gnnten', 'Quellwasscr', 'Affoltern MooS', 'Oster', 'Langenegg Blattenstein', 'Mürreu', 'Hobgant', 'Waldhügel Ns', 'Kalkspathkrystalle', 'KileyAlp', 'Justisthals', 'Zwetlütschinen', 'St AntonienRitter', 'Gauligletscher', 'Moos Hellsau', 'Christoffelthurm', 'Zur Dießbach', 'Tossenhorns', 'Frieswyl Berg', 'Furkc', 'Balleuhaus', 'Zweilütschineu', 'Unspunneu', 'Aeltere', 'Ritter Twann', 'Rüti', 'Altholz Kolchenthal', 'Früher Sundlaucnen', 'Höchstetten', 'Rutzwyl', 'Weißenberghorn Die', 'Wäsemli', 'Brenzikofen Eichi Höfe', 'Jochberg Engstlerjoch', 'Düttenberg', ' luontsolion 1459  küonsvlion', 'Eisenfluh', 'B lattiberg Brüchlen', 'Genfersee', 'Küherhaus', 'Wachthubel Hsr', 'Obermatt Wirthshaus', 'Gant Wand Felswand', 'Bergdorf Brünigen', 'Huudestall', 'Bern Knno', 'Eichenbühl', 'Dörfch Haus', 'Gadmenfluh', 'Lenk OberSimmenthal StA', 'Cüdrefin', 'Namen Balm', 'Flühlen', 'Simmenbrücke', 'Kernenried Urtenen', 'NO', 'Sumiswald Trachselwald', 'Täuffeleu', 'Brüht', 'Aargau Alchen', 'Aletschgletschers', 'Mündigem', 'OberLindach NiederLindach', 'Ortweid', 'Rüttele', 'Thierarzneischnle', 'Gastron', 'Solothurn St', 'Neuenstadt Nods', 'Thormaun', 'Brunnmühlebach', 'Räzliberg Daran', 'Twing Bann', 'Urkundliches', 'Räufle', 'Landwirth Alchistorf', 'Hilterfingen Thun', 'Stockhorn Vgl', 'IbnxburA', 'Aventicnm', 'Sohlflnh Scheibe', 'Bern Bühl', 'Wynau Ehemals', 'Mooslaud', 'Riedbürg', 'Rothisches', 'Bergthals', 'Stadtthore', 'Mährenhorn', 'GroßAmmertenhorn', 'Adelsbühl', 'I  Aoräon', 'Feldsiechen', 'Ballmoos', 'Gurgeten', 'Hinterburgseelein', 'AußerLatterbach', 'BernThunstr', 'Gebirgs', 'Engelberg Unterwalden', 'Münnenbergs', 'LüthiwylBezirk', 'Wabern Groß', 'Kurzeney', 'Burgdorf Wangen', 'Vurgbühl', 'Scheuer Speicher rc', 'Silberbühl', 'AarbergerMoos', 'OberSulgenbach', 'Achsitbergs', 'Wyßachengraben', 'Stadönz', 'Schloß Trachselwald', 'Obern Spital', 'Pfarrd Trüb', 'Bern Brunnadern', 'Bierhübeli', 'Muthes', 'Hügelländes', 'Bälliz Hsr', 'Bäderegg', 'Vierwaldstättersee', 'Schlösser Fels', 'Wirthshaus Kirchberg', 'Roßalp Noßboden', 'luzcrn', 'BernerHochalpen', 'Hartisberg', 'Bättwyl', 'Buxgän', 'Bach III', 'Brandkorps', 'Tonnerbühl', 'Solothurn Luzern', 'Banmannshans Bumish Hof', 'Langenthal Kap', 'Spitalholz', 'Ohmgeldamt', 'Affoltern Pfarrd XIV', 'Alp Hannenmoos', 'Uslmon', 'Roßalp der Burg', 'Chrinnen', 'Thörigen', 'Hülfe', 'Hilterfingen Pfarrdorf', 'Freibnrgischcn', 'Limpachthale', 'Mittaghorns', 'Lenzigen', 'Lithographie Littcwyl', 'Duoatus', 'Weinwachs', 'Aeschi Aeschlen', 'Oltschi Wandel', 'Bern Dießbach', 'Bärswyl', 'Mittelalters', 'Twann St PetersInsel', 'Fehlbaum Hof', 'Kilchschwaud', 'Großer Rath', 'Schloß Reichenbach', 'Stanbbachs', 'Gem Twann', 'Mühleberg', 'Köniz Bern', 'Trübtensee', 'Jnselspital', 'Wildhorn Geltenhorn', 'Zeminis', 'Biberen Landger Zollikofen', 'Hnttwyl Vgl', 'Neßleren4l', 'Rothmoos', 'Bern Bnnd', 'Adelboden Thal Pfarrdorf', 'Schwarzenburg Gug', 'Nanflüh', 'Das Schloß', 'Scherlibach Brücken', 'Dieses Thal', 'Mühlehof', 'Aetigkofen', 'Ohmgeldbnreau', 'Grindelwald Hasli', 'Stockhorn der Reutigen', 'Twingmühle', 'Stäg', 'Alp Seefeld', 'Kronburg Hsr', 'Thal Pfarrdorf', 'obern Straße', 'Buchen Eichen', 'Kühberg', 'Straßberg', 'Dannenbühl', 'Obere Spital', 'Rüthi', 'Schmitten Lan', 'Thal Snmiswald', 'Alp Hinterburg', 'Bühlbach', 'Gunten Gonten Gurbrü', 'Wirthshaus Grenzbureau', 'Obere', 'Oberhofen Nefsenthal', 'Kien Jahrh', 'Landban', 'OberhofenGontenstraße', 'Weißen Schwesternhaus', 'Kanderthals', 'Schöueck', 'Botanischer Garten', 'Brüttelen', 'Gamchigletsch', 'Gadmenthal Unänwn', 'Gem XIII Hermiswyl', 'Seelibühl', 'PöschenriedBäuert', 'Schwengimatt', 'Schloß Landshnt', 'Herrenvogel', 'Großen Rath', 'Rauh', 'Kandergrund Gaffern', 'Kühlewyl Kühliwyl', 'Libruims', 'Buchsee Fraubrunnen', 'Mnnimatten Frienisbergerwald', 'Emme Zulligenhof', 'Stadttheil', 'Wetterhorns', 'Ins Erlach', 'Arni Dorf', 'Ried Dörfch', 'Berge Gurten', 'Wohley Franenkappelen', 'Aarzihle', 'Wärgisthal Bergbächen', 'Eggen', 'Burgdorf Kap', 'Aarberg St', 'Fultigen', 'Steinberge Ammertenth', 'Ferenbalm Abthl Freiburgisch Ferenbalm', 'Lüzelflüh', 'Emmenstuß', 'Faulhorukette', 'Schloß Blankenburg', 'Str Signau', 'Gemmi Seinen Namen', 'Bade Weißenburg', 'Huristall', 'Balmwald', 'Krn', 'Gem VIII Graben', 'Barheggen', 'MittelAlpen', 'Wyßbach', 'Grimselkctte', 'Schloß Brücke', 'Altreu', 'Thun Steffisbnrg', 'Zeerled', 'Unspunnen', 'Sigriswyl Thun', 'Rüschegg Reuschegg', 'Trubthal', 'Susten', 'Grabew4tel', 'Walkringen Burgdorf', 'Fischcrgut', 'OberOesch', 'Mentschelenalp', 'Bäuert Krattigen', 'Weißachen', 'SpitalackerViertel', 'Twingherrn', 'Lücke', 'Frutigerstraße', 'Ferenbalm Kerzers', 'Kauzenhubel', 'solothurn Bncheggberg', 'Republik Bern', 'Burgerspital', 'Weiler Hof', 'Aar Uttigen', 'Ritterhans', 'Nufshausen', 'Olletscherhorn', 'Emme IViclon', 'Unfern', 'Moosböden', 'Frankreichs', 'Matten Grenze', 'Pfrundhofstatt', 'Stutz Unt', 'Kri', 'Sandfluh', 'NidauerKap', 'Morgenröthe', 'St Stephan', 'Armengut', 'Gurnigel Grön', 'Lobvuidül', 'Mittellegi', 'Str Frei', 'Nidau Buren', 'Oberbüren', 'Iustithal', 'Oeschinensce Oeschinenthale', 'Oberlandes', 'Gätzistihl', 'Cliiniacenser', 'FrittenbachViertel', 'Schloß Laupen', 'Gelmer', 'Viesch Wallis', 'Lauterbrunnen Gimmelwald', 'Helfers Jnterlaken', 'Hasle Burgdorf', 'Llulinon Fraubrunnen', 'Bächi', 'HaslebrückUetigenstraße', 'Walliser Gebietes', 'Bremgarten Reichenbach', 'ObcrSimmenthal', 'UnterAargletscher', 'Lengnau Jura', 'Sensenb', 'Verschiedenes kiooliinAön', 'Wiesenhöhen', 'Schlößli', 'Peterlingen Bickigen', 'Falkenflub', 'Gemsenfluh', 'Strätligen', 'Niesenkette', 'Thal Pfarrort', 'Schernelz Schernolz', 'Jmerius', 'Mnschelsandstein', 'Tschachtlanei Frutigen', 'Haus St', 'Bleiben', 'Lenkthales', 'Tschuggen Alterthümliches', 'Häusergr', 'Schloß Nydeck', 'Grädelisberg', 'Burgslnh', 'Frutigen Vgl', 'Aegerstein O', 'Engstlenseelein', 'Das reich', 'Münchenbuchfee', 'Münchenwyler Clavaleyres', 'Chirelbach Erlen', 'Grünenberg Langeustein Schnabelburg', 'Affoltern Dürrenroth', 'Schwendi Roggen', 'Burk Sumiswald', 'Shromk', 'Nessenthal Haus', 'Bockstege', 'Zehntens Brüttelen', 'Bestäti', 'Doßenhorn', 'Meiringen St', 'Hürlisegg', 'Dörfch Stein', 'Buchsee urk', 'Schweiz Museum von Füßli', 'Schöpf Wachseldorn', 'St Niklaus', 'Laueli', 'St Oberge', 'Brünnen', 'Geologisches StWA', 'Alterthümer', 'Gotthards', 'UnterDießöach', 'Oberschönegg', 'Hengstfluh', 'Schloß Hsr', 'Ortschwabenbachs', 'Simmenthales', 'Haus Scheuer', 'Gelterfingen', 'Schloß Stadt', 'Distelzwang', 'Eschen Linden', 'Dießenberg', 'Alpensecu', 'Schw arzenberg', 'Gem III Schatteuhalb', 'Pfarrdorf Wichtrach', 'Balm Ober', 'Stübblene', 'Triftbach', 'Wimmis Amsoldingen', 'Schwarzhänsern', 'Weißenbnrg', 'Gem Bowyl', 'OberJbach', 'Jungizehntens', 'Chrinnenberg Krinnenalp Alp', 'Tiefenthal', 'OberWichtrach', 'Müllenberg', 'Schwarzwasser Sense', 'Hofwylsee', 'Gruber Bern', 'Landeron St Johannsen Stadt', 'Bigel', 'Alten Grabe', 'UurKuilum', 'Ilunciv', 'Branntweinbrennerei', 'Bond Bonderspitz', 'Männiggrund', 'Strubeleck Frutigen', 'Bergdörfch', 'FrauenKappelen', 'Simmenthal Albristhorn', 'Lichtmeß', 'Faulhorn Stdn Rothachen', 'Tannwaldnngen', 'Port Bort', 'Krinne', 'Hinterbnrgseelein', 'Rauchmühle', 'Zürich', 'Whnigenstr Waldsaum', 'Nämi', 'Berns Vgl Völligen', 'Büren Die Oberwyl', 'Wirthshauses', 'Oberwyl Weg', 'Bouderlen', 'Schwanden zerstr Dorf', 'Aeschi Stuhl', 'Schaffalle', 'Amsoldingen IV', 'Obcraar', 'Bleiche Hammerschmiede', 'Thörishaus Dörfch', 'Thierreich', 'Dantigen', 'Pabst Engen', 'Buren Man', 'Aeschi St', 'Thal Rothhorn', 'Der Zehnten', 'Laubbach Törfchen', 'Spitalböglein', 'Baursame', 'Neubrück', 'Folgendes', 'Langenthal Brücke', 'Jnsti', 'Muri Abthl Muri', 'Aeschbacherschachen Schachen', 'Gamchi Frutigen', 'Frutigth', 'Mannenberg Mannried Married Dorf', 'Langcncgg O', 'Landwirth Niederösch', 'Schönenfels', 'Oberhofen Balmen', 'Burgenstein Stdn', 'Gasthansc Hügel', 'Finkenhubel', 'Entschers', 'Sägi', 'Aetigen Lüßligen', 'Wynigen Nieder', 'Tannengehölz', 'Aegerten', 'Aarmühle Wofern', 'Lauterbrunnen Grindelwald', 'OberGoldbachB ezirk', 'Emmeu', 'Alp Furgi', 'Laucherhorn Suls', 'Gem Köniz', 'Moos Enetmoos', 'Glur Roggwyl', 'Wiedlisbach Bern', 'Aarsand', 'Johannisinsel', 'Scharnachthal Der Suldhalten', 'Buchholterberg Thun', 'Tüscherz', 'Finsteraargletscher', 'Llnioiiiiiduoll', 'GilbachBäuert', 'Gsteigthale Kts', 'Bärhegen', 'Pet Wich', 'Muristraße', 'Scheid egg Berg', 'Müllergasse', 'Ergsingen', 'Jnterlakeu', 'Str Bern Emmenthal', 'Tannenth Höfe', 'Predigerkloster', 'Mauricius', 'Knlimeüo', 'Hintertheil', 'Hünigen N', 'üütoiplatz', 'ScherzisBach', 'Jntertaken', 'Kapfschwand Hof', 'St Hnbberg', 'Gurnigelberge', 'Alabasterweiße', 'Palissaden', 'Moos Hof', 'Junten', 'Münslngen', 'Käderegg', 'Haus Buchsee', 'Kanderthalcs', 'Ilwreiwelmtlon Mernsolmtton', 'Schloß Bremgartcn', 'Könitzstr', 'Malefizrecht', 'Birg', 'Aarberg AarbergerMoos', 'Eisenerz almcreckborn', 'Oeyen Oeyen', 'Weiden Wiesen', 'Thal Badweidli', 'Thalschaft', 'Senggiweiden', 'Weißstegen', 'Gerenstein Hub', 'Grindelwald Abthl BussalpJnnerorts', 'Balme Nothenfluh', 'Bärengraben', 'Mühlidorf', 'JnnerEiger', 'BordellBad', 'GentelbachBrücke', 'Zihl Brügg', 'Kapfschwand', 'Scherlihubel', 'Attinghausen', 'Schloß Sch', 'Gümligen Einwohnergem', 'Schloß Bremgarten', 'Däfi', 'Frischenwerth', 'I Hott Türrenroth', 'Bönigen', 'Mnlchi', 'Burgercnz', 'Hohenalp Lauterbrunnen', 'Zeitglockenthurm', 'Aargletschers', 'Rohrbach Aarwaugen', 'Thalbecken', 'Bareichti', 'Nied', 'Wengi Wintermatt Alp', 'Gem Lyssach', 'Hof Mittl', 'Aargau Bern', 'Bättenalp', 'Gurnigelbades', 'Grünenbachs', 'Grenzmarchen', 'Rothkumigrat', 'Weißenberghorn Wytenberghorn', 'Murg', 'Grimselspitals', 'Melch', 'Freibnrg Breisgan Freibnrg Uechtlande', 'Moosseedorfsee Dazu', 'Bern Langnau', 'Petinesca Vgl', 'Ripplis', 'Heidenschnarre', '§ Ebnit Lbinocle KU', 'Jsboden Jnter', 'Schnlh', 'Imporii', 'Lauenenhorns', 'Hallwyl', 'Hagneck', 'Bnmbächli', 'Könitzberg', 'Nhdeckbrücke', 'Lnstrum', 'Inorosse', 'Wirthsrechts', 'KleinEmmenthal', 'Mooseck', 'LanbeggZollstatt', 'Burgstall Büetigen', 'Udelbuch', 'Emmenthais', 'Schloßdomi', 'Rittmal', 'Bäuert', 'Ebni Ebnit', 'Bad Std Weisen', 'Eggisberg Höfe', 'Madretsch Dorf', 'Saanerloch', 'Vogesen', 'Bürgisweyer', 'Bütschelbach', 'Gem Langnau', 'Furggen', 'Grimselstr', 'Muri Murzelen', 'Aarwangen Thun', 'Gimmelwald Mürren', 'Thale Namens St', 'Pfarrd Kallnach', 'Ref Bern', 'Dürrenroth Sam', 'Rathhans', 'Furt Hof', 'Bergpaß Lauenen', 'Holzmarkts', 'Wädischwyl', 'Enswyl', 'Berken Unt', 'Goldbach Ober', 'Scheurer Mausoleum Th', 'Bade Blumenstein', 'Spitzenberg Langnau', 'Achsalpenhorn', 'Langete Hans', 'Kirchthnrms', 'Dündenhorn', 'Erlach Lehen', 'Thunstetten Abthl Bützberg Aar', 'Whnau Aarwan', 'Spiez Spiez', 'Affoltern Suberg', 'NiederMuhleren', 'AugustinerOrdens', 'Obwaldenschen Engelberg', 'Wildelsigen Elsighorn', 'Laubbach Schwendi Dorf', 'Lünsperg', 'Mülchi Mühlheim Mülenen', 'Tießbach', 'Brüggacher', 'Dieser Berg', 'Answyl', 'Hochstraße', 'Schaafegg Heimwesen', 'Suselmatte', 'Lont', 'Ob', 'Hsr äViniKvn', 'Bern Fuß', 'Dürlocherhorn', 'Mannenbalm Hof', 'Bnrgbühl', 'Bartlome', 'Bern Konolfingen', 'Mörigen MörigenEggen', 'Pfrund', 'Chorhaus', 'Merzligerr Dorf', 'KleinWabern', 'Ulmitz O', 'Karthause', 'Kurried', 'Wirths', 'I Eriswvl Wynigen Pfarrdorf Bnrgdorf', 'Amseldingen Birchi Tiessenberg', 'Bergstraße', 'Fitzer', 'Ramseren', 'Wetterhorn Oberberg', 'Geißhofbach', 'Thales Adelboden', 'Wolf Aargletscher Ober', 'Hübeli Hsr', 'Waldegg Waiden', 'Kirchdorf Pfarrdorfu ehem Landger Seftigen', 'Gütlisperg', 'Moüens', 'bcrn Wangen', 'Aeschi Eschi Ober', 'Bern der Landstraße', 'Maricnthal Kloster', 'Leubriugen', 'Pfarrrd Täuffelcn', 'Barschwand Berg', 'Psarrd Ligerz', 'Mannenberg Lanbeckstalden', 'Kandersteg St', 'Abläntschen', 'Arni Vorder', 'Bern Balzenberg kall', 'Egghölzli', 'Möösli', 'Zull 1710 Nothachen', 'Langhans', 'Städtch', 'Brienzerseestraße', 'Ezelkosen', 'Ochlenberg Oschwand Wohngeb', 'TentschordensComthurei', 'Oekonomische Gesellschaft', 'Hünibach', 'Wetterhoru', 'Pfarrd Ursenback', 'Rehe', 'Kihley Diemtigen', 'Leutkirche', 'Helfereibez Rüschegg', 'Allmendthor', 'Stettlen Vechigen', 'Gsteig Steig', 'Lochmannsbühl', 'Kleinlanbersteck', 'Köniz Aegerten', 'BrandöschVicrtel', 'Nothhorn', 'Gem Hasleberg', 'Gem AußerBirrmoos', 'Gassenhorn', 'Rapperstübli Vgl', 'Säriswyl', 'Orpund Std', 'Steigelberg Stigelb', 'UMM', 'Aegidius', 'Altenberghöhe', 'Lauberstock', 'Signau Thun', 'Freiburgstraße', 'Hünigen Freimettigen', 'Sigrisivul', 'Waadt Saanen', 'Weißenau', 'Münsters Bern', 'Gasthof Mühle', 'Seefeld Vgl', 'Oberaargletschcr', 'Berghalde', 'Balm Frutigen', 'Auros', 'Hölzli', 'Gurnigel Lormoulum', 'Gnertres', 'Seeberghorn Flo', 'Bangarten', 'Erlenfluh', 'Schloß Justinger', 'Riedergrat', 'FeutersOey', 'Schloß Aarwangen', 'Bätterkilw', 'St Ligerz', 'Beim Brodhänsi', 'Bowyl Würzbrunnen Oberhofen', 'Rebberg', 'Mettenbergbrücke', 'Türrbach', 'Hubei', 'Reichenbach von Frutigen', 'Haus Wädenschwyl', 'Grimsclstraßc', 'Grafenried Gruben', 'Bockstein', 'Worblen Vgl', 'Alterthumsspnren', 'Achsitberges', 'Heuberge Hundsrück', 'bioüortinAon', 'Münsingen Wichtrach', 'Einwohnergem', 'Chateau dOex', 'Geistsee', 'Tönn', 'Fahrstraße', 'Hilsenenbrunnen', 'Scsterzligbrücke', 'Gnggli', 'Bürglcn', 'Steigelhorn', 'Schüppbach', 'Hirschmatt Schnlbezirk', 'Bözingen', 'Arve', 'Ochlenberg Homberg', 'Aarufers', 'Wintcrfutter', 'OberHohlen', 'Egerdo', 'Abcndbergs', 'Tnngel', 'Weiß Wörl', 'schihorn', 'Notthal', 'Vinelz Pfarrdorf Erlach', 'UntcrAargletschers', 'Mühlethal St', 'Pfarrgem', 'Zweisimmen St', 'Schloßmühle', 'Hühnerbach Hsr Höfe', 'Schloß Aarberg', 'Längeubühl', 'Lüthiwyl', 'Das O', 'Löschthal Wallis', 'Lyß', 'Otterbach Höfe', 'Kastelbühl', 'Weidganges', 'Burgbühl', 'Dingstatt', 'Schloß Burgdors', 'Bern Neuenburg', 'Emmenthal Oefters', 'Erlach Landeron', 'Schloß Signau', 'Wirthshause', 'Dentenbergs', 'Schwendi Schwende', 'Bijouterie', 'Spiez Jnterlaken', 'Düzberg', 'Wärgisthal', 'Jlfis', 'Hsrn besäetes Thal', 'Kandersteg Kirche', 'Aargau Emmenthal', 'Thälchens', 'Wiesen Felsen', 'Alp Tschuggen', 'Schönbühl Ziegelhütte', 'Garzen', 'Haus Boden', 'Znterlaken', 'Wattenwyl Wege', 'Emmenthal Bätterkiudcn Burgdorf', 'VinzenzenLeutkirche', 'BleyenbachNütschelenstraße', 'Nebengeb', 'Mühlheim', 'Bucheggschlößlein', 'Ryken', 'Därlig', 'Affoltern Moos', 'Salp', 'Aeschi Spiez', 'Gümmenen Klein', 'Spiez Bodenzingen', 'Dießbach Kiesen', 'Glockhaus', 'Vll5', 'Nydeck Dahin', 'Gümligen Welchen', 'Erorbernng', 'Herzogen Hauses', 'InnsIinMn', 'Rosenlauigl', 'Laubegg Spiez', 'Unttcv', 'Dießbach', 'Festlande', 'Schloß Thun', 'Ebren', 'Bisthnms Konstanz', 'SenseThals', 'Friedensey', 'SulgcnbachViertel', 'Rüderswyl Schönholz', 'Mühlibach', 'Grüneck', 'Trümmletenthal', 'Bleiken Schaubhaus Höfe', 'Haus Sumiswald', 'AarbergerMooses', 'Gürbenmoos', 'Erzeck', 'Wasserfluthen', 'Bürenberges', 'Bärenflühli', 'Emdthal Außer', 'Papiermühlestraße', 'Lühlweid Heidbühl Buchschachen', 'Mitordens', 'Langnau Sumis', 'Nidau Erlach', 'Bennenwyl', 'Gadmen Grindelwald', 'Schloß Twing', 'AnßerLatterbach', 'Einiges  lollir', 'Büetigen Affoltern', 'Aar Völligen Bern', 'Gerzensee Kirchdorf', 'Schumacher Zunfthaus', 'Kienboden Hohkien', 'Kanderbrügg', 'Dürrbach', 'Lastwaage', 'Wangen Bay', 'Herenfingen', 'Egg Schloßgut', 'Blümlisalp Winteregg', 'Röthenbach Röthenbach', 'Vom Lammerhorn', 'Thiergarten', 'Schorrenflnh', 'Außerbach', 'VLO', 'Kam', 'löükImMn', 'Abthl NiederMuhleren Seftigen', 'Schwarrenbach Wydi Wyde', 'Biclersee', 'Kirchberg Burgdorf', 'LvmirioliinAon', 'Närheggen', 'XnsoltinAsn', 'Wieswachs', 'Nöstbühl', 'Buchwald sw', 'Simmenthal Uebrigens', 'Waldeinöde', 'Langnau Huttwpl', 'Egrischwand Berg', 'Axalp Hinterburg', 'Bern Därstetten', 'Feldhäusli', 'Rabenthalwäldchen', 'Bäuert Ptisch', 'UAanw', 'Geichtbergs', 'Glasholzfluh', 'Seinen Namen', 'Aiühlenen', 'Arnolfsmühle', 'Ulm', 'Uebrigens', 'OberSimmenthals', 'Thierbcrg', 'UnterwaldenObw', 'Dampfwyl Ellenwyl', 'Gümligenthal', 'Hru Herrenschwand Murten', 'Rebgut Echenbühl', 'Tschugg Torf', 'Ferenbalni', 'Röthcnbach', 'Stein Bern', 'St Gumiswyl', 'Scheidbach', 'Zehntschencr', 'Bätteualp', 'BiglenEnetbach', 'ChablaisMoos Berg', 'Trachselwald UnterOeschenbach Wangen', 'Thunersee Faulensee', 'Belp kirchgän', 'Thun St', 'Ranflüh', 'Väuert', 'Tschingelgletschers', 'Bremgarten Oberlin', 'Barichti', 'AdelbodenHahneumooses', 'Bärenegg', 'Frutigen Das Thal', 'Rüeggis', 'Hofstatt Bremgarten', 'Melchsee St', 'Mülinen', 'Bergthales', 'Rychenarni', 'Spital Bern', 'Käfichthurm', 'IsthmusEingang', 'Faqade', 'Doknmentenbnch', 'Felsstocks', 'Arni der Hof', 'Engehalde', 'Gem Muri', 'Thun Std', 'Ganthi', 'Kühlbächleiu', 'Die Brücke', 'Zwieselberg Nentigcn', 'Berner Schneegebirge', 'Kiesen Oberland', 'Burgthurme', 'Stellihorn', 'Büren Bis', 'Aargauerstr', 'Dberhasle', 'OImrtreuLe', 'Frauchwyl', 'Giegisperg Hof Haus', 'Steinb alp', 'Calanda Graubündten', 'Ramsern Ramsern', 'Kehrsatz Belp', 'Wiesenthale', 'Reömann', 'rothe Fluh', 'Klösterli Kreuz', 'Alpeli', 'Längenbach', 'Rümlingen', 'Neuenburg Brunnadern', 'Waldeck Graben Reichenbach', 'Kriegsnoth', 'Pfarrort', 'Hühnli Hof', 'FinsterAarhorns', 'Suberg Dorf', 'Mühleberg Ebersche KleinHöchstetten Wichtrach', 'Thierberges', 'Suleckgrats', 'GwattSpiezstraße', 'Schangnau Habkern', 'Rehfnes Bern', 'Gamchigletscher Vgl', 'Leuerenfeldcs', 'Imerius', 'Aarjochs', 'Straßberg Büren', 'genMooses St Bern St Burgdorf', 'Münstngen', 'Langenthal Langete', 'Haube', 'Lauterbrnnnenth', 'Felsengebirgs', 'Schloß Kirche', 'Gilbach Geils', 'Jschbad', 'Vuvrv', 'Montblanc Savoyen', 'Schünenberg', 'Limpach Bad Uetendorfberg', 'Bänuen', 'Kienthal Dorf', 'Kastvogtei', 'Fischetzen Aarwangen', 'Hagnek', 'Horn Hübet Kaps Knubcl', 'Seftigen Lindach', 'bnrg', 'Carthause Thorberg', 'Susten Wasen', 'Münsigen', 'Attulnivyl', 'Belpstraße', 'Lützel', 'Längenbühlsee', 'Burgdorf Psarrdorf', 'Ligerz Nidau', 'Ried Weiler', 'Ziegelhütte', 'Frienisberg 1263 Frauchwyl', 'St Johannsen', 'Haus Luternau', 'OberAarhorn', 'Laupenstraße', 'Pfarrd Ob', 'Mittelaltcr', 'OberStocken', 'FlühLach', 'Mühle Schmiede', 'Helferci', 'Mönchshorn', 'Pfaffengraben Haus', 'Kirchberg Kiltberg Hof', 'Lötscherberg', 'Luläo', 'Schloß Nidan', 'Carton agefabrik', 'Bodenzengrat', 'Glashütte', 'Beatenloch', 'Müllen', 'Std Spiez', 'Bern Aarau', 'UnterG', 'AußerBlumenstein', 'Jsboden Grindelwald', 'Egg Fluh', 'Edlen Erlach', 'Stutz Thurnen', 'Ilooamw llsttereliinAon L0', 'Aarberg Bern', 'Egg Hintereggli Höh', 'Herbligen Aeschlen Kurzenberg', 'Ochsenalp', 'Priorat', 'Augusta', 'St JohanserHaus', 'NanflühVicrtel', 'Baschiloch', 'Bellelay', 'Lügenbach', 'Steinenbriinnen', 'SiebenBrunnen', 'Oswald', 'Schifflände', 'Deutsches Haus', 'Jnn erB lumen', 'Sempacher', 'Grafenstein Grimmenstein', 'OberDießbach', 'Völligen', 'Tabakfabrikation', 'Tannenbandstock', 'Lüumplum', 'Prüm', 'Wartenstein Emmenthal', 'Frutigen Berg', 'Wachsens', 'Schulgem', 'Schloß Spiez', 'Hilarii', 'lwspitnle', 'Hohen Namstein', 'Pfarrd Zimmerwald', 'Aare Bremgarten', 'Schlosse', 'Könizberges', 'Luzern Langenthal', 'Ergöw', 'Twingrecht', 'Thunstetten Schuposen Borste', 'Breithorn Vgl', 'Schloß Langenthal', 'Rosengarten Friedhof', 'Zoll Bern', 'Emmenthal Alpenros', 'Wengi St Bern', 'Saanen Schreckhorn', 'Bern Dümplitz', 'FinsterAargletschcr', 'Pfarrhs', 'Grimmeustein', 'Aarberg Brücken', 'Schloß Brandis Feuer', 'Brünig Std', 'Gsteig Chumigalm', 'Psarrdorf Zngeh', 'Wattenwhl Blumenstein', 'ThnnerAllmend Rosengarten', 'Hugi 5800', 'Goldgld', 'Kl', 'Vilmcrgerkrieg', 'Büttelspach', 'AußerOrts', 'Helgisried', 'Aarbrücke', 'Dieses Schloß', 'Weißensteinhölzli', 'Gem Gnggisberg', 'Pfarrb 1775 Thörigen', 'KleinTietwyl', 'Tuchfabrikation', '8ierv', 'Doppelbnrg', 'Lüßligen', 'Gländ', 'Lötschberg', 'Wandelhorn', 'Helsereibez Rüschegg', 'DernerAlpen', 'Bielersee St', 'Mittaghorn Elsighorn', 'Thun Burgdorf', 'Waggenmattgut Waggeumatt Haus Läng', 'Käsershaus', 'Nhonegletscher', 'Engstligen Kandergrund', 'Unteraargau', 'Scharnaehthal', 'Granholze Hofwyl', 'VütschelViertel', 'Wystätthorn', 'Lötschenthal', 'Jura Gestlcr Tessenberg Justisthal', 'Pfarrd Münchenbuchsee', 'Wylerguts', 'OberPlacken', 'Sumiswald Trachsclwald', 'Grciffen', 'Ochlenberg Staufen', 'Reutenen Dörfch', 'Goldsand', 'Schünen', 'RiggisbergWyslisaustraße', 'Oberbalm Wohng', 'Urreelliims', 'Frutigen Nieder', 'Fällbach', 'Fnsi', 'Beinhause', 'Belp Vgl', 'Amsol', 'Freihaus', 'Bache Zelg', 'Munizipalrath', 'Forst', 'Schloß Heimw', 'Ommiiu', 'Aeugsternknubel', 'Grindelwald Pfarrd Wellenberg Hsrgr', 'Heimathlein', 'Mülheim', 'Kander Oberhofen', 'Floßholz', 'Engelgebirge', 'Wangen Abhang', 'KleinDietwyl', 'Kapf', 'Kastei', 'Hasle Goldbach', 'Bern Zimmerwald', 'Bösingen', 'Ettenheim Schwarzwald', 'UnterGoldbach', 'Flötzkalkes', 'Oberer Drittel', 'Bucheggbergthälchcn', 'Köniz Linder', 'Grimselstraße', 'Spitallamm', 'Thal zeHr Rüegsau', 'Mülinen Mühlithal Graben', 'Adelmännli', 'Oua', 'Bußalpgrat', 'Nidflüh', 'Oberfeld Ort', 'Mörisried', 'Feldzng', 'Sch Mühle', 'Ammertenb', 'Attiswyler Zehnten', 'Cour Sumiswald', 'Engi Promenade', 'Höhlisbühl', 'Schloß Buchsee', 'Sedel', 'Wynigen St', 'Cistercienserordeus', 'Aar Eyberg', 'Erlenbach Frutigen', 'Militärspital', 'Imitindero 1268 leintoiiderA 1275 Oent', 'Büchslen', 'Schloßgut', 'Käserz urk 1294 Xerssx Dorf', 'Bleienbach Mann', 'Rüegsau Rüegsau', 'Ostermundigen', 'Osso', 'Könitz O', 'Rafrütti', 'Lütschenthals', 'Bütschibachs Bitsch', 'Luthern Eriswyl', 'Schwanden N', 'Sörenberg Marienthal', 'Süderen', 'Teß', 'Hru Trog', 'Gebirgshöhe', 'Konolfingen Zollikofen', 'Emmentha', 'Handelsrnhm', 'Llmrtrouso', 'Großhorn', 'Niederbipp Abthl Niederbipp Wangen', 'Achern', 'Flüßchen', 'Bern Gündlischwand', 'Diemtig berg', 'Hermann', 'Charlottenbühl', 'Lauenen Thal', 'Ghürn', 'Frutigen Bern', 'Schloß Bubenberg', 'Hütte', 'Säeune', 'Pfarrd Wyl', 'Münster Bern', 'Aarbergergaßbrunnen', 'StA Bäche', 'Bunschcn', 'Burgdorf Oberburg', 'Kirchdorf Abthl Gelterfingen', 'Hsr Mitholz Ueblenberg', 'Teutsch', 'Lerne Savoie', 'Alchenflüh', 'Std Zmittenholz Felsenburg Zwischeubäch', 'Schönegg', 'Burgdorfhölzchen', 'Grindelwald Dem', 'IlutlUviluro', 'Melchnau Pfarrdorf', 'Stiege', 'Grimsel Std', 'Thälchen', 'Adelboden Aeschi Frutigbad Kandersteg Kienthal Krattigcn Mülenen Ueschinen', 'Grindel Schulh Graben', 'Tennenbach', 'Aargauerstraße', 'Konolfingen NiederWichtrach', 'Bern Luzernstraße', 'Kaltwasserkuren', 'Mehringen', 'Lenk Der Weg', 'Roggwyl Pfarrdorf', 'EngtHalbinsel', 'Agriswyl Goldbach Nieder', 'Hühnliwalds', 'Weißenburgbad', 'Bödeli', 'Marcellus', 'Grandson Orbe', 'Bern Aarwangen', 'Gole der Emme Goldsand', 'Alterthnmsfvrschung', 'V6Ü', 'Simmenthal Zweisimmen', 'Lombachthnrm', 'Bernerisch', 'Biebern', 'Müusingen', 'Sandsluh', 'Horben Niedern', 'Kantonstheile', 'Wystäthorn', 'Totzigen', 'Weyer Hollanden', 'AescheRied', 'Würzbrunnen', 'RothBezirk', 'Steghalden', 'Hirsboden', 'Steinhölzli', 'Schlosse Reichenbach', 'Winkten Winkel', 'Kap Bern', 'Hauseck', 'Badens', 'Reben Schloß', 'Das Mühle', 'Kienthal Vgl', 'Guggisberg Schwarzenburg', 'Pfarrd Koppigen', 'Bern Vgl', 'Studcr', 'Furka Wallis', 'Meiringen Vgl', 'Bäuert Horben', 'Bern Blankenburg', 'Bellegarde Chateau dOex', 'Rath Burgdorf', 'Amsoldingerfee', 'Wimmis Tiemtigen', 'Alpenthee', 'Kaufh', 'Bor', 'Brüchle', 'Saumstraße', 'lütschine', 'Pfranmholz', 'Nidau Der Zehnten', 'Haubenberges', 'EriswylDorf', 'Ns', 'Mühleberg Pfarrdorf Kirch', 'Maßholder Ulmen Aspen', 'Burgdorf Aarwangeu', 'Saage Schneidemühlen', 'Täuffelen Nidau der Pf', 'Meli', 'Steinhüs Steinhaus', 'Furgge'}",4684,"{'Gro-Strnbel', 'Egkenbhl', 'Tas', '- sternthal', 'Schnegg', 'Tannenth', 'Breitmoos', 'Lan', 'Nesselgraben', 'Schinkengasse', 'Zwygart', 'Jlisried', 'Grbeufer', 'Strtlingeu', 'Graben', 'Geienthal', '- zenbnrg', '- Lind', '- Burgund', '- Mhleberg', 'Brck', 'Kaltenbrunnen', 'Simmenth Turbachth', 'Jsch', 'Albrist', 'Burgdorf-Kapitel', 'Lanterbrunnen', 'Schowlandsgasse', 'Soau', 'Mnribach', 'Niklaus', 'MngHH', 'Gra', 'Hohenalp', '- delbank', 'St. Johannstag', 'Ried-Aesche Aesche-Ried', 'Rtli', 'Calanda', 'Mure', 'Lindbach', 'Ltrata', 'Rohuscrn', 'Schmidigenhof', 'Vaupers', 'Wangen St.', 'nterdorf', 'Kriechstetten', 'St. Sebastians', 'weid', 'Sigriswhl', 'Ncuenburgersee', 'Kurz enberg', 'Reggisberg', 'Josua Diebach', 'St. Urban', 'Bucheggbergthlchcn', 'Mettenb', 'Kalchstetten', 'Niedburg', 'Synoden', 'Langenthals', 'Redtligen', 'LrkinZvon', 'Mhrenhorn', 'Freiburgerbergen', 'Solberg', 'Weienburgbad', 'Zaunegg', 'Nieder-Muhleren', 'Strub', 'Werdenberg', 'Leen', 'Hannemoos', '- halde', 'Bregg', 'OtsI', 'Eschlischwang', 'Bienbach', '- Maa', '- Oenz Wanzwyl Heimenhausen', '- miswald', 'Martiegg', 'Rdligen', 'Nentigcn', '- Wald', '- Allmeud', 'Grabenstrae', 'Schmiedenviertel', 'Alteiche', 'Vincenzen', '- Dettigen Hosen', 'Saussure', 'Oberhvfcn', 'Utvnbiil', 'Elsa', 'Lberu', 'Nieder-Sibethal', 'Ziemlisbcrg', 'Weien brg', 'Wystthorn', 'Nieder-Simmenthal', 'Bern St.', 'Bleierz', 'Burgdorfs', 'Buntsch', 'Othmarsabend', 'Kandergrien', 'Graubndten', 'Rdligcn', 'Pfarrdorfu', 'Lverach', 'Bttcnalp', 'Ticmtigthale', 'Vivis', 'Rothachen', 'Ober-Scherli', 'Rpplisried', 'Oberbtzberg', 'Brien', 'Sim', 'Herreuschwanden', 'Burglauihorn', 'Wangen ried', 'ThunersSe', 'Doffenhorn', 'Sommerlatt', 'Niiegsbach-Viertcl', 'Seidenberg', 'Herzo', 'Baumgartner', 'Oberwyl Mauer', 'Schallenhaus', 'Mrlingen', 'Egernschwand', '- Limmenthal', 'Zringen', 'Gran', 'Sand', 'St. Ilrban', 'Sam', 'Lngeubhl', 'Sossau', 'Matthias', 'Gemeindsbez', 'Pfarrdvrf Nthi', 'Vincenzenstifts', 'Finster-Aarhorns', 'Deiwyl', 'Schnisegg', 'Hrn', 'Dnemark', 'Lindnach', '- Diebach', 'Martins sel', '- chirel', 'Nied. - Bleyenbach', 'Hornbach-Kurzeneigraben', 'Sann', 'Sausbach', 'Flhlenstalden', 'Buwylgraben', 'Blumenstciner-Bad', 'Wald', 'Llossi', 'Trrenbach', 'lten', 'Zwiebelngasse', 'Gadinen', 'Nyfellcr', 'Chamouny', 'Rnkh', '- stock', 'Thalgraben', 'Kerselen', 'Sanetschpa', 'Hugi', '- selwald', 'Bhlberg', 'Haulerberg', 'Oltingeu', 'Deiwul', 'Pfaffenmoos-Hlzli', 'Btzingeu', 'Anderegg', 'Reuschegg', 'Moosseedorfsee', '- nan Bern', 'Schwrzibach', 'Alt-Bubenberg', 'Brbach', 'Ghsenstein', 'Gsteigth', 'Steinbock', 'Rohrb', 'Dorsch', 'Rcdi', 'St. St.', 'Mnster', 'Mutach', 'Kosen', 'Obonvii', 'Safnern', 'Horn', 'Ober-Ey', 'Frntigerland', 'Krschenbrunnen', 'Brhegen', 'St. Georgeutag', 'Gug', 'Rmkofen', '- burgseelein', 'St. breit', 'Blattenweid', 'Vannwyls', 'Bnigen', 'Hahn', 'Krayligen', 'Vordertbeil', 'Stockenthal Grbenmoos', 'Seandinavien', 'Matt', 'Oberbcrg', 'Nenbrcke', 'Kauzcnhubel', 'Urssubach', 'Hohkien', 'Liebegg', 'Morgarten', 'Bagwyl', 'Olnvglexres', 'Kalli', 'Muri Pfarrd', 'Lauenenhorn', 'Gerwern-Viertel', 'Tscherlschisthal', 'Burgbhl', 'Michelthrlein', 'Mayenfahl', 'Str', 'Eichberg', 'Wengen-Scheideck', 'Borns', 'Hpbach', 'Ostcrmundingen', 'St. Gallentag', 'Musterthal', 'Lpssach', 'Gilomen', 'Brunngaffe', 'Hirzenhalde', 'Grasland', 'Ningolzwyl', 'Ltschenthals', 'Waltrigen-Mhle', 'Notenflue', 'Mettenbhl', 'Kelergasse', 'Maybach', 'Diindenhorn', 'Lterkofenbach', 'St. Maria', 'Sulgcnbach-Viertel', 'Mnnsingen', 'Gerbern', 'Bnben', 'Neutigen', 'Bram', 'Kirchbhl', 'Hellischwand', 'Gnttanncn', 'Dennler-Mhlemann', 'Bhlbubel', 'Gttschmannsried', 'Heddo', 'Alezbach', 'Murzeudon', 'Langerberg', 'Mhleberg', 'Oekingen', 'Griudelwald', 'Thale', '- felden', '^', 'Schachenhof', 'Mlheim', 'Burghof', 'St. lange', 'Acha', 'Wahlalp', 'Greussisperg', 'March', 'Mbleholz', 'Gro Affoltern', '- lodingen', 'Brandsch', 'Weienan', 'Weibach', 'Jmvbcrsteg', 'Bttenalp', 'Gadem', 'Schoshalden', 'Rappcrswyl', 'Erlach-Wuistcmbcrger', 'Kranchthalberg', 'Schweiberg-Drittel', 'Neubrckrain', 'Eriswyl-Wyachengraben', 'Burgdvrf', 'Sigristenhof', 'Lywald', 'Blmlisalp', 'Landiswyl-Bezirk', 'Drlocherhorn', 'Berncr', 'St. Urbau', 'Helvetia', 'Kurzenoergs', 'Farnrain', 'Thunerseestrac', 'Leuw', 'Hruberg', 'B lattiberg', 'Brienzerseestrae', 'Barisch', 'Waldkilchenfeld', 'Brnigen', 'Sefinenalp', 'Unterseeu', 'Emanuel', 'Grnenmatt', 'Gzi', 'Romooser-Enzi', 'Winterswyl', 'Schongau', 'Lterswyl', 'Katzenbhl', 'Buchseemoos', 'Guyot', 'Hinter-Lckhorn', 'Gydisdorf', 'St. Thl', 'orf', 'Vieschcrhorn', 'kyburg', 'Frieswylstrae', 'Bellen', 'Eichfeld', 'Mhleth', 'Grchwyl', 'Tomann', 'Schnried', 'Thnnstetten', 'Ramis', 'Ober-Brandhubel', 'Mriswyl', 'Glungenbrnnnen', 'Hirschen', 'Stadtach', 'Bdeleins', 'Nieder - Simmentbal St. Erlenbach', 'Ober-Oeschenbach', 'Kyburg-Habsburg', 'Bernegg', 'Bidmen', 'Urbanstag', 'Schngan', 'Emdorf', 'Mllergasse', 'St. Gotthards', 'V', 'Martins', 'Gave', 'Leih', '- genstr', 'Morizen', 'Twiug', 'Brgger', 'Ncichenbach', 'Allenwyl-Wald', 'Marchverbal', 'Olerosso', '- Kohlholz', 'Thunerseestr', 'Romoos', 'Rschbach', 'Bnchsgau', 'Scheu', 'Hellstttegg', 'Spirenwald', 'Wdischwyl', 'Goplism', 'Traubachegg', 'Lngenberg', 'Betingen', 'iKiiitz', 'Chumigalm', 'IlonurMo', '- Bnrgistein', 'Rblihorn', 'Bttwyl', 'Pltsch', 'Luginbhl', 'Kirchhgel', 'Erbatta', 'St. Martinstag', 'Mhlau', 'Finsteraar', 'Lenkih', 'Nothach', 'Viviers', 'Sibethal', 'Te', 'Ahornen', 'Lngenbergs', '- Btzberg', 'Frittenbachgraben', 'Tiefenbach', 'Sal', 'Obernz', 'N.O', 'Ober-Emmenthal', 'Tedligengraben', 'Rmligen', '- Emmenthal', 'Knizthal', 'Breisgan', '- lauenenschule', 'Lthiwyl', 'Vanelberg', '- tenthal', '- orn', 'Nieder Btschel', 'Berner-Hochalpen', 'Aspiwald', 'Moos-Affoltern', 'Laupenstr', 'Bandstrae', 'Niederlindach', 'Briigglen', 'Brandts', 'Saanenthal', 'Ober-Tettigen', 'Ltschern', 'Auerdvrf', 'Drrbach', 'Daxelhofer-Haller', '- lauistock', 'Heiligenlandhof', 'Altren', 'Beitenwyl', 'Ncueneck', '- ropa', 'Wildegg', 'Rderswyl.', 'Drrenflh', 'Tannalp', '- egg', '- thals', 'Brgglcn', 'Brengraben', 'Gserz', 'Hochgstr', 'Obergoldbach', '- Aarberg Aarberger-Moos', 'Amtsschaffncr', 'Pfaffnach', 'Zollern', 'Kurz', 'Habsurg', 'Wiesen', 'Gysdorf', 'Neleren', 'Dr', 'Neichsland', 'Weibachs', 'Kirchhfe', 'Sachslenthal', 'Freiburgerstr', 'Golatet', 'eidgen', 'Ita', 'Lauter-Aarhorns', 'Rainbrcke', 'Simmeufer', 'Lngwald', 'Berggut', 'Egerdongaffe', 'Bleyenbach-Ntschelenstrae', 'Riet', 'Mnnenbergs', 'Balzenwyl', 'Nieder-Wichtrach', 'Zzibach', 'Geiholz', 'Stettler', 'Ober-Bipp', 'Wengenalp-Scheidegg', 'Merligen', 'Oelis', 'Regest', '- Simmcnthal', 'Drrgraben', 'Grnigen', 'Maldhubel', '- und Nieder - oder O. - und N. - Bttschel', 'Kan', 'Koniz', 'Brenberges', '-', 'Nieder-Hnigen', 'Aefligcu', 'Nidauer-Kap', 'Vipern ntia', 'Gcibhler', 'Granfelden', 'Msching', 'Ris', 'Spitalbhl', 'Lueghubel', 'Blattenstein', 'Hildolfingen', 'Kuitz', '- und Kienthals', 'Bubenbergc', 'Langenthal-Melchnaustr', '8unAlau', 'Nieder-Dipp', 'Baksigcr', 'Mhlen', 'Bernerisch-Messen', 'Nom', '- banmenhubel', '- dossola', 'Trrmhle', 'Lauter-Aargletschers', 'Dieterswald', 'Emmenbrcke', 'Ghrnwald', 'Engelbrg', 'Blau', 'Wieniger', 'Buchseren', 'Burgen', 'Schulgasse', '- matt', 'Herzogeubuchsee', 'Beittenwyl', 'Goumvns', 'Lbl', 'Bangerten', 'Finster', '- nenthal', 'Jffigeuthal', '- Balm', '- dcneich', 'Egertengasse', 'Straburg', 'Muchenstein', 'Gohlhaus', 'Weidabtausche', 'Breitenwald', 'Thalgut-Brcke', 'Aargauerstrae', 'Mlenen', 'Walliserseite', 'Attenwhl', 'Aarmhle', 'Gdel', 'Kriesweg', 'Grauen-Schwesternhaus', 'Fehlistutz', 'Grben', 'Brentzikvffen', 'Preuen', 'Roth Arni Lthiwyl', 'Glatthard', 'Ergw', 'Twirinn', 'Johannis', 'Mhlethal', 'Sandstein', 'Warmer', '- simmenthal', 'Blasenstutz', 'Steffen', 'Vohnerz', 'Bllitz', '- und Nieder-Alchistorf', 'Tfchamerey', 'Vleichenbach', 'Bitsch', 'Trbtensee', 'Weienbnrg', 'Neggisberg', 'Grimsclstrac', 'Bern-Thnnstr', 'Haueterberg', 'Jasbach', 'Hollanden', 'Wahlenhaus', 'Schlenmenberg', 'Enzenbhl', 'Lhlein', 'Graben-Viertel', 'Soowilo', 'Goldenmattgathor', 'Riedbad', 'Walpenwyl', 'St. Patten', 'Wyleroltingen', 'Scfinenalp', 'Zwischeubch', 'Wart', 'Tausch', 'Nidgau', 'Landw', 'Savoyer', 'Grubenwald', 'Nosenlaui', 'Palme', 'Leiigenberg', 'Lutzens', 'Mei', 'Ilchvlliwl', 'Lerch enberg', 'St. Doset', 'Gotthardstrae', 'Spcisewirth', 'Englisperg', 'Wynigc', 'Bs-Arni', 'Altenbcrg-Viertcl', 'Stuttgart', 'Leuxingen', 'Chrom', 'St. Beaten', 'Gell', 'Geb', '- Ursenbach', 'Tiefenau', 'Hnli-Waldhgels', 'Je', 'Scheurer', 'Alchenfih', 'Mbleberg', 'Nieder-Sinnnenthal', 'Jsrazweil', 'Bon', 'Gempelenbergli', 'Kderegg', 'Metzger', 'Johannsen', 'li', 'Lossoim', 'Trligen', 'Lybachs', 'Elend-Kreuz', 'Nifel', 'Schmieden', 'Eisenstuh', 'Obersch', 'Vrnzikofen', 'Lauteraar', 'Flschackern', 'Schpberg', 'Unter-Stutz', 'Btschelbach', '- tigerthals', 'Burgdorfhlzchen', 'Klein-Tietwyl', 'Gder', 'Ucltschi', 'Jffigenth', 'Mschbachs', 'Rothenbhl-Sonn enberg', 'Ar-ar', 'Stambach', '- wyl Nieder-Simmenthal', 'Mnrtenstr', 'Engelalp', '- labyrinth', 'Niedernz', 'Bhlbach', 'Noggwyl', 'Tschanen Alb', 'Stg', 'Ober-Oesch', 'Grthof', 'Stotz', 'Megisserhorn', 'Buchenberg', '- Neuhaus', 'Schppbach', 'Uettligen', 'Kantonsmarch', 'Schupposeu', 'Mhlenen', 'Hrenberg', 'Bltsch', 'Ober-B', 'Schwenkn', '- horn', 'Ober-Btzberg', 'Lvchbach', 'Mnsterterrasse', 'Oberdorf-4tel', '- lenthal', '- Namsern', 'Berner', 'Auerdorf', 'St. lang', 'Giesenengrat', '- hofen', 'Rosen', 'Tschanz', 'Unterscen', 'Wy', 'Ncucnschwand', 'Hattingen', '- Lehmbach', 'Frienisberg St.', 'Einstedl', 'Lauter-Aarjoch', 'Hlisbhl', 'Var', 'Goldern', 'Kmtz', 'Wiler', 'Ludnig', 'Tas Oertchen', 'Granit', 'Brttelenbad', 'pcrswyl', 'Klein-Emmenthal', 'Vremgarten', 'Luthern', 'Jstithal', 'Fankhauser', 'Ubert', 'Zrich', 'Schwaflands', '- bachthal', 'Merligcn', 'Cvnradsau', 'Teuscher', 'Nsch', 'Olisch enenburg', 'Ltold', 'Bettelberg', 'orb', 'Gutenbnrg', 'Dorssch', 'Feldhusli', 'Gcrenhorn', 'Lhbach', 'Lauterbrunneu', 'Oberberg', 'Schwanden-Viertel', 'Jmboden', 'Rentibach', 'Nieder-Enzi', 'Melcheubhlgnt', 'Lengacher', 'Kybberg', 'Mnriboden', 'Lroolllnl', 'Rterichsbodeu', 'Egrischwand', 'Orpnnd', 'Hiltbrand', 'Bigleumoos', 'Nitstnh', 'Eggstein', 'Tannwalde', 'Blmlisakp', 'Brglcn', 'innedasKlap', 'Constanz', '- Alpbach', 'Weienburg', 'Krebs', 'Burgernziel', 'Hasle-Scheideck', 'Khler', 'Webern', 'Oeli', '- bach-Au', 'Galler', 'Aeschlen-Alp', 'Gerisberg', 'Balmeregghorn', 'Aarbergerstrae', 'Pfarr', 'Gutisberg', 'Hasenbnrg', 'Bannwyl-Langholz', 'Gutenbrnnen', 'Eschlen', 'Langenegg-Grat', '- hausen', 'Pohleren', 'St. St. Gals', 'Wylersteg', 'Emmenthalstrae', 'Golbrckli', 'Hl-G meind', 'Nie', 'Bmplitz', 'Unter-Oeschenbach', '- und Unter-Winterthal', 'Oberweng', 'Kniz', 'Bergdrfch', 'Aaran', 'Langenthal-Kapitel', 'Dornig', 'Orun', 'Rolli', 'Grenzen', 'Lauterbrunnenthales', 'Thun-Kapitel', 'XirotiborA', 'Ober-Ly', 'Wyssachengraben', 'Bisth', 'Gasicr', 'Freisttten', 'Alpweiden', 'Brggelen', 'Drrensee', 'Otten', 'Belpstrae', 'Heidenhaus', 'Prisberg', 'Htschigen', 'Guggersbach', 'Kronenbnrg', 'Sriswyl', 'Mnfingen', '- thal', 'Zwieselbcrg', 'Biren', 'Ahorngruppen', 'Lh', '- heid', 'N.', 'Wcienburg', 'Gruben', '- dorf', 'Wil', 'Tannlihorn', 'Rogg', 'Geihofbach', 'eien', 'Alannschiefer', 'Gries', 'Hattcnmatt', 'Srmmenthal', 'Bittersalz', 'Laubeckstalden', 'Knizberges', 'Refli', 'Doset', '- walden', '- Aarhorn', 'Finster-Aarhorn', 'Oberzelg-4tel', 'Pfaffengraben', 'Hohwart', 'Jnstithal', 'Eichbhl', 'Schilt', 'Escher', 'Lichtme', 'Aeschbacherschachen', 'Hasle-Otzenberg', 'Nfiswaldberg', 'Gestlcr', 'Mergel', 'Rain', 'Buwyl', 'Wlflisried', 'Betschwyi', 'Leibundgut', 'Rtschgrahen', 'Gsteigthales', '- Groerlen', '- W.', 'Seew', 'Brcn', 'Solo', 'Spitzhorn', 'Gstellihorn', 'Sckwy', 'Languau', 'Brem', 'Mlinen', 'Bntschbach', 'Urwyler', 'Luzernstrae', 'Pst', 'Mnchenbuchsee', 'Murzclen', 'Schwalbe', 'Menwyl', 'Rentland', 'Fridegg', 'Solothurnerlandstrae', 'Brttelen', 'Hcidenstatt', '- stein', 'Leerau', '- haldc', 'Eichi', 'Bergpsad', 'Habkcrig', 'Dachnaglergrabcn', 'Brodhusi', 'Er', 'Ltzel', 'Noscnlaui-Bad', 'Alb Bonstetten', 'Birrmos', 'Oschwand', 'Jcnncr', 'Bnmbchli', 'Trub', 'Hchstettcn', 'Burgi', 'Schlo Heimw', 'Zollikofcnstrae', 'Oberwstenbach', 'HellSau', 'Stephan', 'Solothuru', 'St. Beat', 'Banm', 'Aarganerheerstrae', '- Nieder - und Hinterdorf', 'Feldmoos', 'Elenden-Hcrberg', 'Ratolfingen', 'Kirchhren', 'Affoltecn', 'Walpcrswyl', '- bachs', 'Dirvlie', 'Grssisperg', 'Urban', 'Ballenb erg', 'Rotthals', 'Herolfingen', 'Elser', 'Torf', 'Cono', 'HiettmMn', 'Helisbhl', 'Jnnkerngasse', '- thenbach', 'Leiiggrat', 'Rynach', 'Brand', 'Jnngfrauhorns', 'Kopp', 'Deutenderg', 'Landwirth', 'Jnuerdorf', 'Lindenholz', '- und Freiburgerstrae', 'Berger', 'So', 'Briswyl', '- Niederlind', 'Gastren', 'Seelibhl', '- Lngenbergs', 'Mrsried', 'Pfarrdvrf', 'Nogartcn', 'Weienburgberg', 'Oberli', 'Ober-Waltrigen', '- Lerg', 'Leiigermarch', 'Jnnerdorf', 'Hgschbach', 'Sohlhorn', 'Illusigus', 'Speiscwirth', 'Oberbrhl', 'Schwefelgas', 'Weistegen', 'Schohalden-Viertel', 'St. Gallen', 'Kiesenbachs', 'Nizbach', 'Oeschincubach', '- Mhlibach', 'Ober-Bren', 'Bad Oswald', 'Allenlften', 'Aeugsten', 'Martisegg', 'Nydeck-B', 'Weienau', 'Emdthal', 'Lckadt', 'Brenegg', 'Ramsern', 'Signau Langnan', '- Hermendingen', 'Biederen', 'Konr', 'Kfichthurm', 'St. Pfarrdorf', 'Bruchgehrenberg', 'Std Belp', 'Drackau', 'Lzelflh', 'Ober-Sulgenbach', 'Aenetbachberg', 'Loo', 'Belp Jak', 'Flo', 'Laucnen', 'Heiteren', 'Walliser', 'Bblweid', 'Breitfelds', 'Pipin', 'Villars', 'Hilterfingc', 'Anshelm', 'Verglistock', 'Schafalpen', 'Ober-Ramsern', '- riettaz', 'Sternenberg.', 'Habsbnrg', 'Bernerbancrn', 'Hh gant', 'Rz', 'Engibrcke', 'Mschberg', 'Kttikofen', 'kollevuo', 'Frobnrg', 'Strtlingen', 'Tieenberg', 'Napf', 'Weitenbirche', 'Wei-Ltschine', 'Maser', 'Lcngnau', 'Pfarrdrfchen', '8angenthal-St.', 'Vcrchtold', 'Uettligenseld', 'Wer', 'Lauperowyl', 'Andr', 'Wsch', 'Melchthal', 'Urbachth', 'Brnig', 'inBelp', 'Bowegsthrlein', 'Mnchenwpler', 'Bantsgen', 'Tannenhof', 'Arbnrg', 'Instinger', 'Selenit', '- menthalern', 'Niedcrbipp', 'Alpberg', 'Hubberg-Viertel', 'Vipern', 'Hintergasse', 'rhein', 'Wyachcngrabcn', 'Heustrichbad', 'cidg', 'Beck', 'Bhlikofen', 'Nid-Au', 'Rdlen', 'Tellenfeld', 'Bol', 'Gloggenthal', 'Wylerbrcke', 'Seebcrg', 'Amseldingen', 'Diirrenmatt', 'Zlutschi', 'Gehrisberg', 'Ranchenbhl', 'Gibcl', 'Movs-Affvltern', 'Nybrck', 'Irrenhaus', 'Llingen', 'Gr.', 'Tschingels', 'Brningen', 'Adelbodenth', 'Grneck', 'Grnd', 'Lindenholzh', 'Brgisweyer', 'St. nrdl', 'Griebach', 'Alt-Landorf', 'Rxau', 'Unterschwendi', 'Schpfen', 'Gern', 'Thali Drfch', 'Bibcren', '- bezirk', 'Schellenwerk', 'Mnchenwyler', '- zensee', 'Neicheubach', 'Snlpicius-Balm', 'Tessen', 'Kiley-Alp', 'Neuengut', 'Burg', 'St. Burgdorf', 'Stanz', 'Eis', 'UomberZ', 'LauperswyttViertel', 'Enetbachberg', 'ZunfthauS', 'Alpenrosen', 'ald', 'Lochbad', 'Mulinen', 'Kalberhhnibach', 'Aetzreuti', 'Melchsee', 'Gtzi', 'Gugelmann', 'Mhlebach', 'Angstmatthorn', 'Hvrnbachgraben', 'Mhle berg', 'Lorbru', 'Blumeustein-Bad', 'Saanenkse', 'Hnigen-Moos', 'Schwarzwasserbrcke', 'Maurizen', 'Sprri', 'Grterhof', 'Kurth', 'Balsalp', 'Khrcchten', 'sterreich', 'Zwingelhof', 'Seewyl', 'Hegsbach', 'Brau', 'Ulm itz', 'Brhcggen', 'Venz', '- Weienburg', 'NlehfueS', 'Pfarrd Jsch', 'Gchliwhl', 'Tscherz', 'Neuenburger', 'Kouiz', 'Burgdorfern', 'Genfer', 'Amsoldingcn', 'Beunberg', 'Halter', 'Jschisth', 'Egli', 'Jfeltwald', 'Walliser-Gr', 'Kryingen', 'Aha', 'Aefligen', 'Guggershorns', 'Knitz', 'Gror', 'Berghsr', 'Heiligcnland', 'Mhlethals', 'Aelpithal', 'Kfichglein', 'Tscheuten', '- denberg', 'Vignay', '- tclbach', 'Jnkwyl', 'Fluspath', 'Kiltbhl', 'Weien', 'Wal', 'Nieder-Gurzelen', 'Uestethal', 'Zum-Wald', 'Langcncgg', '- cgg', 'Grniberg', '- Sd-Ost', 'Audienzaktnar', 'Sandsteinfelsen', 'Guardian', 'Hnigen', 'Offenhuser', 'Saahli-Bez', 'Wyden', 'Spitalsee', 'Lthard', 'Eratz', 'Berchdorf', 'Moritzen', 'Gld', 'Bttschol', 'Dndenhorn', 'Jaggis', 'Khburg', 'OwMsborZ', 'Alchen', 'Mhlethurnen', '- O - W.', 'Filderichbach', 'Almis', 'Walthaus', 'Lngenbach', 'Hug', 'Buetingen', 'Bnchseebnch', 'Wild-Elsigen', '- Fluh', 'St. Peter', 'Allwandingen', 'Allenberg', 'Bittlosa', 'Gro-Ammertenhorn', 'Langernalp', 'Konitz', 'Tromwyl', '- benberg', 'Ramscr', 'Grindelw', 'Rormoos', '- und Nieder-Schnegg', 'Koburg', 'Stocken', 'Schwcikhvf', 'Curried', 'ArAuurvv', '- hlzleins', 'Grencheu', 'Alpeuros', 'Gohlhausbrcke', '- Jaberg', 'Gasse', 'BrenAns', 'Meyringer-Thal', 'Mhlethaler', 'Oberhofen-Gontenstrae', 'Thronegg', 'Schnenfels', 'Scheidcgg-Alp', '- genstorf', 'Brunnen', 'Hinterga', 'Bickigenhof', 'Bur', 'Bunschenbad', 'Trbtenbach', 'Riesenau', 'Sustenstrae', 'Klsterli Regsegg', 'Khgrimmiberg', 'Schnholz', 'Wyssa urk', 'Reichiswyl', 'Kirschwasser', 'Mnnenberg', 'StG', 'Nachbardrfch', 'Neubrcke', 'Feutersop', 'Sigimu', '- ringen', 'Drrenroth', 'Bmbach', 'Vrstalden', 'Griechenwyl', 'Bleien', 'Rttiberg', 'MooS', 'Grafenbhl', 'Nchtland', 'Gurbr', 'Bttelspach', 'Pfarrd Mnsingen', 'Wydenhof', 'Palstina', 'Niederwichtrach', 'Wylisau', 'Sonnseite', 'St. Siegart', 'Regsbachgrabens', 'Brgenstein', '- ltschine', 'Honig', 'Nied.', 'Gstcig', 'Lyon', 'Jsaak', 'Gneis', 'Welsch-Neuenburg', 'Buri', 'Burgnnden', 'Vonstetten', 'iXova', 'gisp', 'Egerten', 'Uabioorn', 'Fllestntz', 'Kaltackerberg', 'Maurachern', 'Waldhgel', 'Pfaffenmoos', '- sel', 'Geltersingen', 'Ltschthal', 'Niederhnigen', 'Dornbhl', 'Scheidwald-Bezirk', 'Gump', 'Dorfberg', 'Npdegg', 'Stadnz', 'Bcatenberg', 'Gambach-Ryffenmattstrae', 'Kappcllenbad', '- wylbach', 'Moors', 'Bctten', 'Schultheienthor', '- Alpen', 'Obcr-Simmenthal', 'Gemeindeh', 'Otterbach Jnner-Birrmoos', 'Emmeuthal', 'Egghlzlein', 'Heidenwcg', '- Kirchschwand', 'Nassau', 'Nydcckbrcke', 'Trb', 'Wallendors', 'Die', 'Dzberg', 'Eggenderg', 'Trfleinbez', '- stetten', '- Weiler', '- lindach', 'O. - N. - Weiler', 'Btingen', 'Kiltberg', 'Bieberach', 'Frienisbergerwald', 'Wolhausen', '- garten', 'Biberon', 'Lnonlbaoli', 'Novs', 'Oberge', 'Laup', 'Btschels', 'Heidenmoos', 'Aara', 'Dberbofen', 'Hnibach', 'Dieenb erg', 'Ostermundingen', 'Stdn Rothachen', 'Privatsch', 'St. Beatenberg', '- und Nieder-Sulgen', 'Trfch', 'Murzendon', 'Dmplitz', 'amOenzbach', 'Zziwyl', 'Feer', 'Fundort', 'HabstetttN', 'Kvppigen', 'toiplatz', 'Neuchatel', 'Ilnolwnlmoli', 'Knizberg', 'Gornerengrund', 'urk', 'Thrishausstr', 'Kra', 'obern Aarthal', 'Halen', 'Kblisbad', 'Gerol', 'Freibachmoos', 'Weien-Schwesternhaus', 'Grodei', 'StA Mrchen', 'Tbring', 'Kastelbhl', 'Mittholz', 'Zazenwyl', 'Moor', '- Lindach', 'Studen', 'Lanterbach', 'Ober-Jbach', 'Niedersch', 'Lybach', 'Enetmoos', 'Btterkilw', 'St. Erlach', 'Diligencen', 'Grnenberg', 'Alkistorf', '- derlamm', 'Bandelier', 'Felden', 'St. Oberaargau', 'Brombeerstrauch', 'Grubach', 'Arlesheim', 'Mnchy', 'Laubbach', 'Freudenberger', 'Tessen berg', 'Sderen', 'Goldpisberg', 'Zieger', 'Neucn', 'Jnner-Orts', 'Rthi', 'Adelgos', 'Hciligbhl', 'Gruenbachs', 'Ro', 'Schweiberg', 'Brienz Kirchhreu', 'Lungernsee', 'Altenberghhe', 'Weinm', 'Alphhe', 'Kuttlenbad', 'Enz Enzberg', 'Steg-Lindach', 'Stcinberg', 'Gltsch', 'Querstrae', 'Ortelengrat', 'Ningol', 'Hochwart', 'Guntcn', 'Ltschenberg', 'Boden', 'Brnnen urk', 'Nderswyl', 'Whl', 'Geilbach', 'Thunerstrae', 'Hirschgraben', 'Grdelisberg', 'Thrishaus', 'Lieben', 'Blasen', 'Franoz', 'Gowyl', 'Amsoltingen', '- burg', '- navien', 'Obegg', 'Gltschbad', 'Engewald', 'Bttingen', 'Engstlerjoch', 'Neuenfchwand', 'Brriswald', '- und Nieder-Simmen', 'Kroschenbrunnen', 'Schwar', 'Meridian', 'B', '- holz', 'HirSbrunner', 'Breitlauenenalp', 'Moser', 'Neckhollern', 'Uechtlande', 'Rdcrswyl', 'Regsau-Schachen', 'Brchbhl', 'Vrsbach', 'Jsenbollingen', 'Grnen', 'Landsitz', 'Suberg', 'Reckenbhl', 'Zrcherkrieg', 'Landstr', 'Giltstein', 'Tschppbach', 'Wirth', 'Landstrae', 'Nm', 'Werkhof', 'Gilb ach', 'Ramsperg', 'Jochberg', 'Nov', 'Seenfer', 'Drrenwald', 'Brning', 'Vnrgdorf', 'oberer Niesen', 'Scheunen', 'Enzen', 'Ltschenenthal', 'Brglen', 'Hcrbligen', 'St. Gotthard', 'Wascn', 'Bietingen', 'Ziehl', 'Auerbach', 'Erl', '- Oltigen', 'Twrenbach', '- gen', 'Grindelwald-EiSmeer', 'Breuw nrk', 'Seelhofen', 'Gauwli', 'Frb', 'Khliwyl', 'Egglibergen', 'Olten-Strae', '- Ramsern', 'Topp', 'Mlenens', 'Herrenbrunnen', '- burgersee', 'Thl', 'Seematt', 'Srvsnckon', 'Almend', 'Oberei', '- tingeu', 'Kabisberg', 'Scedorf', 'Wynigcn', 'Fahrbhlgasse', 'Muristalden', 'Grfisberg', 'Oberricd', 'St. Solothnrn', 'Negsau', 'Haslebrck-Uetigenstrae', 'Namsli', '- bhl', 'Regsauschachcn', 'Hchlisbhl', 'Grindelwaldth', 'Prassen', 'Lternen', 'Schernolz', '- und Unter-Gurbs Gurbsgrat', '- wylersee', 'Schlegelholz', 'Rtschelen', 'Lcnzligen', 'Bern-Lnzernstr', 'Engibach', 'Kal', 'Ober-Bipp nw', 'Drligen', 'Nydegg-Brcke', 'Ober-Diesbach', 'Solothurus', 'Alpscheli', 'Thoracker', 'Ltschenth', 'Leimbrck', 'Saxetenbach', 'Hubel', 'Zwetltschinen', 'Bolligerburg', '- und Ober - Obernz', 'Brfischenhaus', 'Schaafegg', 'Ober-Bucrt', 'Bttscheleck', 'Kriechenwyl', 'Nhnk', 'Bach-Grindel', 'Gasth', 'Hinter-Kienthal', 'Klein-Gmmenen', 'Mrrenbachs', 'Rderswyl', 'Gro-Viertel', 'Nieder-Lindach', 'Heutlingen', 'Sigristhof', 'Grthlis', 'Zhringen', 'Brtschi', 'Route', 'Grncnberg', 'Jffighorn', 'Fuetcr', '- Drfch', 'Gmligenthal', 'Luxus', 'Ormond', 'Klein-Erlenbach', 'Nieder-Btzberg', 'Lotus', 'Corbrn', 'O.', 'Gadmeuthal', 'Riederenhubel', 'Strt', 'Erbs', 'Gtschmannsried', 'Schnen-Frowen-Glein', 'Brstenegg', 'Khberg', 'Klenthal', 'Ober-Aarhorns', 'Nnterwalden', 'Kirchcnwesen', 'Sels', 'LoinnMn', 'Blutthurm', 'Waiden', 'Neggisbcrg', 'Kpfcr', 'Herzogenhaus', 'Wartenberggraben', 'Vinclz', 'Torfgasse', 'Buch', 'Daubenhorn', 'Schwbis', '- derswyl', '- bchlein', 'Glarns', 'Guglerkrieg', 'Lchli', 'Arnenbcrg', 'Th', 'Amsoldinge', 'Lyach', 'Schpf', 'Saxeten', 'Ezelkofen', 'Melchenbhl', 'Vlligen-Krauchthal', 'rfch', 'Msern', 'Khn', 'Negsbach', 'Walterswylhof', 'Bahlisalp', 'Glysi', 'Gmmencn', 'Chrinnenberg', 'Vierwaldstttersee', 'Nieder-Emmenthal', 'Blumenstcin', 'Lvlothur', '- Ly', 'Nubaum', 'Kir', 'Schafalp', 'Ber', 'Tessekon', 'Ksltonbrunnon', 'Frutigbad', 'Adrians', 'Roscnlauegletscher', '- wald', 'St. Bern der Murtenstr', 'Wiesenlaud', 'Wynigen-Brcke', 'Egadi', 'Brunnmhlebach', 'Mlincn-Gurowski', 'Engt-Halbinsel', 'Enziberg', 'Gnggisberg', 'Steck', 'Gro', 'Trub.', 'Jsenbolgen', 'ettenbergs', 'Bechlen', '- bach', 'Grebern', 'Gohl', 'Bschenried', 'Ltzschenthal', 'St. Unterheid', 'Mhli', 'Brisbach', 'Kohlhaus', 'Aeschiberg', 'Br', 'Hessenhof', 'Std nordwestl', 'Inner', 'Tachnaglercngraben', 'Hemlismatt Emlismatt', 'Lanterbrnnnen', 'Eschibach', 'Murren', 'Lauter-Aarhorn', 'Frittenbach-Scha', 'Thunstrae', 'Bohlseiten', 'Ginn', 'Dieenberg', '- Rausch-Bach', 'Mnsterplatz', 'Scheid egg', 'Bricnz', 'Klein-Burgund', 'Tbdingen', 'Lammbachs', 'Berchtold', '- renroth', '- sching', 'Kern', 'Liebi', 'Tonnerbhl', 'Asra', 'Gentelbach-Brcke', 'Bcttelried', 'Durgdorf', 'Btikofen', 'StP', 'Schrcckenbrunnengasse', 'Turbach-Th', 'Bttlassenhorn', 'St. Signau', 'Hundbhl', 'Pas Pfarrdorf', 'Nanflh-Vicrtel', 'Meyenbach', 'Krauckthal', 'Oefch', 'Ilassleo', 'Seusebez', 'Notenburg', 'Btzberg', 'St. Johaunsen', 'Zsenberg', 'Oberbofen', 'Lind', 'Oye', 'Blsch', 'St. Murten', '- derschrinde', 'Vlliz', 'Hgli', 'Reulissen', 'Hardcrn', 'Hochburg', 'Bhnlin', 'Dicbach', 'Ruland', 'Bren-Effinger', 'Roth-Bezirk', 'Weiensteinhlzli', 'Psarrd', 'Herzogennchsee', 'Kyburz', 'Gum', 'Schiltbach', 'Std Twann', 'Oeler', 'Bnnkhoffen', 'Kirgeli', 'hl', 'Rderichsboden', 'Stettlers', 'Ninkenberg', 'Langengletscher', 'Gsteig-B', 'Lurgund', 'Maron', 'Latreienbach', 'Utziugen', 'Habeggcr', '- Barheggen', 'Rothenfluo', 'Grnen Burgbhl', 'Iobann', 'Engen', 'Senn', 'Gchliwyl', 'Rubig', 'Kuiz', 'Tessikofcn', 'Ooenctork', '- bach-Lindenstr', '- Aarhorns', 'St. Johannscnhaus', 'Dinkelmann', 'Krattiggraben', 'Rothstaldcnhof', 'Wthrich', 'O. - Dorf', 'Gro-Dietwyl', '- wyl', 'Kirchlinda', '- storf', '- Matten', 'Mrchen', 'Bodezen', 'Drrethan', 'Thormann', 'Bhlhof', 'Eggerdingen', 'Etzelkoven', 'Klein-Roth', 'Gynaufluh', 'Wrzbrunnen', 'Cappelen', 'Allmis', 'Lonsdorf', 'Ober-Diebach', 'Obersbach', 'Hinter-Dessikofen', 'Blasenhorn', 'Bietenwyl', 'Alpenreisen', 'Eoldbach', 'Scherzligen', 'Mungnau', 'Frittenbach-4l', 'Schlueb', 'Oossoim', 'Nenhans', 'Sgiez', 'Aeschau', 'Secdorf', 'Wangen Bachalp', 'Haus', 'Spietz', 'St. Schangnau', 'Mors', 'Nawylhorn', 'Schachen', 'Oberfeld', 'Kalkstein', 'Leuenbergers', 'Tttlingen', 'Thorbcrg', 'Ltzell', 'thal', 'Arni-Drittel', 'Weienstein', 'Btschifluh', 'Lolothurn', 'Mitthvlz', 'Ostermundigen-Worbstrae', 'Oberey', 'St. Jakob', 'Chasseral', 'Simon', '- telbach', 'Madrcisch', 'Lnsperg', 'Lattrigen', 'Lwenberg', 'Brchershuscrn', 'Brandsch-Vicrtel', '- buchsee', 'StA Albrist', 'Stdelhorn', 'Hindcnlang', 'Merzligerr', 'Trogen', 'Almendingen', 'Lnterkofen', 'Bad Uetendorfberg', 'St. Jvhannsen', '- senlaui', 'Zihlmatt', '- Bigelberg Biglenberg', 'Gtlisperg', 'Scharmachthal', '- nau', 'Bunschen', 'Kypbcrg', 'Schwarzsee freiburg', 'Dieboldshausen', 'Burgundern', 'Tyrol', 'Schloli', 'Vorberg', 'Neumhle', '- Briswyl', 'Hegebach', 'Tachsselden', 'Affenthal', 'Beir', 'Gsteigthal', 'Mrkte', 'Janzenhusen', 'Nblihorn', 'Wysttthorn', 'Franken', 'Mhliberg', 'Pfarrd Mhleberg', 'Ochtland', '- Schlli', 'Habbach', 'Burgener', 'Valdratzstal', 'StockhornKB', 'Gysenstein-4l', 'Palmegg', 'Hhnerbach-Viertel', 'Oeuiswyl', 'Lgenbach', 'Gyuch', 'Schmutz', 'Trachsel', 'Rtzliberg', 'alt-Statth', 'Mohr', 'Magnesia', 'Blle', 'Juden', 'Mengen', 'Brggelbach', 'Kosthofcn', 'Matten', 'Erlengebsch', 'Kellerhals', 'Hasleth', 'Salvisperg', 'Kurzen', 'Gtch', 'Sury', 'Menigberg', 'Kanderbrgg', 'Alpenros', 'Ns.', 'Jezikofen', 'Egghlzli', 'Bhl', 'Vogt', 'Langhaus', 'Speichingen', 'Lohmatt', 'Aanderbrgg', 'Almen', 'Gmlingen', 'Laupcn', 'Gool', 'Tannenbhl', 'Grawyl', 'Gerberengraben', 'Bleuen', 'Wiedlis', 'Wsemli', 'Obcrhofen', 'Kieno', 'Thring', 'Tbnnersee', 'VuItinMa', 'Reichend ach', 'Trrbach', '- horns', 'Theiswyl', 'Ev', 'Nieder-Oesch', 'Elblingen', 'Sulz urk', 'Weienburgba', 'Brg', 'Lengenbhl', '- Heimwesen', 'Wstethal', 'Unter-Diebach', 'Dentcnberg', 'Ltsckinc', 'Srenberg', 'Sommeran', 'Diebach', 'Rnmisberg', 'Zelg', 'Oltingen-Neuenburg', 'Marpach Marbach', 'Ober-Hohlen', 'Bietzwyl', 'Btschel', 'Nydau', 'Mntschemicr', 'Barschwand - schwand', 'Mnchringen', 'Ar-ara', 'Bnndcrbach', 'Adelsbhl', 'Grbe', 'Unter-Wstenbach', 'Mnchen', 'Mniggrund', 'Lanz', 'Tnishaus', 'Jsgenstorf', 'Mnslngen', 'Walliswhl', 'Telli', 'urk Gastron', 'ZHvald', '- platzgasse', '- kette', 'Jaussi', 'Dorsmarch', 'Ebni', 'Rndera', 'Krrchlindach', 'S-tdn', 'Ligriz', 'Fcldmann', 'Lochenberg', 'Stigelb', 'Gram', 'Unter-Goldbach', 'Mtschwyl', 'Gypsmhle', 'Altengrat', 'Seelandes', 'Tei', 'Sanbergbach', 'Ptschel', 'Bclpberg', 'Urtenenbach', 'Nthenbach', 'Niederdorf', 'Aettikofen', 'Ober-Simmeuthal', 'Aner-Latterbach', 'Laubcck', 'Greub', 'Adlembhl', 'Frieslihaus', '- bergs', 'Lngenbhl', 'Langem', 'Saxe', 'Neleren-4l', 'Haller', 'Muristaldcn', 'Zaun', 'Baselstrae', 'Scheidegg Wengenalp', 'Bucholterberg', 'Brgg', 'Eschau', 'Thun, ', 'Kummer', 'Mittannen', 'Ausland', 'St. Niklaus', 'Verona', 'St. Colombes', 'Aeschiegg', 'Sagiweidli', 'Mediatland', 'Rickli', 'Grimmen', 'Litschenen', 'Grn egg', 'Zyet', 'Tannenb', '- Bern', 'Buchensteg', 'Weissenau', 'Giegisperg', 'DettenLhl', 'Nidflh', '- zogenbuchsee', 'Sandackcr', 'Nrban', 'Luternan', 'Mauer', 'Huslimoos', 'Kisen', 'Buchseemoor', 'Tettnang', 'Rplisried', 'Jann', 'Kunidsy', 'Thurm', 'Wynigenthal', 'Opclingen', 'Bnberg', 'Ulfingen', 'Moos-Seedorf', 'Rllisen', 'St. Enswyl', 'Bielersees', 'U', 'Osterstein', 'Rthihorn', 'Hrnberg', 'Wyler-Oltigen', '- dach', 'Schau', 'Altenberg-Viertel', 'Viaca Taf', 'Schwarzhusern', 'Marggi', 'Ober-Stocken', 'Eisenerz', 'Gundiswyl', 'Werdthfe', 'Nu Mhleth', 'oberer', 'Gsgeu', 'Brummbach', 'Rwethal', 'Dornegg', 'Drrenwaldberg', 'Burdollf', 'Scheidgassen', 'Lluvvlozwos', 'Dicmtigthal', 'LauperSwyl-Viertel', 'Biglcn', 'Unterwalden-Obw', 'Jagdbnrg', 'Navensburg', 'Hh', 'Freiburgerstrae', 'Sd', 'Brach', 'Kpburg', 'Engstligenbrcke', 'Klsterlein', 'Agassi', 'Be', 'Oenz Seeberg', 'Schlienberg', 'Schlodomi', 'Vine franz', 'Nieder-Wirtneren', 'Bzingen', 'Klusenbach', 'Grorath', 'Jnterlakner', 'Olden', 'Doracher', 'Ellenwyl', 'Opelingen', '- Rothbachs', '- land', 'St. Vineenz', 'Wiedertufer', 'Ober-Laueuen', 'Reggis', 'Nydeckbrckc', 'Lidwn', 'Colombes', 'Nieseten', 'Tufbach', 'Kirchb erg', 'St. Johann', 'Hirzenfeld', 'R', 'Fera', 'Landger', 'Rhnkhofen', 'Lochbach-Bad', 'Ablndschen', 'Schlobergs', 'Halerberg', 'Grbenmoos', 'Storr', 'Pletsch', 'Sdel', 'Regensburg', 'Thuns', 'Frutingen', 'Rthenbach-Sdernstr', 'Ramsei', 'Nieder-Scherli Schcrlibach', 'Mnchcnbuchsee', '- Oenz', 'Juchli', 'Tschertschis', 'Helvetica', 'Alchenflh', 'Burgunden', 'Moeschler', 'Feutersoy-Be', 'Hinter-Kicnthal', 'Ntols', '- gebirgen', 'Bielerseestrae', 'Prm', 'Rcgsegg', 'Hhnerbach', 'Friesenberg-Neuhaus', 'Rap', '- lenbach', 'Thdin', 'Geils', 'Haslebach', 'Ober-Wichtrach', 'Schar', '- Twann', 'Belmnnd', 'Krummeneck', 'Schpbergs', 'Obstberg', 'Hcrzogen', 'Gegisberg', 'Ochle berg', 'Sigriswylgrat', 'Bhnli', 'Kandcrbriigg', 'Ballenbhl', 'Petronella', 'Unter-Wynau', 'Gltschbachs', 'Bad Std', 'Ghrnberg', 'Adelgoo', 'Scheidgasse', 'Chateau', 'Heinemann', 'Ltschine', 'Frutigstrae', 'Krinnenalp', 'Niederdorf-Viertel', 'Vil', 'Schaub', 'Mschlcr', 'Glcknerthor', 'Mnsperg', 'Bundesrathhaus', 'Schlipfen', 'Lngga', 'Mett', 'Dannenbhl', 'Hinter-Habchegg', 'Brgleu', 'Bchlisbach', '- Staldenstr', 'Grv-Viertel', '- Rdligerwald', 'Glstschhorn', 'lumen', 'Moosbad', 'Auer-Latterbach', 'Jscher', 'Guttauuen', 'Hnni Jak', 'Ly', 'Gromann', 'Stern enberg', 'Wohnhsrn', 'St. Leerau', 'Groaffoltcrn', 'Maa', 'Vechburg', 'Blwestatt', 'Jffi-zenthal', '- Schwarzenbach', 'Kronburg', 'Gorgen', 'Wildeneybad Bad', 'Heloetia', 'Vrandis', 'Wyenbach', '- Hunzikenbrcke', 'Kirchg', 'Erlcnbach', 'Jntzi', 'Barrakenrain', 'Hammerschmied', 'Mnchegg', 'Althaus', 'Str Ltzelflh', 'Schaffhauscn', 'Prs', 'Bren', 'Schwarzwaffer', 'Beaten', 'Drfch', 'Holzhalb', 'Flsch', 'Oppligcn', 'Lngenthal', 'Achsitberg', 'Ober-Gurzelen', 'Kalchnach', 'Kirchen seid', 'Niederhusern', 'Mathys', 'Alfermo', 'Rohrbachgraben', 'Erlisbach', 'Einsiedl', 'Zumbach', 'Aufgau', 'Gerbe', 'Liebiwyl', 'Schallenberg-Wald', 'Aetzlischwand', 'Winkel', 'Ziegelried', 'Waldkirchen', 'Grischbach', 'Kiencr', 'St. Hochthal', 'Bachwyl', 'M-eli', 'Ndispach', 'Bettenhansen', 'Oeschibach', '- Otzenberg', 'Marcuard', 'Groschneit', 'Bttlosa', 'Grindclwald', 'Frutigerstrae', 'Drrsee', 'Byfang', 'Brnigpa', 'Bnchsee-Reg', 'Rdcrswpl', '- perlublein', 'Ksershaus', 'Bern-Kapitel', 'Romang', '- stgen', 'Galliern', 'Poschenried', 'Tschentcnthal', 'Namscrn', '- Frisching', 'Hcidbhl', 'Nikl', 'Sulgenbachs', 'Frthen', 'Riedsttt', 'Unterdorf', 'Jsely', 'Glissen', 'Enzcn', 'Oberwallis.', 'Bromb', 'Salz', 'Melchuau', '- Nain', 'Nieder-Siebenthal', 'Oppligen-Berglein', 'Ziegler', 'Hnenberg', 'Siuermxou', 'Brunnmhle', 'Kilchschwanden', 'Gopplismatt', 'Wydc', 'Kolchosen', 'Perrot', 'Dingsttten', 'Unt.', 'Thcol', 'Martig', 'Unter-D iebach', 'Blanalp', 'Nieder-Balm', 'Kie', 'Wintermatt', 'Bourgeois', 'Bibereu', 'Drligbachs', 'Kaseren', 'Aeschlimann', 'nberg', 'Vttlosa', 'Gummalp', 'Klapperplatz', 'Bualp', 'Kunz', 'Rysfersegg', 'demWorb', 'Stauden', 'Lilvort', 'Bchlen', 'Jansbach', 'Neudruck', 'Saumstrae', 'Saanebrcke', 'Ob.', 'Mnringen', 'Buchseemoors', 'Goliwyl', '- Lanencn - Gsteig-Thal', 'Drr', 'Llisberg', 'Vrggfeld', 'Drlig', 'Wrl', 'eckenmatt', '- laui', 'Klara', 'Lubbach', 'Birch', 'Mllinen', 'Mrisried', 'Ladenwand', '- slh', 'Schatt', 'Grbenbach', 'Gerber', 'Toldenhorn', 'Wvnau', 'Tnrbach', '- Untcrhards', 'Rauchenbhl', 'Brunbach', 'Balderstal', 'Vincenzenstist', 'Tiebachgraben', 'Uusslev', 'Schtzenmatt', 'Thunstctten', 'Spiezmoos', 'Bieter see', 'Brckfeld', 'Jnu er-Emdthal', 'St. Frienisberg', 'Hueben', 'Knitzberg', 'Drstetten', 'Bri enz', 'Alt', 'Grvrath', 'Uelisbrunnen', 'Eigstein', 'Lutstorf', '- fingcn', 'Mrigen', '- seau', 'Gnnten', 'Rthcnbach', 'Reu', 'Jffingenth', 'St. Bern', 'Bern.', 'Ltschenen', 'Gggisberg', 'Ober-Aarg', 'Geltenhorn', 'Entsch', 'Geren stein', 'Scknegg', 'Innert', 'Schachen-Viertel', 'Schppach', 'Nrnberg', 'Bachsee', 'Wigisperg', 'Pletschen', 'St. Oswald', 'Miescher', 'Bndihorn', 'Engstligen-Thal', 'Elfenauw', 'Heinr Buchegg', 'Brunner Alb', 'Aergw', 'Erlenbacb', 'selwald', 'Gantersberg', 'Kiltbhlhof', 'Obersteckhvlz', 'Bracher Bend', 'Zollikofen-Moosseedorfstr', 'Bund', 'Runs', 'Wurstemberger', 'Saaner-Wald', 'Oltin', 'Allmen', 'Farn', 'Gran egg', 'Lybachthal', 'Brigdelen', 'Schyuen', 'Jucharten', 'Bremgartcn', 'Dali', 'Gupersmhle', '- husi', 'Glowyl', 'Buchholderberg', '- Herzogenbuchsee', 'Nitzbach', 'Wolfg', 'LarriborZ', 'Kehrli', 'Rufer', 'Hohbalm', 'Heidenstatt', 'Bderegg', 'Jak', 'Laudmarch', 'Eflingen', 'Hni', 'Gollaten', 'Oberlndern', 'Wohleyberg', 'Niederdors', 'Wicdlisbach', 'Luls', 'er-Diebach', 'Egkstein', 'Hasel Tha', '- Schwand', 'BndIey', 'Seehofen', 'Bncheggi', 'Grbcn', 'Imlrin', 'Orbacb', 'Kiberg', 'Teuffenbach', 'Lehier', 'Frittenbach-Viertel', 'Vinzenzenstift', 'Holligeustrae', 'Brnigs', 'Vroburg', 'Instisthal', 'Negot', 'Gro-Mhleberg', 'Gryach', 'Lemibrgg', 'Rtihof', 'Eriswpl', 'Bolzisberg', 'Steinegger', 'Spins', 'Torfmoor', '- Unter-G ostel', 'Gerstenhorn', 'Zollikofeu', 'Mttiwpl', 'Kienthalfurgge', 'Nieder-Mnhleren', 'Austrasien', 'Bayern', 'Rppli', 'Paradies', 'Rosenlaui', 'Dav', 'Ltschinen', 'Kraylingen', 'Rawylpa', '- berg', 'Weinstegen', 'Kappelenbad', 'Hasli-Scheideck', 'Schwefelkiese', 'Schpbach', 'Schup', 'Stockhorus', 'Zuzwyl', 'Bntscheleck', 'Duchholz', 'Ansol', 'Klein-Basel', 'Krystalle', 'Schalunen', 'Schuposen', 'Littcwyl', 'Ghiirn', 'Wachteldorn', 'Rieder', 'Klsterli', 'Grnenbachs', 'Tschingelgl', 'Graburg', 'Zwischenflh', 'Suls', 'Ipos', 'Tuffelen', 'Axalp', 'Gsteigwyler', 'Hegspach', 'Win', 'Hlzli', '- perg', 'Egg-Viertel', 'Kanderffeg', 'Ghrn-Mertel', 'Egg', '- wyler', 'Weienburg-Bad', 'Gersperg', 'Ober-Simmenthal', 'Hellsttt', 'Balmhor', 'Lngmoos', 'Gnlialp', 'LtvOItz', 'Schwaben', 'Gsnhorn', 'Langentan', 'Urnerland', '- und Klein-Wabern', 'Frnttaria', 'Schaufelbhl', 'Spiegelberg', 'Freyburgerstr', 'Rothberg', 'Gilbach-Bnert', 'Oberschnegg', 'Murtnerthor', 'Khbnrg', 'Kriesbaumen', 'Giesingen', 'Unter-Urbach', 'Tuftstein', '- Hinter-Birchbhl', 'Emmen-Viertel', 'Lschcrz', 'Kaltenherberg', 'Mzlenberg', 'Dietenwald', 'Rucf', 'Httlingen', 'Emmenthaler-Kse', '- Goldbach', 'Kolchenthal', '- brunnen', 'Michaelsinsel', 'Nieder-Bipp', 'Sattelegg', 'Oberbren', 'Ottelbad', 'Brspach', 'Burrach', '- Pfarrdorf', 'Wstisth', 'Jnkwylsee', 'Geltenberg', 'Gole', 'Tittlingen', 'Willading', 'Wohng', 'Teufelsburg', 'Bubcnga', 'Simmenthalstr', 'Kser', 'Pfd', 'Amseldi', 'Lenxingen', 'Kvburg-Habsburg', 'Reg', 'Oeschinensee', 'Jnterlakenhaus', '- Simmenth', 'Grb', 'Goldenmattgasse', 'Rickersholz', 'Aaruser', 'Th.', 'Weienbach', 'Eichihfe', 'Leiternpfad', 'Buntschibad', 'Lau', 'Alaunquellen', 'nrk', 'Flschberg', '- Oesch', 'Kypberg', 'Scherli', 'Grast brg', 'Echenbhl', 'Nadelfing', 'Kantons', 'Fischezen', 'Brunnadern-Viertel', 'Schlli', 'Bnmbach', 'Oktob', 'St. Beatenloch', 'Oberholz', 'Madiwyl', 'Hulenthal', 'obern Hard', 'Affolter', 'Scheidwaldbez', 'Aarinscl', '- Brchegen', 'Unter', 'Krhenbhl', 'Seide', '- moos', 'Lammerhorn', 'Birchlauenen', 'Bramergs', 'Schmidigen', 'Herrenmatt', 'Maria', 'Allmenden', 'Berg-Bezirk', 'Snisbcrg', 'Bergdorfe Mrreu', 'Khrechten', 'Schlowyl', 'Schenkelgasse', 'Mllenberg', 'Ellenberg', 'Ortsch', 'Aek', 'Engstligengrund', 'Gletscher', 'Bockigen', 'Redisbach', 'Zbinden', 'Bren Burk', 'Weihorn', 'Wcrdthvf', 'Amtsweibel', 'Hrlisegg', '- Habkerenthal', 'Obcrburg', 'Grtter', 'Schwan', 'Schohalden', 'Gro-Affoltern', 'Rdeli', 'Vaumgarten', 'Drfchen', '- see', 'Matzenried', 'Arburg', 'Heigers-Geisberg', 'Schwab', 'inertenhorn', 'obern Schtte', 'Turbachs', 'Stcuri', 'Neubrck', 'Ober-Steckholz', 'St. Neuenburg', 'Hun', 'Rotenflue', 'Gallenstock', 'Grbeu', 'Schumacher', 'Valmeck', 'Otmarsiugen', '- der-Simmenthal', '- lanei', 'Bern Emmenthal St. Bern', 'Simmeuthal', 'Ober-Eichi', 'Mari', 'Bissen', 'Fctschcrin', 'Ringoltingen', 'Netschi', '- Klein', 'Nychigen', 'Alberstberg', 'Aenetbach', 'Priesen', 'Ober-Placken', 'Ueblenberg', 'Mauergraben', 'St. uzen', 'Betigen', '- Nieder - Hinterdorf', 'Gmligen', 'Thrigen-Oberd', 'Word', 'Grbethal', 'Krayigen', 'Saffoltern', 'Banmoos', 'Renhans', 'Holligen-Viertel', 'Borste', 'Mnthal', 'Neust', 'Berueru', 'Freudenreich', 'Brunnenbachbad', 'Unterfluh', 'Jnterlakcn', 'ach', 'Bdelein', 'Silleren', 'Tuftbach', 'Lthi', 'Nessenthal-Sge', 'Brgglindach', 'Mnstngen', 'Lutsch', 'Vurgbhl', 'Landsturin', 'Wimmenowa', 'Dttenberg', 'Laueneuhoru', 'Tscheppbach', 'Oossengx', 'Schmidengasse', 'Gontcn', 'Auer-Birr', 'Laugeustein', 'Namstein', 'Schauspielhaus', 'Schuppose', 'Beatcnberg', 'Frei - bnrg', 'Arm', 'Ksershof', 'Rnmedingen', 'Strlcr', 'Greyach', 'Geisberger', 'Bechlinen', 'Weienberghorn', 'Becher', 'Sphlibachs', 'Srihubel', 'Jnncrschwand', 'Ksershaushof', 'Gltschbach', 'Freiburgisch-Ferenbalm', '- urk', 'Gstad', 'Nudenz', 'Alpenpsad', 'Oblingen', 'Mlinens', 'Laudiswyl-Bezirk', 'Schlo', 'Bantiger', 'Hohwrz', 'Bad-Weiler', 'Griechwyl', 'Gutmannshaus', 'Grndenhof', 'Weibel', 'Efsinger', 'Bergdorf', 'Stuhl egg', 'Mnsingcn', '- kirch', 'Rahnflh', 'Bruchenbhl', 'Galliten', 'Sondersiechen', 'Hegen', 'Vincenzcnstift', 'Oent', 'Gatzenried', 'Hopfern-Neuhaus', 'Ringoldingen', 'Detigenwald', 'Blumensteinerbad', 'Hgspach', 'Wattenwpl', 'Torfbach', 'Pfarrd orf', 'Gmnmenen', 'Walther', 'Signau Eggiwyl', 'Murifeld', 'Allemann', 'WiedliSbach', 'Schwarzeneck-Erizstrae', 'Bnrgbhl', 'Alteich', 'Auer-Emdthal', 'Herzwhl', 'Seeddrs', 'Riedlisperg', 'otthard', 'Wrgisthal', 'Bualpbach', 'Schorren-4l', 'Kridey', 'Radelsingcn', '- genbuchsee', 'Johannsenhaus', 'Ninderwald', 'Nieder-Goldbach', 'Brenbach Bach', 'Lauterbrunncn', 'Ortbach', 'Rubismhle', 'Gempelen', 'Kriechwyl', 'Ober-Wynau', 'Torfmoos', 'Gottftadt', 'Grsisbergs', 'Laubholz', 'Witschn', '- Aargau', 'Murtenstrae', 'Werdt', 'Watteuwyl', 'Hiltolfingen', 'Uereini', 'Neugart', 'Btterich', 'Brandts-Kyburg', 'Aerlenbachbrcke', 'Bitlosa', 'RLthlisbergcr', 'Schngau', 'Mhlibach', 'Thdingen', 'Blttisbachs', 'Frzbach', 'Gfll', '- gisthal', 'Scheidcstrae', 'Brieuzerb', 'Rmlisberg', 'Erlispach', 'Wanchdorf', 'Wynigcr-Vcrtrag', 'Kirchenthurnen', 'Emmcnthal', 'Jtenberg', 'Blatter-Ried', 'Eyberg', 'Mrren', 'Nesson', 'Geisberg', 'wyl', 'Oenz Oenzfall', 'Glysibach', 'Wdischwhl', 'Grimselstrae', 'Wig', 'Gaset', 'Bafel', 'Gen', 'Schafberg', 'Lernn', '- gisberg', 'St. Johannsen', 'Leipzig', 'Voens', 'Grn', 'Rggisbcrg', 'Rubigen', 'Ltzeloll', 'Gaudard', 'Gurmels', 'Etzenwyl', 'Tscharner-Wurstemberger', 'Stav', 'Zyackerzelg', 'irk', '- dersteg', '- lhnrn', 'Blatten', 'Hubberg-4tel', '^-', 'Henzischwand', 'Stmpach', 'Eriswyl-Dorf', 'Rochliswyl', 'Jenny', 'Steffansfelden', 'Wytenberghorn', 'Buchs', 'Rumeudingen', 'Rhrb', 'Bttenberg', 'Tiefeuaubrcke', 'Agassizhorn', 'Kahenstein', 'Engstlerberge', 'Wange', 'Btenberg', '- Ursenbachs', 'Wald-Drittel', 'Luinmae', 'Doris', 'Engstligen-Grund', 'Jvh', 'Metzgern', 'Ryhiner', 'Thurn', 'Grvr', 'Vnchbach', 'Knizstrae', 'Gossen', 'Nydeckbrckgasse', 'St. Peters', 'Diessenhof', 'Secwyl', 'Schlo Justinger', 'Mhlithal', 'Rthen', 'Dinkelbhl', 'Chronikon', 'Nidauer', 'Winkle', 'Rormos', 'Mettenbergbrcke', 'Engstlenjoch', '- perswyl', 'Diebach Konolfingen', 'Ober-Wstenbach', 'Banmos', 'Falkenpltzli', 'Babschwand', 'Muristrae', 'Gzischwendi', 'Hellisbhl', 'Dchlibach', 'Kehrsatz', 'Gradlisberg', 'Sennhaus', 'Alpenwirtbsck', 'Lanzcnen', 'Torfstrae', 'Eastelstetten', 'St. Stephan', 'Krattingerhaus', 'Nfenacht', 'Blattenheid', 'Steffisbnrgl', 'Elseggen', 'Jttigcn', 'Bern Thun', 'Bangerter', 'Diesb ach', 'Rawylhorn', 'Oermuui', 'Goldbach-Farbschachenstrae', 'Allmendbezirk', 'HuSlimoos', '- holterberg', 'Bleicnbach', 'Nefsenthal', 'Bicrhbeli', 'Steinarten', 'Gerzensce', 'Berncrn', 'Balmos', 'Schlup', 'Nieder-Bleikcn', 'Seitenthal', 'Cuenin', 'Grnenmatt-Viertel', 'Untersteckholz', 'Trttlisberg', 'Jegenstors', 'Waltrigen-S', 'Rupprecht', 'Grner', 'Eu', 'Dinghof', 'Buchacker', 'Riprechtsgrat', 'Kenelthal', 'Emnienthal', 'Beitiwyl', 'Mnch', 'Freiburgstrae', 'Ghsen', 'Ltschenthal', 'Bren egg', 'Rodt', 'Klein-Hchstetten', 'Thun-Almeud', 'Thun-Allmend', 'Matti', 'Ostern', 'Ober-Dettigcn', 'Oberaar', 'Mhlestcttlenhof', '- lenberg', 'Pfaffenhorn', 'Daube', 'Ted', 'Aerlenbach', 'Blatte', 'Wyhrien', 'Rm', 'Hoffstetteuk', '- Otterbach', 'Negvtiant', 'Brschgengraben', 'Marbot', 'Uechtsee', 'Drligcn', 'GuggiSberg', 'Neucnstadt', 'Grohorn', 'Jakoben', 'Wengwald', 'Nawyl', 'Welschneuenburg', 'Laupen St.', 'Brnnen', 'Sgesscr', 'Mller', 'See', 'Schwarz', 'Btscheleck', 'Schnthal', 'Rehhaag', 'Stofselberg', 'Leuenberger', 'Glur', 'Rfenacht', 'Herzogenbuchsce', 'Tndengrat', 'Gtzistihl', 'Jeg enstorf', 'Knutti', 'Waggeumatt', 'Rthenbach', 'Marktort', 'Walpurgis', 'Nogget', 'Kaufhaus', 'Bonder', 'Sumislvld', '- lingen', 'Haldenmoos', 'Regsbach', 'Hirscrn', 'Grindelwald-Gletscher', 'urk stcnbach', 'Binzberg', 'Kirckberg', 'Unter-Dieach', 'Brumberg', 'Brandschbach', 'Ammertenth', 'Balmereck', '- schwendi', 'Twirgi', 'Kirchort', 'Lieb', 'Klaps', 'Nessenth Mhleth', 'Mutti', 'Tannenstr', 'Btzbergcr', 'Aeschbacher', 'Ehrom', 'Zeiningen', 'Gieblitz', 'Sauerbrunnen', 'Ger', 'Grsisberg', 'Biberach', 'Wanzenried', 'Barthol', 'Riegenen-Viertel', '- Bergthal', 'Tavel', 'Mlchi', 'Vnnalos', 'Muralt', 'Hlischwand', 'Tnn', 'Rapperswhl', 'Negs', 'Niederfultingen', 'Jucher', 'Bderberg', 'Affolternstrae', 'Lnotomviler', 'Schpbachdrittel', 'Btzingsn', 'Zwischenbach', '- Dettigen', 'Willenschwand', 'Rudolfs', 'Bietz', 'Brgglen', 'Hasli Regsau', 'Doenhorn', 'Chnmigalm', 'Thon', 'Rohrbachs', 'Berfi', 'Scheidegg Thalsch', 'Miinchenbuchsee', 'Sigenthaler', 'anstork', '- schinenthal', 'Hintereggen', 'Reisgrund', 'Mettenwyl', 'Oberdiebach', 'Bndley', 'Oppliger', '- tiugen', 'Obrecht', 'Michels-Jn', 'Aesch', 'Trubbnch', 'Knigsthal', 'Sachslen', 'Ltschberg', 'Franbrunnen', '- strae', 'Lsissigenbad', 'Urech', 'Twings', 'Aeschauberg', 'Seeli', 'Treiten', 'Nieder-Jbach', 'Riggisberg-Wyslisaustrae', 'Posto', 'Schwarzcnburg', 'Fischerdrfch', 'Zzi', 'Walterswvl', 'Alp Grindelwald', 'Schnholzer', 'Brnnlein', 'Wrgistabl', 'Bochti', 'Oyer', 'Rheinsalm', 'Teilenbrg', '- burg-Nidau', 'Briswhl', 'Bhmen', 'Spital', 'Berge', 'Oeschinenbach', 'Gerbern-Grabcn', 'Weid', 'Mrisegg', 'Schluep', 'Mnchringcn', 'Vienne', 'Kalberhhni', 'Veatenberg', 'Martinsgrat', 'Wyttenbach-Biertel', 'Alabaster', 'Bavweidli', 'Leonh', 'Enggistcin', 'Weicnau', 'Furggengtsch', 'Lugibach', 'Ottenleue', 'Balmeck', 'Tschndi', 'Wallisergr', 'Ltschithal', 'Schnenbhl', 'Janzcnhnns', 'Lnggasse', 'Jlfingen', 'Eblingen', 'Bdeli', 'Knitzstr', 'Guggishorn', 'Maricnthal', 'Mttenbach', 'Schwellen', 'Engt', 'Zosingen', 'Wegessen', 'Kaltenegg', 'Bettenalp', 'Nenenegg', 'Negotiant', 'Baselland', 'Emmenthaler-Furgg', 'Obcrbalm', 'Straberg', 'Leuen', 'Niedcr-Btzbcrg', 'Afflentschen', 'Obcrholz', 'Hau', 'Oberes Thun', 'Vurghgel', 'Peters-Insel', 'Schlvberg', 'Muhleren', 'Gyrizenmoos', 'Ober-Balm', 'Schwandi', 'Lngenbergstr', 'Kies', 'Gvhl', 'Wydenloch', 'Steinackern', 'Schanze', 'Gmmene', 'Stockorns', 'Briens', 'Bttiosa', 'Alcheufih', 'Rmlingen', 'Thunerstaldens', 'Neu-Landorf', 'Schwendi-Buert', 'Pfingsten', 'Tromelbach', 'Lanbegg-Zollstatt', 'Saaue', 'Linnach', 'Rcnfer', 'Hol', 'Htt', 'Gydisdors', 'Engelhruer', 'Netschbhl', 'Lock', 'Mau', 'StovensburK', '- berge', 'er-B', 'Hosen', 'Lobsigen', 'Gyps', 'Schweikhof', '- Blumenstein', 'Ankenwaag', '- bnrg', 'Rothacher', '- Grabenstrae', 'Thun Hilterfingen', 'Rudi', 'StA', 'Heltstttegg', 'Zwingelh', 'Lchligut', '- Wangen', 'Schleumen', 'Stnden', 'Banmgarten', 'Grt', 'Pltschbezirk', 'Kastelenhubel', 'Bizwhl', 'Frei', 'Ober - und Vurgiwyl', 'Schlle', 'Morier', 'Metzel', 'Riedbrg', 'Matte', 'Lerg', 'Brgistein', 'Ottichingen', 'Brselbach', 'Aettiswyl', 'Bnembach', 'Waldsberg', 'Mnfiugeu', '- - Alchistorf', 'Te Neuenstadt', 'Ulmitz', 'Schwarzen', 'Nyffel', 'Rutsch', 'Nicolai', 'Solothnrns', 'Leim', 'Barheg', 'Laupeu', 'Mnsters', 'Aetiger-Berg', 'Zusatz', 'Hub berg-4tcl', 'Nri', '- Abthl', 'Vilett', '- Bubenberg', 'Laupe', 'Gmmenen', '- bad', '- denbach', 'Zweiltschinen', 'Gugger', 'Seeufer', 'Tonisberg', 'Rfiswald', 'Twingherr', 'Pfarrd er-Wichtrach', 'Auer-Blumenstein', 'Mnchenstein', 'Cappele', 'Knitzthal', 'Grien', 'Mus', 'Lizernethal', 'Rnen', 'Thuner-Allmend', 'Wollhusen', 'Nieder - auch O. - und N. - Rohrbach', 'Obermuhlern', 'losn', 'Wrgisthalbach', 'Steinl', 'Bann', '- Gasternth', 'Milden', 'Wald-Xtklioltorn', 'Ober-Tiebach', '- derbrck', 'Lschthal', '- Btschel', 'Tschameri', 'Sternenberg.Das', 'Johannserhau', 'Gmligenthlchen', 'Clavalepres', 'Prstd', 'Mnchenbuchsce', 'Breitfelde', 'Eichenbhl', 'Roten', 'Geiser', 'Zmittenholz', 'Alchi', 'Mrwighorn', 'Bort', '- genbhl', 'berg', 'Asp', 'Weissenburgerbad', 'Rtinrain', 'Mhle', 'Stucky', 'Urk', 'Brggen', '- burg-Berg', 'eidegg', 'Huttwyler-Allment', 'Donnerbhl', 's.Oenz', 'Schloberg', 'Wcinstcgen', 'Oberstutz', 'Blei', '- posen', 'Khlewyl', 'Neu-Schweiz.', 'Drig', 'Obertoffen', 'Hhlisbhl', 'Mhlcberg', 'Thali', 'Feuters-Oey', 'Oberbnrg', 'Alpenseen', 'Konrad', 'Sefinenthal', 'Husergr', 'Schohaldenschlacht', 'Tffen', 'Galmitz', 'Alpschelen', 'Lhlisberg', 'Miieon', 'Palm', 'Ober-Aarjoch', '- Wynau', 'Mslithal', 'Egerdo ngasse', 'Bach', 'Arnisagen', 'Zihlbrcke', '- bachthlchen', 'Wilig', 'Oberer', 'Saage', 'Lchlibad', 'Heinzenschw', 'Opfingen', 'Btteualp', 'Lligen', 'Alp Trachselwald', 'St. Hnbberg', 'MoSmann', 'Alpschelcn', 'GoMwyl', 'Icgenstorf', 'Podagra', 'Ghrn', 'Ravcnsburg', 'Graneggstutz', 'Maus', 'Aar Illiswyl', 'Sani', 'Lng', 'Omnp', 'Wyttenbachgraben', 'Moos-Affolternwald', 'Mittaghorn', 'Langenthaler-B', 'Bchtelen', 'Klingenberg', 'Ringgis', 'Gallentag', 'Erdpech', 'Schattenhalb', 'Neueneckau', 'Drstettcn', 'Fermel', 'St. Bad', 'Klein-Mhleberg', 'Ouolm', 'Hchstetten', 'Mhledorf', 'Herzvgenbuchsee', 'Lthy', 'Twrenbachgraben', '- Schernelz', 'Neustrien', 'Ptschol', 'Stampach', 'Mz', 'Zulligenhof', 'Bmpliz', 'St.', 'Hiltbrunner', 'Rschmaad', '- tenbvrA', 'Chablais-Moos', '- gletscher', 'Kunstsaal', 'Trtlisberg', 'Wybach', 'Offenburg', 'Reitbahn', 'Mllen', 'Pestilenzen', 'Hoher', 'Buchiberg', 'Steiger', 'Mhlbachs', 'Urwylhof', 'Zollenkofen', 'Adelbodenthl', 'Kalluach', 'Walde', '- O Aarberg', 'Widderfeld', 'Aspibad', 'Gysnaufluh', 'Backalp', 'Kirchegg', 'Breu', 'Klein-Dietwyl', 'Kuratli', 'Neu-Bubenberg', 'Scsterzligbrcke', 'Kehrsatzbach', 'Hellftttegg', 'Kirchberg-Emmenbrcke', 'Niggis', 'Gisferhorn', 'S.idelhorn', 'Das idau', 'Habsburg-Kyburg', 'Hinterburghorn', 'Mnchenbuchfee', 'UZissclorl', 'Mnsingen', 'Lntschinen', 'Kvsthofcn', 'Brris', 'Aarganerstrae', 'Sense', 'Gloswyl', 'Klein-Roth Langeuthal', 'Mhlheim', 'Rdispach', 'Bnchholterberg', 'Lobl', 'Stcffisbnrg', 'Brne', 'Roalp', 'Mlineu', 'Pest', '- ried', 'Sehohalden-Viertel', 'Ltzelflh', 'Ober-Aarhorn', 'Aarziele-Rain', 'Tiebach', 'Unter-Aargan', 'Sumis', '- Radelfingenstr', 'StA Allmend', 'Stauffer', 'Brswyl', 'Altholz', 'Karlen', 'Klein-Twann', 'Regsau', 'Schlo Sch', 'Zo', 'Thuner-Allmeud', 'SchwenLi', 'Rhoncthal', 'Sidel', 'Mhlidorf', 'Beriken', 'Lt', 'Groaffoltern', 'Friewyl', 'Obrist', 'StA Marchverbal', 'Elsigenalp', 'Frienisb', 'Martini', 'Grnhorn', 'Rschegg', 'srz', 'Erbetlaub', 'Pfaffenried', 'Rttihubel', 'Radcl', 'Schnbbl', 'Vhlfeld', 'Furggi', 'Schadan', '- und Nieder-Emmenthal', 'Ober-Lindach', 'Berken', 'Whnau', '8rmoim', 'Mhrenstub', 'Vilmergen', 'Henenschwand', 'St. tumbuok', 'Hinterdorf', 'Bergen', '- Mnch', '- tigen', 'Alferm', 'Kohli', 'Brispach', 'Zielibach', 'Ammerzwhl', 'Endorf', 'Tschudi', 'Reckenthal', 'Brienzer-Rothhorn', 'Mhlebacko', 'Walterswyl-Hof', 'Rthi Rthihof', 'Balmer', 'burg', 'Lanffen', 'Marmor', 'Neu', 'Olirenlingen', 'Bern-Thunstr', 'Steghorn', 'StM', '- gasse', 'Feren balm', 'Gadmensluh', 'Mineralbad', 'Marchgraben', 'Drettenhrnli', 'Lng waldes', 'Oesterreichs', 'Ochsen', 'Oranicn', 'Ober-Goldbach', 'Ninggis', 'Marpach', 'via stratn', 'Raine', 'Triftengletsch', 'May-von', '- graben', 'Jmmerthal', 'Hbernbad', 'Sitten', 'Beru', 'Fellistutz', 'Aenzen', 'Otzen', 'Palstina2', 'Brndlisegg', 'Eisenstein', 'Inncrtkirchen', '- pingen', 'Htaberg', 'Stcklein', 'Knno', 'Aarberger-Mooses', 'Nieder-Lindachwald', 'Viel', 'Brechbhler', 'Kum', 'Rbeldorf', 'Oestreich', 'Wyhony', 'Urban-Zofin', 'Elisried', '- thurn', 'Oberthor', 'Sulglaucneu', 'Dvrsfluh', 'Bder berg', 'Drlocherhvrn', 'Neuer', 'Hhcwcg', 'Palmos', 'Hannenmoos', 'Nieder-Gestelen', 'Gsterg', 'Htte', '- giswyl', 'Gundischwyl', 'Petri', 'Siegenthal', 'Dosel', 'Pfarrd Ringgenberg', 'Ried.', 'Drfch Hsrn', 'vrf', 'Abendbergwald', 'Wilderswhl', 'Drrmhle', 'Gto-Mhle', 'Berchtoldshof', 'Jnner-Birrmoos', 'Baumgarten', 'Mohren', 'Engi-Viertel', 'St. Lomannstag', 'Tbunstetten', 'Nabenthal', '- laken', 'b.Burgdorf', 'Fromberghorn', '- Murgenthal', 'Scywendi', 'Aemmer', 'Nncnflnh', 'Morsee', 'Ober-Bleiken', 'Trachsclwald', 'Tscheppach', 'Lnggavicrtcl', 'Oltschenen', 'Grispach', 'Riesen', 'Schauplatzgasse', 'Thu St.', 'Nuliork', 'Bonstettcn', 'Bau', 'Mrsperg', 'Abrah', 'Lopsingen', 'Wahleren', 'Mngistorf', 'Almisberg', 'Mufingen', '- Ob.', 'Neuenburg-Nidau', 'Ettiswyl', 'Lanbbach', 'Aechen', 'Bchi', '- haslethal', 'Hirsern', 'Gcrzcnsee', 'Hclgisried', 'Vincenzenstift', 'Trrenroth', 'Habsburg-Lauffenburg', 'Htnter-Fultigen', 'Ritschard', '- Simmenthal', 'Neubau', 'Gauli', 'Vnbenbach', 'vgl', 'Giebach', 'Kohofen', 'Eschenbach', 'Neuenberg', 'Fcrrenberg', 'St. Michael', 'Murgetcn', 'Nieder-Stocken', 'Kurzeneigraben', 'Refisberg', 'Bend', 'Btigkofen', 'Ober-Hoblen', '- Affoltern', 'Ridan', 'Schlachthaus', 'Kuhlauenen', 'Frutigenbad', 'Ober-Goldbach-B ezirk', 'Hangendhorn', 'Vlligen', 'Schnenberg', 'Michelsthrlein', 'Licbcfeld', 'Niedermuhlcrn', 'Jnter', 'Kloster-Buert', 'Zwischenbch', 'Geihubel', 'Baggwyl', 'Luegberg', 'Trmmletenthal', 'Ncsscnthal', 'IViclon', 'Arch', 'Enet', 'Kaufm', 'Bttenbergs', 'Nydeckbrcke', 'Thun Nenhaus', 'Bcnd', 'Hinter-Biembach', 'Bbel', 'Pestalozzi', 'Bttikou', 'Schoren-Almend', 'Nessen', 'Ly-Hindelbankstrae', '- wangen', '- Huttwyl', 'Mslin', 'Gronov', 'Ganzenberghos', 'Ltscherberg', 'Bellevne', 'Wurstembergers', 'Samuel', 'Grnegg', 'Wyachengraben', 'Aarzielethvr', 'Negenbolshorn', 'Bartol', 'Allm', 'Ranflh', 'Berner-Alpen', 'Mhren', 'Bellikofen', 'Lerchen', 'Klima', 'Laugnen', 'Schulthei', 'Vad', 'Jagberg', 'Erdharz', 'Jscl', 'Bnnd', 'Ncgotiant', 'Nitzberg', 'WiggiSwyl', 'Frntingen', 'Gottl', 'Enziberge', 'Neisiswyl', 'Oberburg-Gut', 'Grsisperg', 'Habsburg-Kybnrg', 'Hr', 'NdcrSwyl-Vicrtel', 'Auer-Birrmoos', 'Dinkel', 'Seefeld', 'Waitenwyl', 'Zeig', 'Marzielethor', 'Wahlenberg', 'Oberlin', '- schihorn', 'Merken', 'Teiwyl', 'Tiessenberg', 'Hitzig', 'nitz', 'Haslib erg', '- greis', '- Lindenthals', 'Notschalp', 'Ontolsporg', 'Rietwyl', 'Alb', 'Todtcntanzgasse', 'Brchli', 'Weisen', 'Hchstetteu', 'Teufenbach', 'Weicnburg', 'Fli', 'Berggrat', 'Kleiner', 'Tiefenaubriicke', 'Drienz', 'Ueten', 'Rufshusern', 'Bex', 'Bgl', 'Kuhweiden', 'Bez steig', 'Neuenstadt-Tessenbcrgstr', 'Rti'}",3954,"{'OberBipp', 'Gammcn', 'Bär Kreuz', 'Emmenthal Ober', 'ScheidwaldBezirk', 'Grbeufer', 'Roth Horn', 'Pfarrdorfe', 'Dettigen Bremgarten', '- Mhleberg', 'Brck', 'Kaltenbrunnen', 'Simmenth Turbachth', 'Niklaus', 'MngHH', 'Gra', 'Burgdorfer Münze', 'Grüuenbachs', 'UüttmAsn', 'Kriechstetten', 'weid', 'Hurselen', 'Wimmis N', 'Kappelen Hs', 'Nieder-Muhleren', 'VölligenKrauchthal', 'OhmgcldSbcamtr', 'Hannemoos', 'Grabenstrae', 'Alteiche', 'NiederSimmen', 'Bleierz', 'Burgdorfs', 'Der Stadtbach', 'Rdligcn', 'Lverach', 'Ober-Scherli', 'Grüncnberg', 'iTEinwohnergem', 'Psarrd Kerzers', 'Schwarzhorn Blauengletscher', 'Mrlingen', 'Llnioüonduoü', 'Belp Zimmerwald', 'St Jvhannsen', 'Armensacheu', 'Alaunschicser Thonschiefer', 'Lüilvüort', 'Finster-Aarhorns', 'Sann', 'Muri Gümligen', 'Flhlenstalden', 'Llossi', 'Trrenbach', 'Thalgraben', 'FinsterAarhorn', 'Oltingeu', 'FranceyBad', 'Moosseedorfsee', 'Stettlen Deißwul', 'Saxetcn', 'Unspunnen Palm', 'Safnern', 'Krschenbrunnen', 'Hauptstraße', 'Vannwyls', 'Urssubach', 'Stasel', 'Nüderswyl', 'Rohrbach Pfarrdorf', 'Löwen Mühle', 'Münsterplatz', 'Hirzenhalde', 'Kelergasse', 'Buchsee Edelknecht', 'Schwefelbade', 'Großen Rathe', 'Knnbel Barheg', 'Der Gerweruvi', '- felden', 'StA Aarmühle', 'Acha', 'Flachsknltnr', 'Mbleholz', 'Gro Affoltern', 'Bttenalp', 'Rappcrswyl', 'Pulvermühle', 'Guyot', 'Langenthaler Kap', 'Vieschcrhorn', 'Ober-Brandhubel', 'Bdeleins', 'St von Bern', 'Wyleroltingen Gurbrü', 'Faulhorus', 'Wyniger Brücke', 'Ellenberg H', 'Zäzibach', 'Weugen', 'BernerAlpen', 'Hellstttegg', 'Brüchli Alp', 'Mhlau', 'Büren zum Hof', 'Graßburg', 'Rmligen', 'Arnezmühle', 'Brandösch Vord', 'Bandstrae', 'WyttenbachBiertel', 'Grünenmatt', 'Schloß Blau', 'Heiligenlandhof', 'Diemtigen', 'Schwarzlütschinen', 'Breitholzwald', 'Golatet', 'Simmeufer', 'Waag', 'Mnnenbergs', 'IüAmvr68', 'Nuliäork', 'Schwellenmatt', 'Kirchgemei', 'Gerzensee Seftigeu', 'Kirchhügel', 'Brenberges', 'Nieder-Hnigen', 'SoümlinAou', 'Herrenschwandcn', 'Bubenbergc', 'Baksigcr', '- dossola', 'Freigericht', 'Blau', 'Höben', '- matt', 'Muschelsaudstein', 'Schloßruine', 'Kunitz Sachsen', 'Schwarzenegg Goldswyl', 'sw', 'llmmpion', 'Heünenschwand', 'Bllitz', 'Hofbez', 'Hof Breite', 'Bern-Thnnstr', 'Haueterberg', 'Hollanden', 'Wahlenhaus', 'Enzenbhl', 'Bättenberg', 'Walpenwyl', 'Grindelwald Pfarrd Allmis Hsr', 'Nidgau', 'Grindelwald Herabstarren', 'Mei', 'Gümmenen Laupen', 'Geb', 'Wieslandes', 'Ganligletschers', 'Stoffelsreuti', 'WildStrnbel', 'Mittaghorn Vgl', 'Trligen', 'Eisenstuh', 'Wirthsh', '- tigerthals', 'Emme Emmat lat  mmu Lmmu Lmmmm Linmotu', 'Edlen Rümlingen', 'Grächwyl', '- labyrinth', 'Grüsisberg', 'Buchenberg', 'Uettligen', 'Oberdorf-4tel', 'Lehn Hsr Roßweg', 'Std Riedacker Hof', 'Kienholz St', 'Lauter-Aarjoch', 'Hlisbhl', 'Tas Oertchen', 'Landstuhl', 'Sandflnh', 'St Bern', 'Linden Linden', 'Rentibach', 'St JohannsenUrkunde', 'Thal Wang', 'Seewli Seeli', 'Industrie', 'Kybberg', 'Simmcnthal', 'Mnriboden', 'Bernpfd', 'Tannwalde', 'Weienburg', 'Pfarr', 'Eschlen', '- hausen', 'Trümleten', 'Büetschwyi', 'Nie', 'Bmplitz', 'Hohenschwand Bergs', 'Rolli', 'Aeschi Heustrich', 'XirotiborA', 'Schillingen', 'Gem Alchi', '- thal', 'Biren', 'Vütscheleck', 'eien', 'Alannschiefer', 'Hattcnmatt', 'Knizberges', 'Entlibuch Stdn', 'Gem Langenthal', 'Gem Mnri', 'Büttenberg Gottstatt Abthl Safneren Nidau', 'Ried Sch', 'Karthäuser Thorberg', '- Groerlen', 'OberEmmenthal', 'Gstellihorn', 'Brem', 'Läber', 'Solothurnerlandstrae', 'Röthen', 'Bergpsad', 'Gürbe', 'Habkcrig', 'Er', 'Bnmbchli', 'Burgi', 'Aarganerheerstrae', 'KleinBurgund', 'Cono', 'HiettmMn', 'Helisbhl', 'Kopp', 'Landwirth', '- und Freiburgerstrae', 'Berger', 'Engstlenthale', 'Schweiz Museum von Füßli Jahrg 1795', 'Fraubrnnnen', 'Ober-Bren', 'Allenlften', 'Aeugsten', 'Emdthal', 'Haus Grünenberg', 'Arnisagi Baldistall Baldenstall Valdistahl urk Balderstal Valdratzstal', 'Pipin', 'Schafalpen', 'Mschberg', 'Schwarzsee freiburg Seusebez', 'Handeckhütte', 'Vogtrecht', 'Grien 6rüu', '- menthalern', 'Büntschbach', 'Bütikofen', 'Wohnh der Halen', 'Aeschlimanns', 'Kloster Museum', 'Neicheubach', 'Jnni', 'UomberZ', 'Simmenthal Diemtigen', 'Mulinen', 'Gugelmann', 'N  W', 'Bäderberg', 'Weinbergs Twann Ligerz Ligerz', 'Lyß Lyßwald', 'Rüegsbach', 'Emme Der Wald', 'Bäuert Achseten Elsigen Engibrücke', 'Affolternstraße', 'Brau', 'Venz', 'Dreispitz First der Schwalmeren', 'HubbergViertel', 'Brnstübel', 'Halter', 'biMlsee', 'Gsteig Abthl Wilderswyl AJnterlaken', 'Bolligen Bern Laupen', 'Bern Vergl Bern', 'Affenthal Hsr Brunnacker', '- denberg', 'Bocken Rebloch', 'Lütschenth', 'Altels', 'Rathe Bern', 'Dörfch', 'Wyden', 'Bttschol', 'Wohlen Bern', 'Vurghügel', 'Haus Thunstetten', 'Neuligen', 'Konitz', 'Zähringen', 'Koburg', 'Grencheu', '- Jaberg', 'Bunschenbad', 'Käpelli', 'Aergöw Aar', 'Dießenb', 'Langnau Signau', 'Reichiswyl', 'Erlacherhof', 'Gamchi', 'Brenzikofer', 'Ryffershäusernstutzes', 'Drrenroth', 'Saanen der Hornfluh', 'Gurbr', 'Knrzenbergs', 'Berggut Berg', 'Brgenstein', 'Lyon', 'LangenthalMelchnaustr', 'Maurachern', 'Aarlamm', 'Griesbachsaage', 'ThunerAllmeud', 'Npdegg', 'O  N', 'Buren Ob', 'Uun  1361 liunitx', 'Krauchthalmooses', 'Bctten', 'Burgistein Margrethen', 'Llmmniun', 'Bisthums Basel', 'Langenthal Vgl', 'Gsteig Bern', 'Hnibach', 'Sibnen', 'Dmplitz', 'Kvppigen', 'Grodei', 'Bußwyl', 'Langnau Signau Derselbe', 'Twärenbach', 'Lybach', 'Enetmoos', 'Erlenbach Pfarrdorf', '- derlamm', 'Grubach', 'Bernegg Heimwesen', 'Than Thangraben', 'Jnner-Orts', 'Schweiberg', 'Brienz Kirchhreu', 'Gurmels Freiburg', 'Gltsch', 'Neubrückrain', 'Langenegg Hos', 'Vom Tschingelhorn', 'Stöckl Borisried', 'Alp Stierendungel', 'Nderswyl', 'Teltistock', 'Hirschgraben', 'Belp Längenberg', 'Alferms', 'Leißigenberg', 'Alt Brunnadern', 'Obegg', 'Felsmauer', 'Schluchtschule', 'Meridian', 'Neuti', 'KleinBasel', 'Krauchthalbach', 'Cluniacenser', 'Landstr', 'Tschppbach', 'Brunnmühle', 'Nm', 'Lauperswyl Zollbrücke', 'oberer Niesen', 'Scheunen', 'Ltschenenthal', 'Leißigermarch', 'Olten-Strae', 'Faulhorn Röthi', 'Herrenbrunnen', '- burgersee', 'Scedorf', 'Mörigen', 'Haslebrck-Uetigenstrae', 'Gürbetbals Belpmoos Ost', 'Geldnoth', 'Solothurus', 'Alpscheli', 'Sundlaucnen', 'Freiburgerstraße', 'Bauernlande', 'Mrrenbachs', 'Adlembühl', 'Nieder-Lindach', 'Thierartcn', 'Stanffenknubel', 'Seelisbühl', 'Glütschbades', 'Nieder-Btzberg', 'Corbrn', 'Riederenhubel', 'Wabern Engiviertel', 'Weibermarkt', 'Sehetb', 'Glarns', 'Lchli', 'Manuwyl Mannenwyl Dörfchen', 'Gürbeu', 'Chrinnenberg', 'Blumenstcin', 'Haubenholz', 'Steck', 'MAwrum', '- bach', 'Gem Wyl U', 'Burgdorf Hasle', 'Henkershand', 'Albristalp von Fermel', 'Köniz Brügg', 'Thunstrae', '- renroth', 'Morgenberghorns', 'Tonnerbhl', 'Gentelbach-Brcke', 'Bcttelried', 'Erlengebüsch', 'Ilassleo', 'Hilterfingen Gerzensee', 'Zehntscheuer', 'Ochlenberg Vgl', 'Das Oldenhorn', 'St. Murten', 'Weiensteinhlzli', 'Kyburz', 'Std Twann', 'Helfereibez Kandergrund', '- Aarhorns', 'St. Johannscnhaus', 'Dinkelmann', 'Oberönz', 'Großh', '- Matten', 'Müw', 'Venner Schmieden', 'Lyß Rapperswyl', 'Hinter-Dessikofen', 'Heimenschwandzehntens', 'renovirt', 'Langnau Unterdorf', 'Schermenholzes', 'Bödeleins', 'Aeschau', 'Mannenried Hof', 'Secdorf', 'Spietz', 'Gem Lyß', 'Nawylhorn', 'Leuenbergers', 'Mitthvlz', 'Lwenberg', 'Xulron', 'Brchershuscrn', 'Brandsch-Vicrtel', 'StA Albrist', 'Stdelhorn', 'Spitalkapelle', 'Brästenegg', '- Bigelberg Biglenberg', 'Olroukalli', 'Scharmachthal', '- nau', 'Burgundern', 'Thuns Waisenhaus', 'Neumhle', 'Wysttthorn', 'Pfarrd Mhleberg', 'Götschmannsried', 'Nagelsiuhhügels Ns', 'Hhnerbach-Viertel', 'Oenlilslwmmos', 'Pintenwirthsch', 'alt-Statth', 'Magnesia', 'Blle', 'Krauchthal Oberburg Wynigen', 'Gsteigwyler Gsteig Jnterlaken', 'Büren Ober', 'Burgerspitals', 'Belpberg Rüthi', 'Eichenwald des Ober', 'Wsemli', 'Dtknvvilaro', 'Bettelriedbach', 'VuItinMa', 'Schoßhaldcnholzes', 'Diablcrets', 'Bußalp', 'Rnmisberg', 'Forst Burkard', 'Grbe', 'Unter-Wstenbach', 'Tnishaus', 'Walliswhl', 'Liebiwyl Dorf', 'Rndera', 'Stigelb', 'Saxetenthal Jnterlaken', 'Unter-Goldbach', 'Mtschwyl', 'Altengrat', 'Tei', 'Bergli', 'Ober-Simmeuthal', 'Nüeggisberg', 'Diessenhof Landsitz', 'Langem', 'Haller', 'Scheidegg Wengenalp', 'Mirchel Hsr', 'Matten Weiler', 'Ortonanien', 'Schangnan VnmbachTrittel', 'Zihlmattgut Zihlmatt', 'Beatenberg Habkern', 'St. Niklaus', 'Adelboden St', '- zogenbuchsee', 'Gümmenen', 'Luternan', 'Ulfingen', 'Moos-Seedorf', 'Küttikofen Kunstsaal', 'Bielersees', 'Altenberg-Viertel', 'Viaca Taf', 'Eismeer', 'EmmenthalerFurgg', 'Rwethal', 'Drrenwaldberg', 'Verraths', 'Lluvvlozwos', 'Selsach', 'Sd', 'NiederSulgen', 'Engstligenbrcke', 'Morgenbergs', 'Schlodomi', 'Klusenbach', 'Ellenwyl', 'Kurzenberg Glasholz', 'Lidwn', 'Landger', 'Sdel', 'Bargen Wohnh', 'Frutingen', 'Nieder-Scherli Schcrlibach', 'Möschberg', 'Pfarrd Messen', 'Moeschler', 'HasliScheideck', 'Ferenbalm Mühle', 'Seedorf Urnerland', 'St Beaten', 'Belmnnd', 'Gürbenbach', 'Unter-Wynau', 'Kühalp Kirgeli', 'Heinemann', 'Bütschel', 'Wiesenthal', 'Pulverthurm', 'Melchnau Aarwangen', 'Moosbad', 'HtnterFultigen', 'Ly', 'Groaffoltcrn', 'Vechburg', 'Untcrthancnberathung', 'Wildeneybad Bad', '- Hunzikenbrcke', 'Schwarzwaffer', 'Aemligenstutzes', 'Kienthalfurgge Vgl', 'Ober-Gurzelen', 'Rohrbachgraben', 'Einsiedl', 'Aufgau', 'Ziegelried', 'Kiencr', 'M-eli', 'Blindenanstalt', 'Galliern', 'Bielersee Bern', 'Euune', 'Holzmühle', 'Glissen', 'Enzcn', 'Spitzenberg Vgl', 'Salz', 'Oppligen-Berglein', 'Dingsttten', 'Vooanalu  äunniliieg', 'Bielerseestraße', 'BernerHochgebirges Aara', 'Klapperplatz', 'Nidau Geistholz', 'Vrggfeld', '- laui', 'Vincentius', 'Gehren Horn', 'Burgdorf Radelfingen', 'Toldenhorn', 'GrittdelwalderGismeer', 'Schtzenmatt', 'Alpberges', 'Psarrsatz', 'Bicrhübeli', 'Str Saanen', 'Thl Ebnit', 'Eigstein', 'Lutstorf', 'Hahnenmoos Hannemoos', 'Gnnten', 'Bern Freiburg', 'Nordschwaben', 'Marschried', 'UnterD ießbach', 'Bösingen Oberbalm', 'Ltschenen', 'Ober-Aarg', 'Geltenhorn', 'Riedbad Höfe', 'Pletschen', 'Ringgenberg Jnterlaken', 'St. Oswald', 'Lützelstühbrücke', 'Bund', 'Büblweid', 'Gran egg', 'Soßau', 'Antimoninm', 'Buchholderberg', 'Bisthum', '- Herzogenbuchsee', 'Dennlergl', 'Rufer', 'Büttlassenhorn', 'Trachselwald Langnau', 'Gasserhans', 'Wicdlisbach', 'Schneidehorn', 'Haltenberg', 'Münsingen', 'Seehofen', 'Bncheggi', 'Iloeobuo', 'LauterAarjoch LauterAargrat', 'Instisthal', 'Möriswyl', '- Unter-G ostel', 'Klosterschnle', 'Bayern', 'Hasli-Scheideck', 'Heidenloch', 'Aarbett', 'Schpbach', 'NiederBleikcn', 'Spitalackers', 'Bern Stadt', 'Gwärtistocks', 'Wachteldorn', 'Graburg', 'Wiedergalm', 'BächenBäuert', 'Laushütte', 'Obersteg Bergdörfch', 'Kanderffeg', 'Eichwald UnterHard Haldimoos Haldenmoos', 'Gallus', 'Lschcrz', 'Tingstatt', 'Emmenthaler-Kse', 'Wärgisthalbach', 'Str Huttwyl', 'Michaelsinsel', 'Irrthum', 'Rhone Vgl', 'Simmenthalstr', 'Pfd', 'Kastanienbaum', 'Leiternpfad', 'St Johannstag', 'Arar', 'Alaunquellen', 'Kypberg', 'Oktob', 'Frickstege', 'Längenbühl Länggaß Länggaßvicrtcl', 'St. Beatenloch', 'Kirchhof Belvedere', 'Scheidwaldbez', 'Trachsell', 'Amthause', 'Schmidigen', 'Orunä', 'VLU', 'Schweinsberg Schweißberg', 'Sumiswald Walteröwyl', 'Gletscher', 'Kuhnisberg', 'Redisbach', 'Solothurn Bern', 'Schwan', 'Gro-Affoltern', 'Höchstetten St', 'Bühlikofen', 'Hünigen St', 'Aenetbach', 'Priesen', 'Schloß Langenstein', '- Nieder - Hinterdorf', 'Thrigen-Oberd', 'Frienisberg Bern', 'Quellwasscr', 'Mürreu', 'Kalkspathkrystalle', 'Frieswyl Berg', 'Balleuhaus', 'Nessenthal-Sge', 'Mnstngen', 'Eisenfluh', 'Schauspielhaus', 'Lenk OberSimmenthal StA', 'Frei - bnrg', 'Sumiswald Trachselwald', 'Aargau Alchen', 'Aletschgletschers', 'Laudiswyl-Bezirk', 'Schlo', 'Hohwrz', 'Griechwyl', 'Hilterfingen Thun', 'Stockhorn Vgl', 'IbnxburA', 'Efsinger', 'Stuhl egg', 'Feldsiechen', 'Hinterburgseelein', 'Bruchenbhl', 'Burgdorf Wangen', 'Gatzenried', 'Scheuer Speicher rc', 'Hgspach', 'Pfarrd orf', 'Pfarrd Trüb', 'Seeddrs', 'Brandkorps', 'Solothurn Luzern', 'Uslmon', 'Bualpbach', 'Schorren-4l', 'Radelsingcn', 'Mittaghorns', 'Lenzigen', 'Werdt', 'Bärswyl', 'Gem Twann', 'RLthlisbergcr', 'Gfll', 'Dieses Thal', 'Wirthshaus Grenzbureau', 'Gamchigletsch', 'Rubigen', 'Stmpach', 'Eriswyl-Dorf', 'Rochliswyl', 'Wohley Franenkappelen', 'Fultigen', 'Steinberge Ammertenth', 'Btenberg', 'Faulhorukette', 'Wald-Drittel', 'Bade Weißenburg', 'Engstligen-Grund', 'Jvh', 'Grimselkctte', 'Mentschelenalp', 'Schlo Justinger', 'Weißachen', '- perswyl', 'Burgerspital', 'Ritterhans', 'Olletscherhorn', 'Kehrsatz', 'Sennhaus', 'Sandfluh', 'NidauerKap', 'Armengut', 'Eastelstetten', 'Nidau Buren', 'Oberlandes', 'Gätzistihl', 'Hasle Burgdorf', 'Oermuui', 'Thal Pfarrort', 'Schernelz Schernolz', 'Lenkthales', 'Schloß Nydeck', 'Klein-Hchstetten', 'Burgslnh', 'Thun-Allmend', 'Frutigen Vgl', 'Chirelbach Erlen', 'St Niklaus', 'GuggiSberg', 'Nawyl', 'Mller', 'Ortschwabenbachs', 'Glur', 'Eschen Linden', 'Jeg enstorf', 'Tiefenthal', 'Bigel', 'Branntweinbrennerei', 'FrauenKappelen', 'Hirscrn', 'Binzberg', 'Kirckberg', 'Tannenstr', 'Aeschbacher', 'Wanzenried', 'Tavel', 'Mlchi', 'Vnnalos', 'Jnsti', 'Muri Abthl Muri', 'Landwirth Niederösch', 'Jucher', 'Schpbachdrittel', 'Willenschwand', 'Scharnachthal Der Suldhalten', 'Pet Wich', 'Scheid egg Berg', 'Mettenwyl', 'Oberdiebach', 'Str Bern Emmenthal', 'Tannenth Höfe', 'Michels-Jn', 'Aesch', 'Hintertheil', 'Hünigen N', 'ScherzisBach', 'Kapfschwand Hof', 'Lsissigenbad', 'Palissaden', 'Ilwreiwelmtlon Mernsolmtton', 'Malefizrecht', 'Fischerdrfch', 'Bärengraben', 'Schnholzer', 'JnnerEiger', '- burg-Nidau', 'Frischenwerth', 'Oeschinenbach', 'Gerbern-Grabcn', 'Mnlchi', 'Bareichti', 'Bättenalp', 'Gurnigelbades', 'Furggengtsch', 'Petinesca Vgl', 'Knitzstr', 'Maricnthal', 'Udelbuch', 'Bürgisweyer', 'Muri Murzelen', 'Aarwangen Thun', 'Schlvberg', 'Achsalpenhorn', 'Stockorns', 'Wildelsigen Elsighorn', 'Laubbach Schwendi Dorf', 'Bttiosa', 'Alcheufih', 'Mülchi Mühlheim Mülenen', 'Rmlingen', 'Thunerstaldens', 'Hochstraße', 'StovensburK', 'Kurried', 'Lobsigen', 'Schweikhof', 'Ankenwaag', 'Banmgarten', 'Bern Balzenberg kall', 'Städtch', 'Ober - und Vurgiwyl', 'TentschordensComthurei', 'Aettiswyl', 'BrandöschVicrtel', 'Nyffel', 'Sigrisivul', 'Auros', 'Gurnigel Lormoulum', 'FeutersOey', 'Lizernethal', 'Reichenbach von Frutigen', 'Haus Wädenschwyl', 'Worblen Vgl', 'bioüortinAon', '- Gasternth', 'Milden', '- Btschel', 'UntcrAargletschers', 'Mühlethal St', 'Prstd', 'Lüthiwyl', 'Breitfelde', 'Otterbach Höfe', 'Geiser', '- burg-Berg', 'Hsrn besäetes Thal', 'Schönbühl Ziegelhütte', 'Tffen', 'Lhlisberg', 'Mslithal', 'Lchlibad', 'Heinzenschw', 'Alp Trachselwald', 'MoSmann', 'GoMwyl', 'Maus', 'Lng', 'Grüneck', 'Schattenhalb', 'Bürenberges', 'Herzvgenbuchsee', '- Schernelz', 'Zulligenhof', 'Vom Lammerhorn', 'Schwarrenbach Wydi Wyde', 'Biclersee', 'Hoher', 'Nöstbühl', 'Mhlbachs', 'Bern Därstetten', 'UnterwaldenObw', 'Dampfwyl Ellenwyl', 'Hru Herrenschwand Murten', 'Hellftttegg', 'Bärenegg', 'Rychenarni', 'Brris', 'Gem Muri', 'Thun Std', 'Kühlbächleiu', '- ried', 'Büren Bis', 'Dberhasle', 'Rehfnes Bern', 'Karlen', 'Gilbach Geils', 'Rhoncthal', 'Montblanc Savoyen', 'Fischetzen Aarwangen', 'Sidel', 'Martini', 'Burgdorf Psarrdorf', 'Radcl', 'Ziegelhütte', 'Ober-Lindach', 'Whnau', 'Bergen', 'Beatenloch', 'Std Spiez', 'Jsboden Grindelwald', 'Mhlebacko', 'Lanffen', 'Olirenlingen', 'Lüumplum', 'Frutigen Berg', 'Kum', 'Luzern Langenthal', 'Ergöw', 'Schloß Langenthal', 'Elisried', 'FinsterAargletschcr', 'Neuer', 'Kl', 'Aarbrücke', 'Scywendi', 'Aemmer', 'Nhonegletscher', 'Nncnflnh', 'Reutenen Dörfch', 'Nuliork', 'Fällbach', 'Wahleren', 'Neuenburg-Nidau', 'Lanbbach', 'Bchi', 'Kander Oberhofen', 'Wangen Abhang', 'Kastei', 'Giebach', 'Adelmännli', 'Kurzeneigraben', 'Bend', 'Engi Promenade', 'Licbcfeld', 'Jnter', 'Baggwyl', 'Süderen', 'Ncsscnthal', 'IViclon', 'Handelsrnhm', 'Hermann', 'Bbel', 'Pfarrd Wyl', 'Bunschcn', 'Lerne Savoie', 'Wyachengraben', 'Adelboden Aeschi Frutigbad Kandersteg Kienthal Krattigcn Mülenen Ueschinen', 'Aargauerstraße', 'Bern Luzernstraße', 'Lenk Der Weg', 'Roggwyl Pfarrdorf', 'V6Ü', 'Bnnd', 'Nitzberg', 'Frntingen', 'Enziberge', 'Dinkel', 'AescheRied', 'Waitenwyl', 'Wahlenberg', 'Weisen', 'Bgl', 'Steinhüs Steinhaus', 'Egkenbhl', 'Känelgaß', 'Gnrzelen Hof', 'Buchmühle', 'NiederBipp', 'Abendwald', 'St Vgl', 'Glütsch', 'Abthl Schattenhalb', '- delbank', 'St. Johannstag', 'FrieswylHubels Frieswyl', 'Waldsberg Luzern', 'Türrenberg Kienthal', 'Kurz enberg', 'Wylhof Wyl Mühle', 'Weiler OberB', 'Nidan Der', 'Demnach', 'Mhrenhorn', 'Nri Brügglen', 'Ziemlisbcrg', 'Geschtcklichkcit', 'Graubndten', 'r St', 'Holzerstuh', 'Vivis', 'Herreuschwanden', 'OberBleiken', 'Hügelreihe', 'Hasle Ober', 'Freihof', 'Sossau', 'Blümlisakp', 'Anderegg', 'Reuschegg', '- nan Bern', 'OltingenNeuenburg', 'Bärenloch', 'Elbechen', 'Freiherrsch Spiez', 'Ober-Ey', 'Brhegen', 'Gug', 'Weiden Bodmen Hsr', 'Schlündi', 'Nüeggisbcrg', 'St sö Bern', 'Bern LoinnMn', 'Wergisthal Wärgisthal Werkhof', 'Chlodwig', 'Buchsee Burkard', 'Hochbalm', 'Ompellu', 'St Nrban', 'Ningolzwyl', 'Diindenhorn', 'Außer', 'Gerbern', 'Wendschatz', 'Dennler-Mhlemann', 'bühl', 'Oekingen', 'Kühedungel', 'Schrattenfluh', 'Rümligen Gelterfingen', 'Fitzerhorn Bütschifluh', 'Emmenthalstraße', 'Weibach', 'Gadem', 'Lywald', 'Landiswyl-Bezirk', 'Drlocherhorn', 'Schafhausen Weiler Souius KU', 'Bremgarten Hasle', 'Wirthshaus', 'Münsters', 'Gzi', 'Romooser-Enzi', 'Lterswyl', 'Katzenbhl', 'Buchseemoos', 'Gydisdorf', 'kyburg', 'Bellen', 'Schnried', 'Mriswyl', 'St. Gotthards', 'Kramoder', 'Leih', '- genstr', 'Marchverbal', 'Olerosso', 'Romoos', 'Kirchthnrm', 'Thun Vurgdorf', 'Schüppach', 'Finsteraar', 'Ried Höfe', 'Lngenbergs', 'Tiefenbach', 'GtoßMühle', 'Luternau St Urban', 'Berner-Hochalpen', 'Zuoberst Thal', 'Laupenstr', 'BlumeusteinBad', 'Niederösch', 'WaldXtklioltorn', 'Lauenen Lauibach', 'Urtelcngrat', 'St Patten', 'Urtenen Uiinlelwnnoü NuiiäerotnnKou Münchringen', '- egg', 'Std Bemerkenswerthe Berge', 'Kurz', 'Neleren', 'Kirchhfe', 'Thürmen', 'Rainbrcke', 'Lngwald', 'Berggut', 'Weißcnau', 'Gem Hettiswyl', 'Std Niedburg', 'Geiholz', '2cU', 'Wallis Unter', 'Paßhöhe', 'ThunAlmeud', 'Kuitz', 'Affoltern Radelfingen', 'Emmenbrcke', 'Schulgasse', 'Finster', 'Zur Gem III Mirchel', '- dcneich', 'Muchenstein', 'Kaltenbrunnen Kaltenegg 613 Kaltwasserheilanstalt', 'Weidabtausche', 'Thalgut-Brcke', 'Aarhochufers', 'Spiezwyler', 'Kriesweg', 'Wallis Sonnenkronen', 'Twirinn', 'Habkern Entlebuch', 'Badhans', 'Twannbergs', 'Vleichenbach', 'Stellihorn Hochjägihorn', 'Notottneuv', 'Riedbad', 'Südalpen', 'Konolfingen Das Pfarrd Walkringen', 'Wart', 'Savoyer', 'Välliz', 'Lutzens', 'Helisbühl', 'Bipp Bipp Nieder', 'Verrath', 'Spcisewirth', 'Gell', 'Biembach Burgdorf', 'Bon', 'Lybachs', 'Saanen Zweisimmen', 'Grimselpasse', 'Köuiz Abtbl Wabern', 'Diechterhorn Triftenstock', 'Mschbachs', 'Rothenbhl-Sonn enberg', 'Stambach', '- wyl Nieder-Simmenthal', 'Thal St', 'Bhlbach', 'Thnner Kapitels', 'Thalgrunde', 'Rindfleischhöhle', 'Lauenenbaches', 'Ncichenbach Schloß 608 Neichenbach', '- horn', 'Ober-Btzberg', 'Rendlen', 'Franmatthof', 'AnßerOrts', 'Tschanz', 'Ramscr U', 'Ghürnberg', 'OberHoblen', 'Leberbergs Jura', 'Wiler', 'Hergisberg Hsr Rauchmühle', 'Weiler Schwenden', 'Gsteig VLO', 'Ltold', 'Tscheppach Brügglen', 'Bettelberg', 'Rätzliberg', 'Lauterbrunneu', 'Bern Genf', 'Gontenbach', 'Blauhaus', 'Elbezen', 'Blmlisakp', 'Kollatnr', 'Hasle-Scheideck', 'Bemerkenswerthes', 'Webern', 'St. St. Gals', 'Illuiollsiibuvk', 'Frohbergs', 'UnterUrbach', 'Zur Abthl Gnttannen', 'Simmenthal Pf', 'Prisberg', 'Kronenbnrg', 'Lh', '- heid', '18Ü0', '- dorf', 'Breitenrain Vgl', 'Igel', 'Refli', 'LInioüinbnoü', '- walden', 'rothe Horn', 'Mänigspitze Menigberg', 'Escher', 'Uebeschisee', 'Hasle-Otzenberg', 'Wlflisried', 'Urwyler', 'Pst', 'Menwyl', 'Fraubruunen', 'Küttikofen Kypberg Mühledorf', 'Gerlafingen', 'Eichi', 'Ltzel', 'Kriesbaum Kirschbaum', 'Feldmoos', 'OberBützberg', 'Knubel', 'Englisberg aulistahl', 'Pfarrd Leissigen', 'Reichenbachbad Bad', '- thenbach', 'Zum Schulbez', 'Deutenderg', 'Nogartcn', 'Weienburgberg', 'Schwarzenegg Wachseldorn', 'Kornhans Th', 'Sohlhorn', 'Speiscwirth', 'Schwarz Horn', 'Bauernod Unter', 'Martisegg', 'Ghürnwald', 'Konr', 'Hauben Hof', 'Bäran Spital', 'Lzelflh', 'Loo', 'Dächlibach', 'Verglistock', 'Aarjoch O', 'Vcrchtold', 'Melchthal', 'inBelp', 'Häftli Büren', 'Arbnrg', 'Selenit', 'rhein', 'Salzmagaziu', 'cidg', 'Beck', 'Tellenfeld', 'Wylerbrcke', 'Gersten Garzen Schwarz', 'KerzerS', 'Movs-Affvltern', 'Bäuert Zwischenflüh', 'Thal Pfarrort Interlaken', 'Griebach', 'Morlotläubleins', 'Wölflisried', 'Ochsen Wald', 'Burg', 'Stanz', 'Frnttgen', 'Bricnz Juterlaken Lauterbrunnen', 'Hnigen-Moos', 'Simme', 'Zwingelhof', 'Brhcggen', 'Pfarrd Jsch', 'Trachselwald Sumiswald', 'Guggershorns', 'Senfzermatte', 'Berghsr', 'Pfründlistock', 'Breiti Breite', 'Wal', 'Uestethal', 'Langcncgg', 'Grniberg', 'Offenhuser', 'Spitalsee', 'Eratz', 'Gem arschwaud', 'Gstaad Saanen Laupen Gümmenen', 'OwMsborZ', 'Aarmühle', 'Habkerig', 'Walthaus', 'Meiringen Willigen Jsenbolgen Hausen', 'Krattiggraben Mühle', 'Haslithal Meiringen', '- und Nieder-Schnegg', 'Buchsce', 'Vanel die Saane', 'Lützelflüh Grünhorn', 'Tündenbach', 'Bmbach', 'Vrstalden', 'Alcheufiüh', 'St Petersinsel', 'Väuerten', 'Bächigut', 'Wylisau', 'Mnristaldens', 'St. Siegart', 'Das Torf', 'Metzgergaffe', 'Aarwangen Pfarrdorf', 'Vonstetten', 'iXova', 'gisp', 'Kaltackerberg', 'Niederhnigen', 'Stadtrathhause', 'Kriegsegglen', 'Bcatenberg', 'Kappcllenbad', 'Alpen Egg', '- wylbach', 'Jnterlaken Hasle', 'Münzgebäude', 'Schloß Landsitz', '- stetten', '- Weiler', 'Kallnach Pfarrdorf Kirchgem Aarberg', 'Frienisbergerwald', 'Beides Mülinen', 'Dieenb erg', 'Ostermundingen', 'Gimmelwald Mürrcn Ammerten Lauterbrunnen', 'Saanen Gsteig', 'Thierspital', 'Urk Loclox Irculitionum Uoimstorü', 'Freibachmoos', 'HinterFultigen', 'Studen', 'Lauenenthal Grenze', 'St. Erlach', 'Mnhlercn O', 'Schulh O', 'Brunnenloch Haus', 'Männliflnh', 'Gaulihorns Wellhorns', 'Bäriswyl', 'Adelgos', 'Büren Dieß', 'Dörfch Hsrn', 'Höchst', 'Meyersmad', 'Uuncioltesrviluro', 'Burgdorf Bern', 'Dauben', 'Gowyl', 'Saanen Vgl', '- burg', 'Gltschbad', 'Kroschenbrunnen', 'Pfarrdörfchen', 'Seftingen Kaufdorf', 'Vrsbach', 'Das Thal', 'St Beatenberg', 'Seenfer', 'Rufshäusern', 'Kuhliwyl Dorf', 'Oimmoix', 'Breuw nrk', 'Seelhofen', 'Bärenbach Bach', 'Mlenens', 'Kantonsgränze', 'Landsitz Hof', '- bhl', 'Emmenbrücke', 'Grindelwaldth', '- und Unter-Gurbs Gurbsgrat', 'Pfarrd Kappelen', 'Aarhoru', 'Lcnzligen', 'Engibach', 'Kal', 'Ober-Diesbach', 'Sustenstraße', 'Iaao', 'Leimbrck', 'Saxetenbach', 'Hubel', 'Zwetltschinen', 'Lüzelflüh Farbschachen Hof', 'Twann Kl', 'Schaafegg', 'Ochsenkops', 'Altenberg Ammerten', 'Anßerfeld', 'Str Kandersteg', 'Landger Zollikofen', 'Bikigen', 'Grncnberg', 'Zwirgi', 'St Johaunsen', 'Imupsnsis', 'Thiermatten', 'Taatelenhorn', 'Kollatnrkirchen', 'Kirchcnwesen', 'Lütschenthal', 'Str Nern', 'Brienz Jnterlaken Pf', 'Hahnenmööser', 'Guglerkrieg', 'Amsoldinge', 'Gottstatt Nidau', 'Kiloüon', 'Melchenbhl', 'Aar Wangen', 'Gmmencn', 'Leinwandsabrikation', 'Wynigen-Brcke', 'Egadi', 'Mlincn-Gurowski', 'Ilaborlmräi', 'Gro', 'Llmmbrier', 'Stullen', 'Beatenberg St Pfarrdorf', 'Bschenried', 'Könitzthal', 'St. Unterheid', 'Rutschbach', 'Thicrreiches', 'thaler Berge', 'Ammertenthale', 'Lammbachs', 'Altanen', 'Gemmi Weder', 'Str Lützelflüh', 'Täuffelen', 'St. Signau', 'Bubenberg Ruinen', 'Krauckthal', 'KlvsterleinS', 'Oberbofen', 'Scheidweg', 'Lind', 'Oye', 'Blsch', 'St Vgl Karmins Rawin', 'StWA', 'Bren-Effinger', 'Utzenstorf Pfarrdorf Kir chgeme', 'Belp Gem Kehrsatz', 'Pfarrhof', 'Müntschemicr', 'Bnnkhoffen', 'Seeberg Schnerzenbach', 'Ried Hint', 'Rothhorn Groß', 'Iobann', 'Rubig', 'AußerEmdthal', '- bach-Lindenstr', 'Oltingen 1413 Weißenau', 'Heutligen', 'PfaffenmoosHölzli', 'Thormann', 'St Leerau', 'Lonsdorf', 'Aarquelle U', 'Bäuerten Niedern', 'Ebendaselbst', 'Vüttlosa', 'Scherzligen', 'Wangen Bachalp', 'Haus', 'Weienstein', 'Chasseral', 'Almendingen', 'Dieboldshausen', 'Tyrol', 'Hupperlandes', 'Sägisthal', 'Hegebach', 'Ochtland', 'Büetingen', 'Hasleth', 'Zäsenberg', 'Ballenbühl', 'Langhaus', 'Wendenstock', 'Allmendingen Eicht', 'Seitenstraße', 'Kappelen Forst', 'Rüwethal Frauenkloster', 'Weißenstein Weiler', 'Kirchhügels', 'Notschalp Tannlihorn', 'Thring', 'Zur Gem III Hub', 'AltenbergDrittel', 'Sommeran', 'Grenchen Mülenen', 'Ober-Hohlen', 'Lauter Aargletschers', 'Bad Wirthschasts', 'Negierungsrath', 'Mnchringen', 'Weißenbach', 'Jegenstorf Pfarrdorf', 'Eriswyl Psarrdorf', 'Lanz', 'Urweid', 'Bottenklemme', 'Aettikofen', 'Aner-Latterbach', 'Neleren-4l', 'Zaun', 'Baselstrae', 'Wohnh VII Latterbach', 'Hnndsfluh', 'Dürrensee', 'Nidflh', 'OberSimmeuthal', 'Mauer', 'Tiemtigen Teuffenbach', 'Gstaad Rübeldorf', 'Rllisen', 'Sigriswyler Grats', 'Osterstein', 'Hardcr der Aar', 'Schwarzhusern', 'Ober-Stocken', 'Nu Mhleth', 'Brummbach', 'Därligbachs', 'Dornegg', 'Dicmtigthal', 'Biglcn', 'Unterwalden-Obw', 'Aegel', 'Kirchenthurnen Mühle', 'Kpburg', 'Oenz Seeberg', 'Blume Schwändi', 'Emmenthal Grenzstock', 'Kornmagazin', 'Bzingen', 'St. Vineenz', 'Nydeckbrckc', 'Thalkirche', 'Brügglindach', 'Lochbach-Bad', 'Grbenmoos', 'Spital St Johannis Jerusalem', 'Regensburg', 'Osterrieth', 'Frauenbrunnen', 'Burgunden', 'Feutersoy-Be', '- gebirgen', 'Schloß Mauern', 'Bhnli', 'Aar znm', 'Ballenbhl', 'Petronella', 'Gltschbachs', 'AlpiglenGletscher', 'Mnsperg', '6eIpo slpo orpu', 'Buntschibachs', 'Dannenbhl', 'Brgleu', 'Guttauuen', 'Löffelhof Galgenhof', 'Kirchhofmauer', 'Kirchg', 'München', 'Gastern Frutigen', 'Bandstraße', 'Wurm', 'Oppligcn', 'Lngenthal', 'Achsitberg', 'Olisch', 'Kalchnach', 'Kirchen seid', 'Nägelisg', 'Zumbach', 'Schallenberg-Wald', 'Grischbach', 'Whdenlö', 'Neuhaus Bauerngut', 'Bttlosa', 'Grindclwald', 'Rümligen Nieder', 'Poschenried', 'Aarberger Thiergarten', 'Sulgenbachs', 'Melchuau', 'Walliser Grenze', 'Scheurers Mausoleum', 'Beatentoch', 'Oltigen Oltschenen', 'Thcol', 'Haste Hsrn', 'Unter-D iebach', 'Kirchhöreu', 'Kie', 'Bualp', 'Kunz', 'Sumislväld', 'Schafrace', 'Bchlen', 'Oberhasle Urbachthale', '179S', 'Saumstrae', 'Drlig', 'eckenmatt', 'Klara', 'Ladenwand', 'Bern Reun Hsr', 'Tnrbach', 'Nothach Mühle', 'Bürgle', 'Saanen von Lauenen', 'Arue', 'St. Frienisberg', 'Alt', 'Karthause Thorberg', 'Seftigen Sternenberg', 'Mühleberg KleinMühleberg', 'Berns Jahrh Zollikofen', 'St. Bern', 'Ibsnon', 'Lazareth', 'Elfenauw', 'Zollikofen-Moosseedorfstr', 'Rüdlen', 'Runs', 'Knnbel', 'Nitzbach', 'Großerlen', 'LarriborZ', 'Sannen Vgl', 'Eflingen', 'Hni', 'Obenher Solothurn', '- Schwand', 'Läger', 'Nüegsbach', 'Imlrin', 'Berges Thurnen', 'Lemibrgg', 'Zollikofeu', 'Langenthal Herzogenbuchsee', 'Rosenlaui', 'Str Aarberg', 'Frutigen Oey', 'Spieß', 'Grindclwald Lauterbrunnen', 'Amthause Fraubrunnen', 'Uassloo', 'Reutigen Burg', 'Langensteiu', 'Gletscher Gletscherhorn', 'Müusterthal', 'Kirchgemeiude', 'Grimselkette', 'Ger Madiswyl Aarwangen', 'Gnlialp', 'LtvOItz', 'Gsteig Halden', 'Frnttaria', 'Venner', 'Kaltenherberg', 'Reichenbach Aeschi', 'Geißhof Hof', 'Eigers Breithorn', 'Enze', 'Burrach', '- Pfarrdorf', 'Jnkwylsee', 'Willading', 'Bubcnga', 'Jnterlakenhaus', 'Grb', 'Blöwestatt', 'St von Aetigen', 'Engstlenalp Genthal Oberhasle', 'Buntschibad', 'Haus Schwand', 'Säntis', 'Brunnadern-Viertel', 'Bnmbach', 'Oberholz', 'Stockernfluh', 'Madiwyl', 'Gießbachs', 'Birchlauenen', 'Maria', 'Berg-Bezirk', 'Aeschlen 1292 Eschi', 'Bergdorfe Mrreu', 'Fischenzen', 'Erlach Nonu', 'Achseten', 'Ellenberg', 'Bren Burk', 'Bottigen O', 'Schnttkegel', 'Bannwvl Wobub', 'obern Schtte', 'Turbachs', 'Hun', 'Bargen Kerzers', 'Saxetenthal Vgl', 'Nychigen', 'Frutigstraße', 'Ober-Placken', 'Ueblenberg', 'Betigen', 'Mnthal', 'Justisthals', 'Moos Hellsau', 'Bdelein', 'Aeltere', 'Ritter Twann', 'Rüti', 'Landsturin', 'Auer-Birr', 'Gant Wand Felswand', 'Namstein', 'Bern Knno', 'Dörfch Haus', 'Gadmenfluh', 'Cüdrefin', 'Arm', 'Greyach', 'Geisberger', 'Ksershaushof', '- urk', 'Gastron', 'Räufle', 'Gutmannshaus', 'Bern Bühl', 'Mnsingcn', 'Kurzeney', 'Vurgbühl', 'Blumensteinerbad', 'Torfbach', 'Stadönz', 'Hügelländes', 'Wirthshaus Kirchberg', 'Spitalholz', 'Ohmgeldamt', 'Alp Hannenmoos', 'Rubismhle', 'Gempelen', 'Mittelalters', 'Uereini', 'Fehlbaum Hof', 'Rothmoos', 'Thdingen', 'Frzbach', 'Scheidcstrae', 'Mühlehof', 'Stäg', 'Buchen Eichen', 'Rüthi', 'Obere', 'Bafel', 'Schafberg', 'OberhofenGontenstraße', 'Weißen Schwesternhaus', 'Tscharner-Wurstemberger', 'Zyackerzelg', 'Wetterhorns', 'Rhrb', 'Schloß Blankenburg', 'Huristall', 'Rüschegg Reuschegg', 'Trubthal', 'Dinkelbhl', 'Lücke', 'Kauzenhubel', 'Frankreichs', 'Hellisbhl', 'St Stephan', 'Gurnigel Grön', 'Iustithal', 'Viesch Wallis', 'Bächi', 'Walliser Gebietes', 'Bleicnbach', 'Berncrn', 'Peterlingen Bickigen', 'Cuenin', 'Waltrigen-S', 'Rupprecht', 'Dinghof', 'Mnschelsandstein', 'Ghsen', 'Ltschenthal', 'Grädelisberg', 'Affoltern Dürrenroth', '- lenberg', 'Daube', 'Wyhrien', '- Otterbach', 'Grohorn', 'Geologisches StWA', 'Alterthümer', 'UnterDießöach', 'Haus Scheuer', 'Schloß Stadt', 'Alpensecu', 'Gem Bowyl', 'Müllenberg', 'Bond Bonderspitz', 'Regsbach', 'Port Bort', 'Unter-Dieach', 'Twirgi', 'Kirchort', 'Nessenth Mhleth', 'Mutti', 'Bouderlen', 'Thörishaus Dörfch', 'Gamchi Frutigen', 'Rapperswhl', 'Oberhofen Balmen', 'Sägi', 'Zwischenbach', 'Moos Enetmoos', 'Aarsand', 'anstork', 'Bndley', 'Franbrunnen', 'Seeli', 'Haus Buchsee', 'Schwarzcnburg', 'Aarberg AarbergerMoos', 'Oeyen Oeyen', 'Thal Badweidli', 'Thalschaft', 'Senggiweiden', 'Gerenstein Hub', 'GentelbachBrücke', 'Kapfschwand', 'Schloß Sch', 'Berge', 'I Hott Türrenroth', 'Hof Mittl', 'Schnenbhl', 'Lauenenhorns', 'Nhdeckbrücke', 'Kaltenegg', 'Madretsch Dorf', 'Emmenthaler-Furgg', 'Saanerloch', 'Obcrholz', 'Furt Hof', 'Bergpaß Lauenen', 'Holzmarkts', 'Kies', 'Steinackern', 'Thunstetten Abthl Bützberg Aar', 'Spiez Spiez', 'Answyl', 'Schwendi-Buert', 'Geißhofbach', '- bnrg', '- Grabenstrae', 'Thun Hilterfingen', '- Wangen', 'Langhans', 'Brienzerseestraße', 'Oekonomische Gesellschaft', 'Kihley Diemtigen', 'Bnembach', 'Säriswyl', 'Solothnrns', 'Aetiger-Berg', 'Hub berg-4tcl', 'Seefeld Vgl', 'Laupe', 'Hölzli', 'Seeufer', 'Türrbach', 'Steinl', 'Chateau dOex', '- derbrck', 'Zweisimmen St', 'Mnchenbuchsce', 'Eichenbhl', 'Löschthal Wallis', 'Weidganges', 'Asp', 'Weissenburgerbad', 'Schloß Signau', 'Wärgisthal', 'Jlfis', 'Wcinstcgen', 'Blei', 'Khlewyl', 'Emmenthal Bätterkiudcn Burgdorf', 'VinzenzenLeutkirche', 'Hhlisbhl', 'Thali', 'Mühlheim', 'Alpschelen', 'Miieon', 'Gümmenen Klein', 'Spiez Bodenzingen', 'Egerdo ngasse', 'Glockhaus', 'Herzogen Hauses', 'Wilig', 'Btteualp', 'Ghrn', 'Aar Illiswyl', 'Gürbenmoos', 'Emdthal Außer', 'Lühlweid Heidbühl Buchschachen', 'Mhledorf', 'Gerzensee Kirchdorf', 'Hiltbrunner', 'Kunstsaal', 'Außerbach', 'Pestilenzen', 'Wieswachs', 'Buchiberg', 'Steiger', 'Urwylhof', 'Zollenkofen', 'Geichtbergs', 'Aspibad', 'Kirchegg', 'Neu-Bubenberg', 'Scsterzligbrcke', 'Ferenbalni', 'Stein Bern', 'Trachselwald UnterOeschenbach Wangen', 'Mülinen', 'Doknmentenbnch', 'Aarganerstrae', 'Roalp', 'Die Brücke', 'Zwieselberg Nentigcn', 'Wiesenthale', 'rothe Fluh', 'Straßberg Büren', 'genMooses St Bern St Burgdorf', 'Thuner-Allmeud', 'Limpach Bad Uetendorfberg', 'Horn Hübet Kaps Knubcl', 'Groaffoltern', 'Carthause Thorberg', 'Attulnivyl', 'Ligerz Nidau', 'Vhlfeld', 'St Johannsen', 'Haus Luternau', 'Mhrenstub', 'Pfarrd Ob', 'Alferm', 'Kohli', 'Luläo', 'Endorf', 'Drettenhrnli', 'Oesterreichs', 'SiebenBrunnen', 'Deutsches Haus', 'Fellistutz', 'Aenzen', 'OberDießbach', 'Inncrtkirchen', 'Tannenbandstock', 'Nieder-Lindachwald', 'Viel', 'lwspitnle', 'Thunstetten Schuposen Borste', 'Zoll Bern', 'Gsteig Chumigalm', 'Drlocherhvrn', 'Hhcwcg', 'Palmos', 'ThnnerAllmend Rosengarten', 'Hugi 5800', 'Nieder-Gestelen', '- giswyl', 'Abendbergwald', 'Gto-Mhle', 'Berchtoldshof', 'Jnner-Birrmoos', 'Engi-Viertel', 'Tbunstetten', 'Helsereibez Rüschegg', 'Ober-Bleiken', 'Wylerguts', 'Lnggavicrtcl', 'Oberbalm Wohng', 'Abrah', 'Beinhause', '- haslethal', 'Aeugsternknubel', 'Htnter-Fultigen', 'Engelgebirge', 'Neubau', 'Gauli', 'Vnbenbach', 'Köniz Linder', 'Eschenbach', 'Neuenberg', 'Mörisried', 'Hangendhorn', 'Vlligen', 'Michelsthrlein', 'Lütschenthals', 'Trmmletenthal', 'Gebirgshöhe', 'Bttenbergs', 'Aarbergergaßbrunnen', 'Ganzenberghos', 'Burgdorf Oberburg', 'Kirchdorf Abthl Gelterfingen', 'Alchenflüh', 'Schönegg', 'Bartol', 'Mhren', 'Kaltwasserkuren', 'EngtHalbinsel', 'Agriswyl Goldbach Nieder', 'Hühnliwalds', 'Alterthnmsfvrschung', 'Biebern', 'Müusingen', 'Kantonstheile', 'RothBezirk', 'Marzielethor', 'Merken', '- Lindenthals', 'Alb', 'Todtcntanzgasse', 'Bäuert Horben', 'Alpenthee', 'Kaufh', 'Fli', 'Berggrat', 'Ueten', 'Burgdorf Aarwangeu', 'Kuhweiden', 'Bez steig', '- sternthal', 'Schnegg', 'Tannenth', 'Burghorn Hinter', 'Trimstein Münsingen', 'Schwendihubel', 'Müslithal', 'Lanterbrunnen', 'Gem JnnerDirrmoos', 'Calanda', 'Lindbach', 'Vaupers', 'Reggisberg', 'Weiler Heiligenschwendi', 'Rümligen', 'Strudels', 'NiederSimmenthal', 'Ursonbnoü', 'Bei Wyler', 'Mistelacherberges', 'Langenthals', 'Kabisberges Dürrenroth', 'OtsI', 'Furggigrats', 'Arnitzmühle', 'Beck Der Körper', 'Bettenhausen Rütschelen', 'Lberu', 'Gelmersee Grimselpaß', 'Wystthorn', 'Bern St.', 'Civilsachen', 'Pfarrdorfu', 'Oberbtzberg', 'Sim', 'ThunersSe', 'MittlerArni', 'Ballenhans', 'Niiegsbach-Viertcl', 'Oberwyl Mauer', 'Schallenhaus', 'Juch Wald', '- Limmenthal', 'Limssoral', 'Oberbützberg', 'Gemeindsbez', 'Lindnach', 'Grindel Nahe', 'Blumenstciner-Bad', 'lten', 'Zwiebelngasse', 'Steinberg Schönisey', 'Sanetschpa', 'VillarsIeUoino', 'Büttenberg Nontpottum', 'St Hohfluh', 'Btzingeu', 'Schwrzibach', 'Hintergasse Hsr', 'Obonvii', 'Brüggen', 'Vlomesten', 'Blattenweid', 'Krayligen', 'Stockenthal Grbenmoos', 'Limmpion', 'Eisenarbcitcr', 'Gem Laupen', 'Olnvglexres', 'Muri Pfarrd', 'Burgbhl', 'Grat Heimwesen', 'Wengen-Scheideck', 'Allenberg Heimwesen', 'IIoMerosbere', 'Ostcrmundingen', 'Grasland', 'Bächlen', 'Nuntigen Mazwyl', 'Gttschmannsried', 'Heddo', 'Emnienthal Hub', 'Haus Gütchen', 'Burghof', 'voclesiu Luroero', 'Mlheim', 'Thalebene', 'Aetschligen', 'Hinteregg Hof', 'Sefinenalp', 'Hünigen', 'Hinter-Lckhorn', 'Bühlikofen Stöcken Bühlikofen', 'Roßalp Vgl', 'Uebrigcns', 'BodenBäuert', 'Hirschen', 'Ober-Oeschenbach', 'Bidmen', 'Schngan', 'Urtenen Moosseedorf', 'Brgger', 'Rschbach', 'Gradlisberg Hof', 'Franenkloster Brunnadern', 'iKiiitz', 'IlonurMo', 'Erwähnens', 'Viviers', 'Klosterkirche', 'Utti', 'Lthiwyl', 'Waldemmen', 'Teitigen', 'Die Kastlanei', 'Martinsdruck', 'Twinghaus', 'Drrbach', 'Drrenflh', 'Teißwyl', 'Brengraben', 'Obergoldbach', 'Gongtriesthorns', 'Zollern', 'Habsurg', 'Neichsland', 'Ausburgerschaft Burg', 'Lyßbachs', 'Sachslenthal', 'Trüttlisberg', 'eidgen', 'Ita', 'Hürnwald', 'Zur Linken', 'Zzibach', 'Gummfluh', 'Oelis', 'St Sebastians', 'Grnigen', 'Kan', 'NiederAlchistorf', 'Bleienbach Madiswyl', 'Hasle Grund', '- und Kienthals', 'Rüegsau Pfarrdorf', 'Nom', 'Thuner Tschuggen', 'obenaus', 'Jffigeuthal', 'Thurnen Seftigen St', 'Bergs', 'Münchenbuchsee', 'Vinelz Bndley', 'Ergw', 'Läusligen', 'ClnniaeenserOrdens', 'Trbtensee', 'Weienbnrg', 'SchweiU Hof', 'Lhlein', 'Laucherhorn', 'Sternwarte', 'St. Doset', 'Englisperg', 'Glashütten Gütchen', 'Leuxingen', 'Hnli-Waldhgels', 'Je', 'Därstetten Vermuthlich', 'Wimmis St Thun', 'Bern St', 'Nühnk', 'Lauteraar', 'Ucltschi', 'St Eichi Ober', 'Biglen Buchacker Hof', 'Langenthal Bern', 'iVurol', 'Ober-Oesch', 'Feilenderg', 'Str Thun', 'Schupposeu', 'Mhlenen', 'Murg Noth', 'Rosen', 'Aarwyl', 'Bümpliz', 'Wy', 'Goldern', 'Thalkessel', 'Granit', 'Ebnit Ebnit', 'Schwaflands', 'Ger Güm', 'Pfarrd Thierachern', 'Nöthenbachs', 'Thallenteu', 'Lüßlingen', 'Bigleumoos', 'Nitstnh', 'Krebs', '- bach-Au', 'Fraubruuuen', 'Mühle Nessen', 'Bütschi', 'Wylersteg', 'Golzwylersee', 'Hof Bartholome', 'Golbrckli', 'Hl-G meind', 'Std Thun', '- und Unter-Winterthal', 'Bisthums Lausanne', 'Aerenbolligen', 'Burgistein Edelknecht', 'Diemtigthale', 'Räterichsbodeu', 'Brggelen', 'Bänert', 'Zwieselbcrg', 'Bittersalz', 'Tundwyl', 'Büttlassen', '- Aarhorn', '356G', 'Blumenstein Thun', 'Mergel', 'Rtschgrahen', 'SaanerWald', 'Lroolllünl', 'Rentland', 'Leerau', 'Birrmos', 'Sels Bisth Straßburg Ooäenctork VVinclemis Uetendorf Wimmis', 'Zollikofcnstrae', 'Stephan', 'Solothuru', 'Stämpflishäusern', '- Nieder - und Hinterdorf', 'Kappelen Pfarrdorf', 'Aarberg Buren', 'Ballenb erg', 'Werner Oberlandes', 'Elser', 'Biberen Ferenbalm', 'Hölisbühl', 'Laudrechts', 'Jnngfrauhorns', 'Nathhauses', 'Wikardswyler', 'Briswyl', 'Netschbühl', 'Oberli', '- Lerg', 'St. Gallen', 'Ibootn', 'Bad Oswald', 'Bern Stdim', 'Drackau', 'Ober-Sulgenbach', 'Flo', 'Oberwyl Pfarrdorf', 'Bblweid', 'Trnbba', 'Ober-Ramsern', 'Sternenberg.', 'Habsbnrg', 'Thalboden', 'Nagelfluhfelseu', 'Negierungsstatthalters', 'Jordans', 'Könitz', 'Gampelcn', 'Judcnkirchhof', 'Brüchli', 'Ralligflnh', 'Bürglegut', 'Thal Wynigen', 'Hard Höfe', 'Nid-Au', 'Schnlhaus', 'Muntigalm', 'Badwirthsch', 'Geschenenthal', 'Gloggenthal', 'Büren Wangen', 'Znbchörde', 'Zlutschi', 'Ranchenbhl', 'Aarhorns', 'Nybrck', 'Gr.', 'Tschingels', 'Adelbodenth', 'Grneck', 'Brgisweyer', '6trsla 6tro 6lIn ors', 'Alt-Landorf', 'Mettenbühl', 'Thali Drfch', 'Bibcren', 'Kiley-Alp', 'Haubenberge', 'Aetzreuti', 'Schloß Npdegg', 'Mhlebach', 'Saanenkse', 'Maurizen', 'Balsalp', 'Namscrn O', 'Neuenburger', 'Kouiz', 'Genfer', 'Seeland Aarberg', 'Haus Savoyen', 'Walliser-Gr', 'Gror', 'Heiligcnland', 'Eisengrube', 'Kfichglein', 'Vignay', 'Kunkel', 'AlpGils', 'Selz Deßwegen', 'Dießbach Konolfingen', 'Distr Buren', 'kertorl', 'St von Thun', 'Moritzen', 'Kornamt Urk', 'Fclsenkluft', 'Lngenbach', 'Aargletscher Unter', 'Hug', 'Buetingen', 'Wild-Elsigen', 'Langernalp', '- benberg', 'Gantrist', 'Forst Forst', 'Gasse', 'BrenAns', 'Allenlüften', 'Commenthur', 'Scheidcgg-Alp', 'Bickigenhof', 'Schnholz', 'Jaberg Kirchdorf', 'Mnnenberg', 'Sigimu', 'Moos Stadtlehen', 'Griechenwyl', 'Gsteig der Sattelegg', 'TenfelsKarrweg', 'Grafenbhl', 'Spital Tönn', 'Affoltern Pfarrdorf', 'Pfarrd Zugeh', 'Gneis', 'Jeusbergs', 'Eichihöfen', 'Dornbhl', 'Gump', 'Wimmis, SLOC', 'Fraubr', 'Staldenstr', '- Alpen', 'Gemeindeh', 'St Stephan Vgl', '- Kirchschwand', 'Nassau', 'JnnerAchseten', '- lindach', 'IlinMiiborA', 'Sch 1827 Hsrn', 'Aalen', 'Roßhäuscrn', 'Dberbofen', 'Stdn Rothachen', 'Ölten', 'amOenzbach', 'Amsoldingen Pfarrdorf', 'Port Sutz Täuffelen Siselen', 'Knizberg', 'Weien-Schwesternhaus', 'Leißiggrat', 'Lindenholz Mühle', 'Niedersch', 'Diligencen', 'Alkistorf', 'Felden', 'Lohnerbergs', 'Badhause', 'Aar Aare', 'Ueberschwemmcu', 'Schweiz Museum', 'Tessen berg', 'Hciligbhl', 'Gruenbachs', 'St Abhang', 'Hnttwyl Std', 'Hochgebirg', 'Stalden Haus', 'Brnnen urk', 'Weiler Neßleren', 'Thrishaus', 'Lieben', 'Reichenbach Scharnachthal', 'Amsoltingen', 'Aeschi Ried', 'Engewald', 'Burgdorf Haus', 'B', 'HirSbrunner', 'Moser', 'bachLindenstr', 'Grnen', 'Reckenbhl', 'Niederdorf Hinterdorf', 'AarzieleRain', 'Schneit Hof', 'Landstrae', 'Erlach Das Pfarrd Sifelen', 'Bavweidli Bächi', 'Kehrli Brienz', 'Ziehl', 'Egglibergen', 'Hypothekarkaffe', 'Leifstgen', 'Seematt', 'Längenbergs', 'Sigristenhaus', 'Lohnstorf Mühlethnrnen', 'Gümligen Amselberg', 'Bnrgdorf Kap', 'Wohlen', 'Namsli', 'Zur KirchgemeindeAbtheilung NiederdorfViertel', 'Schönthal Hsr', 'Hindelbank Kirchberg', 'Bolligerburg', '- und Ober - Obernz', 'Banns', 'Bach-Grindel', 'Gasth', 'Klein-Gmmenen', 'Str Laupen', 'Heutlingen', 'Sigristhof', 'Berglistocks', 'Thoren', 'O.', 'Bähnli Hsr', 'Gadmeuthal', 'Greuzfelsborn', 'Gtschmannsried', 'Falkenplätzleins', 'LoinnMn', 'Rümligen Kaufdorf', 'Wetterhorn Vgl', 'WelschNeuenburg', 'Wynigshaus', 'Arnenbcrg', 'Vlligen-Krauchthal', 'Sant JohannesTag', 'Khn', 'Kir', 'Müschbachs', 'Kohlenbehälter Feuer', 'Jsenbolgen', 'Mhli', 'OponIonWs', 'Sennhütte', 'Die Kander', 'Papiermühle', 'Dieenberg', '- Rausch-Bach', 'Belp Pfarrdorf', 'Grimsel Ober', 'Bricnz', 'Berchtold', 'Benzlanistock', 'Einwohuergem', 'Wendenthal', 'Staatsapotheke', 'Oberwüstenbach', 'Oefch', 'Seusebez', 'Notenburg', 'Btzberg', 'Gümmencn', 'Hingebungen', 'Kirgeli', 'hl', 'Stettlers', 'Ninkenberg', 'Baselstraße', 'Roßalp', 'Brönnimaun Egg', 'Wthrich', 'Kirchlinda', 'Lobstampfe', 'Hauptthals', 'GsteigThal', '8ulvgloüenlmr', 'Klein-Roth', 'stratn', 'Cappelen', 'Allmis', 'Radelfingen Aarberg', 'Ober-Diebach', 'Löhrwald', 'Bach Schwarzenegg', 'Mungnau', 'Schachen', 'Schwanden Dorsch', 'Ostermundigen-Worbstrae', 'Gotthardstraße', 'Antheile', 'NiederOesch', 'Nüegsau', 'Hindcnlang', 'Merzligerr', 'Bad Uetendorfberg', 'Gtlisperg', 'Schloli', 'Tachsselden', 'Beir', 'Läberu', 'Mhliberg', '- Schlli', 'Saumweg', 'Lausten Hsr', 'Oeuiswyl', 'Lgenbach', 'Linden Hof', 'Münz', 'BachGrindel', 'OberAarjoch', 'lornstnton', 'Brggelbach', 'Hahnenbühl', 'Guggisberg Pfarrdorf', 'Dürrbach Hof', 'Menigberg', 'Alpenros', 'Von Habkern', 'Bnrgfluh', 'Haus Hs', 'Vlololiimmv', 'Gerberengraben', 'Heidbühlgut', 'Reichend ach', 'Weißenberghorn', 'Dentcnberg', 'Plaffeysn', 'Twann Uebrigcns', 'Wylerbrücke', 'Kantousgr', 'Jsgenstorf', 'Dittlingersee Bisweilen', 'Thalweite', 'Ebni', 'S-tdn', 'Lochenberg', 'Nthenbach', 'Ortsadel Teß', 'Laubcck', 'Kummer', 'Grimmen', 'Litschenen', 'Weissenau', 'Hoheneck Tnrbach', 'Huslimoos', 'Bnberg', 'Zeughausplatzes', 'Schau', 'Eisenerz', 'Freundhorn', 'Werdthfe', 'Lütterkofen', 'Wachholder', 'lenbach St von Wimmis', 'Landgarben', 'Pipinischen Grafschaft', 'Freiburgerstrae', 'Holzreichem', 'Agassi', 'Be', 'Schlienberg', 'Kandersteg Std', 'lliilllpoiK', 'Ziegelofen Säge', 'Jnterlakner', 'Halbinsel', 'Garstatt', 'Ober-Laueuen', 'Rothhornsattel', 'St. Johann', 'NoscnlauiBad Gletscher 614 Noßgartcn', 'Güzischwendi', 'Ringgenberg Brienz', 'Schloß Städtchen', 'Breitmoos Ober', 'Natrnm', 'Schüpbach', 'Bergweiler Ober', 'Mnchcnbuchsee', 'Juchli', 'llcüon', 'Friesenberg-Neuhaus', '- Twann', 'Gegisberg', 'Ghrnberg', 'Vil', 'Waldhof Höfe', 'Grindelwald Eiger', 'Könizth', 'Bundesrathhaus', 'Jahrmärkte', 'Lngga', 'Hinter-Habchegg', 'Grv-Viertel', 'Wachseldorn Wachteldorn Collektrvname', 'lumen', 'Ganz', 'Wetterlatte', 'Jffi-zenthal', 'Gemcinderath', 'Lyßbach', 'HabsburgKybnrg', 'Burgdorf Dieß', 'Thalkesscls', 'Mübleholz Hof', 'Müz', 'Flsch', 'Münfiugeu', 'Windgrabs', 'Bondelle', 'uK', 'Der Glysi', 'Scherlibach Oberbalm', 'Ksershaus', 'Bern-Kapitel', 'Tschentcnthal', '- Frisching', 'Schloß Oberhofen', 'Bromb', 'Brügglen', 'VorderEnggistein', 'Siuermxou', 'Brunnmhle', 'Unt.', 'Gnttannen Abthl Guttannen Oberhasle', 'Nieder-Balm', 'Gschneit', 'Aeschlimann', 'Den Twing', 'Ob.', 'Saanebrcke', 'Buchseemoors', 'Lubbach', 'Mllinen', 'Grbenbach', 'Rüpplisried', 'GanthiVelsen', 'Spiezmoos', 'Affoltern Kappelenbad', 'Bieter see', 'Brckfeld', 'Mötschwyl', 'Gräthlis', 'Geiß', 'Niesen Aeschi Frutigen', 'Eisenhammer', '- seau', 'Schwarzwassers', 'Bettelberg Nüfiswaldberg Std Lenk', 'Innert', 'Schppach', 'Comthurei', 'Aergw', 'Wikhartswyl', 'Gantersberg', 'Lrunnsn Hof', 'Obersteckhvlz', 'Bächlein', 'OberGoldbach', 'Jucharten', '- husi', 'Heustrich Emmen', 'Glowyl', 'Bderegg', 'Jak', 'Scheurer Mausoleum', 'Wohleyberg', 'Luls', 'Hörne', 'Zinsmaad', 'Wyttenbach Hof', 'Thurnen Seftigen', 'Mürren', 'Gro-Mhleberg', 'Murtenstraße', 'Brodhäusi', 'Tannenhof Taubsiummenknabenansialt', 'Rppli', 'Michels Kirche', 'Kraylingen', 'Hessigkofen', 'Kappelenbad', 'Krystalle', 'Eichbühl', 'Hippboden', 'Zwischenflh', 'SnlpiciusBalm', 'Schloß Aarmühle', 'Grünenberg Bnmbach Schangnau', 'FinsterAargletscher', 'Gersperg', 'Hellsttt', 'Balmhor', 'Mußmatte', 'Lngmoos', 'Schwärmereien', '- und Klein-Wabern', 'Oberschnegg', 'Affoltern Emmenthal', 'Zwiebelngäßlein', 'Moos Baumgarten', 'Tuftstein', 'Oesch N', 'Httlingen', '- Goldbach', 'Wstisth', 'Sefineufurgge', 'Amseldi', 'Liebefeld Landh', 'Reg', 'Thalseitcn', '- Simmenth', 'Weienbach', 'Beru VLU', 'Uttigen Ueten', 'Scherli', 'Helferci Kandergrund', 'Hulenthal', 'Aarinscl', 'Krhenbhl', 'Herrenmatt', 'Weinberg', 'Oelmichle Huf', 'Bümpliz Pfarrdorf', 'Khrechten', 'VorderArnibergs', 'VilmoiinAon', 'Felbacker Hof', 'Engstligengrund', 'Gehrisberg Gerisberg Gersperg Ober', 'Bockigen', 'Nagelfluh', 'Amtsweibel', 'Dorf Biglen', 'Schohalden', 'Vaumgarten', 'Köniz', '- lanei', 'Schloß Weiler', 'Emme Rüdligen', 'Mari', 'Fctschcrin', 'Ringoltingen', 'Netschi', 'Dorsch Ns', 'Kanderholz', 'Oberbergfluh', 'Oberhofen Gnnten', 'Gauligletscher', 'Berueru', 'Silleren', 'Höchstetten', 'Vurgbhl', 'Düttenberg', 'B lattiberg Brüchlen', 'Bergdorf Brünigen', 'Eichenbühl', 'Rnmedingen', 'Gltschbach', 'Solothurn St', 'Nudenz', 'Mlinens', 'Mooslaud', '- kirch', 'Stadtthore', 'Ballmoos', 'Gebirgs', 'Hopfern-Neuhaus', 'Schwarzeneck-Erizstrae', 'Hartisberg', 'Tonnerbühl', 'Riedlisperg', 'Langenthal Kap', 'Kridey', 'Ortbach', 'Torfmoos', 'Lithographie Littcwyl', 'Duoatus', 'Mühleberg', 'Bern Bnnd', 'Adelboden Thal Pfarrdorf', 'Schwarzenburg Gug', 'Aetigkofen', 'Alp Seefeld', 'Kronburg Hsr', 'Glysibach', 'Schmitten Lan', 'Gunten Gonten Gurbrü', 'Oberhofen Nefsenthal', 'Gaset', 'Leipzig', 'Gem XIII Hermiswyl', 'Großen Rath', 'Henzischwand', 'Rumeudingen', 'Bttenberg', 'Balmwald', 'Thurn', 'Grvr', 'Susten', 'Walkringen Burgdorf', 'Twingherrn', 'Ferenbalm Kerzers', 'Emme IViclon', 'Banmos', 'Dchlibach', 'Gradlisberg', 'Lobvuidül', 'Oeschinensce Oeschinenthale', 'FrittenbachViertel', 'Krattingerhaus', 'Nfenacht', 'ObcrSimmenthal', 'Lengnau Jura', 'Verschiedenes kiooliinAön', 'Schlößli', 'Emnienthal', 'Das reich', 'Münchenbuchfee', 'Münchenwyler Clavaleyres', 'Bockstege', 'Brschgengraben', 'Uechtsee', 'Laupen St.', 'Brnnen', 'See', 'Dießenberg', 'Gem III Schatteuhalb', 'Jungizehntens', 'Knutti', 'Schwarzwasser Sense', 'Hofwylsee', 'Landeron St Johannsen Stadt', 'Marktort', 'Männiggrund', 'Sumislvld', 'Haldenmoos', 'Tannwaldnngen', 'Schaffalle', 'Obcraar', 'Sauerbrunnen', 'Thierreich', 'Riegenen-Viertel', 'Langcncgg O', 'Affolternstrae', 'Tannengehölz', 'Emmeu', 'Alp Furgi', '- Dettigen', 'Glur Roggwyl', 'Bietz', 'Chnmigalm', 'Scheidegg Thalsch', 'Oppliger', 'Mauricius', 'Trubbnch', 'Ltschberg', 'Käderegg', 'Riggisberg-Wyslisaustrae', 'Könitzstr', 'Zzi', 'Walterswvl', 'Grindelwald Abthl BussalpJnnerorts', 'BordellBad', 'Scherlihubel', 'Briswhl', 'Gem Lyssach', 'Weicnau', 'Grünenbachs', 'Weißenberghorn Wytenberghorn', 'Grimselspitals', 'Ottenleue', 'Wallisergr', '§ Ebnit Lbinocle KU', 'Hallwyl', 'Hagneck', 'Bnmbächli', 'Mttenbach', 'Wirthsrechts', 'LanbeggZollstatt', 'Wegessen', 'Rittmal', 'Obcrbalm', 'Niedcr-Btzbcrg', 'Furggen', 'Oberes Thun', 'Wädischwyl', 'Berken Unt', 'Goldbach Ober', 'Schwandi', 'Gmmene', 'NiederMuhleren', 'AugustinerOrdens', 'Lünsperg', 'Tießbach', 'Lont', 'Pfingsten', 'Dürlocherhorn', 'Saaue', 'Linnach', 'Bnrgbühl', 'Engelhruer', 'Merzligerr Dorf', 'KleinWabern', 'er-B', 'Bergstraße', 'Bern der Landstraße', 'Leubriugen', 'Mannenberg Lanbeckstalden', 'Grt', 'Pltschbezirk', 'Ezelkosen', 'Bizwhl', 'Ochlenberg Oschwand Wohngeb', 'Riedbrg', 'Rehe', 'Allmendthor', 'Gsteig Steig', 'Kleinlanbersteck', 'Nothhorn', 'Zusatz', 'Lauberstock', 'Grien', 'Bockstein', 'Bann', 'Wald-Xtklioltorn', 'Schüppbach', 'Hirschmatt Schnlbezirk', 'Bözingen', 'Arve', 'Notthal', 'schihorn', 'Dingstatt', 'Mrwighorn', 'Bijouterie', 'Donnerbhl', 'Wiesen Felsen', 'Wattenwyl Wege', 'BleyenbachNütschelenstraße', 'Feuters-Oey', 'Sefinenthal', 'Arnisagen', 'Alpschelcn', 'Mühlibach', 'Haus Sumiswald', 'Langnau Sumis', 'Nidau Erlach', 'Neustrien', 'Schumacher Zunfthaus', 'Rschmaad', 'Egg Schloßgut', 'Thiergarten', 'Trtlisberg', 'Kirchberg Burgdorf', 'Buchwald sw', 'Waldeinöde', 'Langnau Huttwpl', 'Feldhäusli', 'Glasholzfluh', 'Widderfeld', 'Aiühlenen', 'Arnolfsmühle', 'OberSimmenthals', 'Niggis', 'Zehntschencr', 'Väuert', 'Rüeggis', 'Bergthales', 'Spital Bern', 'Käfichthurm', 'Faqade', 'Klein-Roth Langeuthal', 'Mhlheim', 'Arni der Hof', 'Bnchholterberg', 'Lobl', 'Kiesen Oberland', 'Burgthurme', 'Calanda Graubündten', 'Neuenburg Brunnadern', 'Kriegsnoth', 'Pfarrort', 'FinsterAarhorns', 'Suberg Dorf', 'Suleckgrats', 'Altholz', 'Imerius', 'Münstngen', 'Langenthal Langete', 'Bänuen', 'bnrg', 'StA Marchverbal', 'Grnhorn', 'Belpstraße', 'Rschegg', 'srz', 'Rttihubel', 'OberStocken', 'Mühle Schmiede', 'Kirchberg Kiltberg Hof', 'Lötscherberg', 'Brispach', 'Tschudi', 'UnterG', 'Edlen Erlach', 'Neu', 'Bern-Thunstr', '- gasse', 'Priorat', 'Augusta', 'Bellelay', 'Lügenbach', 'Hbernbad', 'Beru', 'Otzen', 'Völligen', '- pingen', 'Aarberger-Mooses', 'Breithorn Vgl', 'Rosengarten Friedhof', 'Emmenthal Alpenros', 'Urban-Zofin', 'Siegenthal', 'Pfarrd Ringgenberg', 'Drfch Hsrn', 'Tuchfabrikation', 'Baumgarten', 'Tscheppach', 'Belp Vgl', 'Freihaus', 'Hirsern', 'Ommiiu', 'Mülheim', 'Kapf', 'Oberer Drittel', 'Fcrrenberg', 'St. Michael', 'Feldzng', 'Attiswyler Zehnten', 'Aar Eyberg', 'Imitindero 1268 leintoiiderA 1275 Oent', 'Büchslen', 'Schloßgut', 'Kloster-Buert', 'Rafrütti', 'Luthern Eriswyl', 'Teß', 'Achern', 'Thun Nenhaus', 'Ghürn', 'Pestalozzi', 'Ly-Hindelbankstrae', 'Wurstembergers', 'Grimsel Std', 'Tennenbach', 'Weißenburgbad', 'Gole der Emme Goldsand', 'Jagberg', 'WiggiSwyl', 'Horben Niedern', 'Wystäthorn', 'Grsisperg', 'Würzbrunnen', '- schihorn', 'Notschalp', 'Brchli', 'Bern Blankenburg', 'Bellegarde Chateau dOex', 'Teufenbach', 'Kleiner', 'Tiefenaubriicke', 'Nidau Der Zehnten', 'Haubenberges', 'Rufshusern', 'Eichihöfe', 'Strtlingeu', 'Schowlandsgasse', 'RuchtiHeimathlein', 'Omnp', 'Bieberach Biberach', 'Bütenberg', 'Mettenb', 'Niedburg', 'Mvvonooli', 'Fr', 'Dicßbach', 'Freiburgerbergen', 'Abthl Zäziwyl Konolfingen', 'Hotel Nusiguo', 'Weienburgbad', 'Zaunegg', 'Alpenkette', 'Hasle Hasle', 'Vincenzen', 'Flühn', 'Hornfluh', 'Aar der Emme', 'Guntenstutz', 'Seidenberg', 'Grafenried Pfarrdorf', 'Urtenen', 'Sand', 'Vincenzenstifts', 'Ocstlich', 'Dnemark', 'Sehenswerth', 'Wengi Dorf', '- chirel', 'Schönenbühl', 'Burg Stocken', 'Gadinen', 'Nyfellcr', 'Engistraße', 'Ncsselbank', 'Nordsee', 'Rüdispach', 'Kappelen Weiler', '- selwald', 'Bhlberg', 'Deiwul', 'Mnster', 'Haslithals', 'Berg Schloß', 'Melcheubühlgnt', '- burgseelein', 'Seandinavien', 'Matt', 'Kauzcnhubel', 'Attisholz', 'Bemerkenswerth', 'Freundhorn Toldenhorn', 'Liebegg', 'Bagwyl', 'Michelthrlein', 'Hpbach', 'Tschuepis Tschuppis Haus', 'Waltrigen-Mhle', 'Amthaus', 'Adelboden Eisenstein Oberhasle', 'Obrigkeitliches Salzmagazin', 'Kirchets Meiringen', 'Langerberg', 'Berg Berg', 'St. lange', 'Mittelhäuscrn', 'Greussisperg', 'March', 'Pfrnndeinkommen', 'Waldstätte', 'Schoshalden', 'Erlach-Wuistcmbcrger', 'Eriswyl-Wyachengraben', 'Finsterhenneu', 'Wyl Bergschloß', 'Farnrain', 'Räthe', 'Hochgebirgs', 'Abbühl', 'Unterseeu', 'Emanuel', 'Steinberg Hauri', 'Römer', 'St. Thl', 'Kornzehntens', 'Mönch', 'Mattstetten Erlach', 'Stadtthor', 'Glungenbrnnnen', 'Stadtach', 'Brügg Gr', 'LsrZos', 'Nieder - Simmentbal St. Erlenbach', 'Kyburg-Habsburg', 'Urbanstag', 'Mllergasse', 'Kernenried Dorf', 'Holzbrnnn', 'Betingen', '- Bnrgistein', 'Burghorn Vorder', 'Rblihorn', 'Pltsch', 'Gäbelbachs', 'Benzenberg', 'Burgerspital Bern', 'Ahornen', 'Std Weges', '- lauenenschule', 'Scheuß Mett', 'Ltschern', 'Str den Kurzenberg', 'Daxelhofer-Haller', 'Ilolpensis', 'bern', 'Tannalp', 'Bürgleu Nidau', '- thals', 'Strahlhorn', 'HandeckSennhütte', '- Aarberg Aarberger-Moos', 'Unt', 'Freiburgerstr', 'Simmenthal St', 'Mühlebacko', 'Rebgut Engelberg', 'Savoyischer Fcldzug', 'Kurzeugol Kurzengold Hof', 'Ober-Bipp', 'Wengenalp-Scheidegg', 'Regest', 'Maldhubel', 'Aefligcu', 'Schwalmeren', 'Nidauer-Kap', 'Granfelden', 'Lueghubel', 'Hildolfingen', 'Ghrnwald', 'Spiez Urk', 'Ackerfeld Wiesen', 'Kirchthurnen', 'Goumvns', 'Steinmasseu', 'Straburg', 'Brienzerkartoffel', 'Tschiugellochtighorn', 'Mlenen', 'Walliser Windspillen Saanen', 'Brentzikvffen', 'Preuen', 'Rebmatt Hof', 'Rnderswyl', 'Ralligstöcke', 'Warmer', 'Lochseite', 'Blasenstutz', 'Steffen', 'Wohlen Säriswyl', 'Jasbach', 'Aerlenbachbrücke', 'Schangnau Eggiwyl', 'AetigerBerg', 'Argöw', 'Wyleroltingen', 'Zwischeubch', 'Nosenlaui', 'OberGurzelen', 'Gadmerwasser', 'Gotteshausleuten', 'Bs-Arni', 'St. Beaten', 'Naron', 'Zäziwyl', 'Niesen Frutigen', 'Aeschi Neichenbach', 'Münsterthurm', 'Gempelenbergli', 'Schallenberg', 'li', 'Lossoim', 'Elend-Kreuz', 'Obersch', 'Vom Diecht', 'LauterAarjoch', '3Stdn', 'Ackerweid', 'Lomiwtus', 'Engelalp', 'Aarberg Schlipsen', 'Stotz', 'Kastlanei Frutigen', 'Palmwoche', 'Handeck Gelmerhorn', 'Weißensteingut', 'Lvchbach', 'Giesenengrat', 'Kmtz', 'Ludnig', 'Nessenth', 'Luthern', 'Fankhauser', 'Ubert', 'Feldhusli', 'Spitalbühl', 'Lhbach', 'Oberberg', 'Jmboden', 'Melcheubhlgnt', 'Interlak Urk', 'Llmlimeüy', 'Orpnnd', 'Könitz Stein', 'Brglcn', 'Probsts Jnter', 'Jnterlaken Gsteig Jnter', 'Kniz', 'Alpscheln', 'Wyssachengraben', 'rle Chirel', 'Gasicr', 'GsteigB', 'Steffisbnrg Thun', 'Langen', 'Ahorngruppen', 'Aar Frauenkappelen', 'Grindel Bußalp Wärgistabl', 'Harder Angstmatthorn', 'Finster-Aarhorn', 'Oberzelg-4tel', 'Pfaffengraben', 'Jnstithal', 'Buwyl', 'Spitzhorn', 'Languau', 'Mlinen', 'Bntschbach', 'Fridegg', '- stein', 'Staubbachs', 'Thals', 'Gentelwasser', 'Karthause Tborberg', 'Jcnncr', 'Weißenburgberg', 'Schlo Heimw', 'Dießbach Abthl Freimettigen', 'Gurnigelbad St', 'Kirchhren', '- bachs', 'Dörfch Jfeltwald', 'Armillon Arnenbcrg Arnensee', 'Herolfingen', 'Rothenfluh Balm', 'Teufelsgraben', 'Leukerbad Wallis', 'Heerstraße', 'Ober-Waltrigen', 'Aerlenbach Erlenbach', 'Weistegen', 'Schohalden-Viertel', 'Frienisberges', 'Wyler V  H', '- Mhlibach', 'Alpenregion', 'Gem Gysenstein', 'N', 'Hint', 'Eichwaldes', '- Hermendingen', 'Biederen', 'Bruchgehrenberg', 'Std Belp', 'Breitfelds', 'Aargauerstalden', 'Bernerbancrn', 'UunoinAS', 'NeuBubenberg', 'Napf', 'Weitenbirche', 'Lcngnau', 'Murten Neuenburg', 'Rütihof', 'Rohrbach Aarwangen', 'Münsingen Abthl', 'Zum DorfDrittel', 'Rdlen', 'Lluvvlozwos Dorf', 'Bol', 'Scherli N  O', 'Amseldingen', 'Dorf Teß', 'St. nrdl', 'Martinsloch', 'Gern', 'Gasternholz Gaffern Gempelen Hsr', '- bezirk', 'Snlpicius-Balm', 'Tessen', 'Neuengut', 'Mühlenenstutz', 'Enetbachberg', 'Alpenrosen', 'Lochbad', 'Gtzi', 'Lei Bern', 'Rüthi Dorf', 'Sprri', 'Hegsbach', 'NlehfueS', 'Gchliwhl', 'Jschisth', 'FaLkenfluh', 'Kirchlindach Ober', 'Aelpithal', 'Kiltbhl', 'Waldan', 'Balmi', 'französ', 'Audienzaktnar', 'Murtnerthor 160 Murzclen 583 Museum', 'Lthard', 'Gld', 'ThunAllmend', 'Alchen', 'Mhlethurnen', '- O - W.', 'KileyAlp Dahin', 'Gießbach', 'Ammertenbach', 'St. Peter', 'Ramscr', 'Schloß Wyl', 'Grindelw', 'Niklaus St', 'Diesbach Ober', 'Grimselhöhe', 'Gohlhausbrcke', '- genstorf', 'Pfarrd Reichend', 'Sustenstrae', 'Klsterli Regsegg', 'Khgrimmiberg', 'Baggesens Parthenais', 'StG', 'Bern Rathe', '- ringen', 'Ferenbalm Laupen', 'Haus Bnbenberg', 'Sels Elsaß', 'Wydenhof', 'Niederwichtrach', 'Sonnseite', 'Gstcig', 'Obcrlyß', 'Brückfeld', 'Uabioorn', 'Geltersingen', 'Scheidwald-Bezirk', 'Gümligen', 'Vincenz St', 'Otterbach Jnner-Birrmoos', 'Egghlzlein', 'Heidenwcg', 'Därstetten Nied', 'Biberon', 'Novs', 'Thalsage', 'Aara', 'Ltänderäthe', 'Schneelinie', '- und Nieder-Sulgen', 'Murzendon', 'Feer', 'Kalchmatt', 'Mühlebach Twannbach', 'Gornerengrund', 'urk', 'Kblisbad', 'Dießbach Hauben Oppligcn', 'Bergfeld Hsr Signal', 'Gem Thun', 'Kirchberg Pfarrdorf', 'Nathhaus', 'Schulhs', 'Altenberghhe', 'Kuttlenbad', 'Habbach Wagisbach', 'Kallnach Kerzers', 'Lanencn', 'Scherli Dorf', 'Wendenstock Titlis', 'Oehle Sage Schmiede Stampfe', '- und Nieder-Simmen', 'Wichtrach St Bern', '- holz', 'St Blaise Gampelen', 'Ilorllwml', 'uUnt', 'Brandösch H', 'Bern Uri', 'Röplisried', 'Landsitz', 'Zrcherkrieg', 'Wirth', 'Bergschloß', 'Schloßhügels', 'Werkhof', 'Ramsperg', 'Leimen', 'Affoltern Groß', 'Gauwli', 'Balisalp Bahlisalp Balsalp', 'Altenberg der AltenbcrgViertcl', 'Münchenbuchsee Fraubrunnen', 'Büellikofen', 'Regsauschachcn', 'Prassen', 'Schernolz', '- wylersee', 'Bern-Lnzernstr', 'Niederhäusern', 'Fluh Hsr', 'Gampelen Vgl', 'Berghange', 'Langengletschers', 'Buchcggberges', 'Kirschbanm', 'Niedersimmenthals', 'Bisthums Konstanz', 'Garnbauche', 'Litton', 'Gebirgsthal', 'Zhringen', '- Drfch', 'Klein-Erlenbach', 'Querstraße', 'Murtenstr', 'Aarwangcn', 'Wartenberggraben', 'Dammhirschen', 'Daubenhorn', 'RüthiSchule', 'Saxeten', 'OberSimmenthal Zweisimmen', 'Schwefelkies', 'Schonholz', 'Negsbach', 'Nubaum', 'Gem Gumiswyl', 'Schafalp', 'Ber', 'Roscnlauegletscher', 'St. Bern der Murtenstr', 'Brunnmhlebach', 'Engt-Halbinsel', 'Enziberg', 'Güzi', 'Egernschwand Adelboden', 'Bürglenwaldes', 'Eisthal', 'Hellisbühl', 'Grebern', 'Herzogem', 'Bord', 'Bepterchingcn', 'Inner', 'Jegenstorf Münchenbuchsee', 'Därligen', 'Bohlseiten', 'Mnsterplatz', 'Adelbodenthäl', '686G', 'Müllerlaube', 'Romoos Enziberg', 'Btikofen', 'StP', 'Bttlassenhorn', 'Hundbhl', 'Pas Pfarrdorf', 'Nanflh-Vicrtel', 'Außerhos', 'Reckenbühl', 'Dinkels', 'Krovllllml', 'Bern Hülfe', 'Hsrn Höfen', 'Holligeustraße', 'Marzili', 'Psarrd', 'Schönthal', 'Rderichsboden', 'Langengletscher', 'Spitalkirchc', 'Maron', '- Barheggen', 'GuttannenThals', 'Wildhorn Laufbodenhorn', 'Grnen Burgbhl', 'Rüeggisberg Pfarrdorf', 'Wirthshäuser', 'Jtra', 'O. - Dorf', 'Bhlhof', 'Scheinenalp', 'Dießbach Ober', 'Mühlbach', 'Alanuschicfer Hasle', 'Abthl Brügglen Seftigen', 'Wcißenburg', 'Arbelhorn Spitzhorn', 'Oberfeld', 'Lolothurn', 'Alterthums', 'St. Jakob', 'NidAu', 'Magglingen Nrrooolin', 'Hotel Bellevne Hofstetten', 'Burgerrath', 'Uibi', 'Bucholterberg Luoollolter', 'Wasen HornbachViertel', 'Gr', 'Schwarzsee freiburg', 'OberSimmenthal', 'Büttlosa Bütlosa', 'OltenStraße', 'Bonderspitzes', 'Salvisperg', 'Ns.', 'Rothstaldcnhof Rotthal', 'Enzenbühl', 'Lyßwald', 'Gmlingen', 'Röthenbachs', 'Grawyl', 'Jlfis Trubschachen', 'Bätterkinden', 'Bleuen', 'Obcrhofen', 'Kieno', '- horns', 'Theiswyl', 'Erlach Olbbatiu', 'Schloß Erlach', 'Lengenbhl', 'Ltsckinc', 'Jmerius Ehemals', 'Dürrenwaldberg', 'Marpach Marbach', 'Rathhausplatz', 'Btschel', 'Zäringen', 'Bnndcrbach', 'Käsershaushof', 'Mnchen', 'Jaussi', 'Hasle Abthl Uetigen Bnrgdorf Std', 'Herzogenönchsee', 'Huttwyl Abhang', 'Bergkrystalle', 'Aarjoch', 'Türrenroth EriswylWyßachengraben', 'Gro-Dietwyl', 'Brünigs', 'äVinclomis', 'Alterthum', 'Uebergange', 'Frießwyl', 'Buchseemoor', 'Tietwyl', 'Rplisried', 'MoosSeedorf', 'Bernerfuß', 'Hrnberg', 'Berner Alpen', 'Thungschueit', 'oberer', 'Amsoldingen Ober', 'Eschau Scheidegg', 'Landger Konolfingen', 'Lsläar', 'RauschBach Gsteig', 'Bürg', 'Tägertschi', 'Jnterlaken sö Lanterbrunnen', 'Nieseten', 'Hirzenfeld', 'Ablndschen', 'Thuns', 'Emme Std', 'Weißenan', 'Mattenstege', 'Helvetica', 'Bruchbühl', 'Alchenflh', 'Pintenschenke', 'Haus Kabisberg', 'Tbeil', 'Scheidgasse', 'Mschlcr', 'Marechaussee', '- Rdligerwald', 'Breiten Hof', 'Raths Bern', 'Blwestatt', 'Rüdligcn', 'Langnau Pfarrdors', 'Gangolf', 'Nenbrücke', 'Gem Aegerten', 'Jntzi', 'Büntschen', 'Schaffhauscn', 'Beaten', 'Drfch', 'Juterlaken', 'Stadtthürmen', 'Wendengletscher', 'Rath Haus', 'Aetzlischwand', 'Winkel', 'Bachwyl', 'Oeschibach', 'Drrsee', 'Bnchsee-Reg', 'Hagneck Epsach', 'Rdcrswpl', 'Romang', 'Namscrn', 'Dürrenflüh', 'Nikl', 'Riedsttt', 'Ligerz Tüscherz', '- Nain', 'zcrstr Hsr', 'Hnenberg', 'Gimmelwald III Mürren', 'Kilchschwanden', 'Gopplismatt', 'St ebendahin', 'Wintermatt', 'Bergweiler Schwenden', 'nberg', '- Lanencn - Gsteig-Thal', 'Der Paß', 'Flußes', 'Tiebachgraben', 'Möuchenstein', 'St Stambach', 'Scknegg', 'Schachen-Viertel', 'Bachsee', 'Miescher', 'Kalberhöhni', 'Niederösch Brügger', 'Glütschbachs', 'Wartenberg', 'Berges Thl Tannwäldern', 'Sack Ufer', 'Rebgnt', 'Nain', 'Forst und Bann', 'Weißenstein Landgut', 'Gem Thörigen', 'Laudmarch', 'Niederdors', 'er-Diebach', 'Brenzikofen Kiesen', 'Egkstein', 'Münster Wallis', 'Aar Man', 'Gryach', 'Kienthalfurgge', 'Nieder-Mnhleren', 'Austrasien', 'Dav', 'Rawylpa', 'Vllgitern', 'Jmerins', 'Kander Simmen', 'Ansol', 'Klein-Basel', 'Landerou', 'Tschingelgl', 'Goldenmattgaßthors', 'Gsteigwyler', 'Win', 'Bieberen', 'Hell Mcienried', 'Alpberg Ahorn', 'Egg', 'Langentan', 'Spiegelberg', 'Freyburgerstr', 'Sandegg der Freyburgersträß', 'Khbnrg', 'Helvetier', 'Kriesbaumen', 'Strätlingen', 'Mzlenberg', 'Kastellan Grasburg', 'Walkriugenmooses', 'Mühlen', 'Nieder-Bipp', 'Koltrrv', 'Geltenberg', 'Untcrhards', 'Lenxingen', 'Oeschinensee', 'Nawyl Vgl', 'Kneulibächlein', 'Hohlefluh Felsenwohnung Std Alpen', 'Glütschbach', 'Lau', 'Bokes', 'nrk', 'Drienzerkäse', 'Leconrbe', 'Echenbhl', 'Morillongut', 'obern Hard', 'Seide', 'Katzensteig', 'Bärau', 'Felswalles', 'Snisbcrg', 'Schlowyl', 'Gampelen Siselen', 'Dem Amtmann', 'Wendelsteins Kirchthurms Frutigen', 'Stockenthals', 'Diemtigbergli', 'Hasius', 'Bäuert O', '- Habkerenthal', 'Gem III Höchstetten', '- see', 'Arburg', 'Heigers-Geisberg', 'inertenhorn', 'Holzersfluh', 'St. Neuenburg', 'Ferenbalm Lanpen', 'Alberstberg', 'Frutigen Frutigen', 'Oster', 'Hobgant', 'Christoffelthurm', 'Zur Dießbach', 'Freudenreich', 'Zweilütschineu', 'Unspunneu', 'Altholz Kolchenthal', 'Früher Sundlaucnen', 'Tscheppbach', ' luontsolion 1459  küonsvlion', 'Genfersee', 'Täuffeleu', 'Weienberghorn', 'Mündigem', 'Jnncrschwand', 'Neuenstadt Nods', 'Gstad', 'Brunnmühlebach', 'Urkundliches', 'Bergdorf', 'GroßAmmertenhorn', 'Adelsbühl', 'I  Aoräon', 'BernThunstr', 'Galliten', 'Hegen', 'Vincenzcnstift', 'LüthiwylBezirk', 'AarbergerMoos', 'Achsitbergs', 'Murifeld', 'Signau Eggiwyl', 'WiedliSbach', 'Griesen', 'Bach III', 'Alteich', 'Banmannshans Bumish Hof', 'Roßalp der Burg', 'Freibnrgischcn', 'Lauterbrunncn', 'Grsisbergs', 'Laubholz', '- Aargau', 'Aeschi Aeschlen', 'Oltschi Wandel', 'Großer Rath', 'Trübtensee', 'Jnselspital', 'Wildhorn Geltenhorn', 'Hnttwyl Vgl', 'Neßleren4l', 'Nanflüh', 'Das Schloß', 'Scherlibach Brücken', 'Grindelwald Hasli', 'Emmcnthal', 'Thal Pfarrdorf', 'Straßberg', 'Dannenbühl', 'Oenz Oenzfall', 'Wdischwhl', 'Kien Jahrh', 'Landban', 'Lernn', 'Kanderthals', 'Voens', 'Rggisbcrg', 'Gaudard', 'Schloß Landshnt', 'Rauh', 'Stav', 'Buchsee Fraubrunnen', 'Blatten', 'Emme Zulligenhof', 'Buchs', 'Kahenstein', 'Ferenbalm Abthl Freiburgisch Ferenbalm', 'Str Signau', 'Ryhiner', 'Gem VIII Graben', 'MittelAlpen', 'Wyßbach', 'Altreu', 'Zeerled', 'Gossen', 'Grabew4tel', 'St. Peters', 'Nidauer', 'Mettenbergbrcke', 'Engstlenjoch', 'Republik Bern', 'Aar Uttigen', 'Längenberg', 'Babschwand', 'Gzischwendi', 'Torfstrae', 'Mittellegi', 'Goldbach-Farbschachenstrae', 'Allmendbezirk', '- holterberg', 'Grner', 'Tschachtlanei Frutigen', 'Matti', 'Ober-Dettigcn', 'Nessenthal Haus', 'Blatte', 'Schöpf Wachseldorn', 'Wengwald', 'Stofselberg', 'Rfenacht', 'Stübblene', 'Wald Weiden', 'Rthenbach', 'Bonder', 'Whnigenstr Waldsaum', 'Lieb', 'Wirthshauses', 'Schwanden zerstr Dorf', 'Aeschi Stuhl', 'Bleiche Hammerschmiede', 'Thal Rothhorn', 'Ger', 'Baursame', 'Frutigth', 'Schönenfels', 'Gasthansc Hügel', 'Wiedlisbach Bern', 'Johannisinsel', 'Llnioiiiiiduoll', 'Thon', 'Bärhegen', '- tiugen', 'Jnterlakeu', 'Schloß Bremgartcn', 'Weißstegen', 'Balme Nothenfluh', 'Rheinsalm', 'Mrisegg', 'Martinsgrat', 'Aargletschers', 'Nied', 'Aargau Bern', 'Enggistcin', 'Murg', 'Ripplis', 'Jlfingen', 'Guggishorn', 'Lnstrum', 'Schwellen', 'Burgstall Büetigen', 'Emmenthais', 'Negotiant', 'Bad Std Weisen', 'Eggisberg Höfe', 'Vogesen', 'Gem Langnau', 'Pfarrd Kallnach', 'Vurghgel', 'Peters-Insel', 'Scheurer Mausoleum Th', 'Kirchthnrms', 'Dieser Berg', 'Hsr äViniKvn', 'Bern Fuß', 'Mörigen MörigenEggen', 'Rcnfer', 'Lock', 'Chorhaus', 'I Eriswvl Wynigen Pfarrdorf Bnrgdorf', 'Amseldingen Birchi Tiessenberg', 'Hübeli Hsr', 'Waldegg Waiden', 'Gütlisperg', 'Rudi', 'bcrn Wangen', 'Maricnthal Kloster', 'Psarrd Ligerz', 'Abläntschen', 'Waldsberg', 'Gem AußerBirrmoos', 'Rapperstübli Vgl', 'Ulmitz', 'Laupeu', 'Aegidius', 'Altenberghöhe', 'Waadt Saanen', 'Gmmenen', 'Seeberghorn Flo', 'Bangarten', 'Auer-Blumenstein', 'Beim Brodhänsi', 'Wollhusen', 'Nieder - auch O. - und N. - Rohrbach', 'Wrgisthalbach', 'Geistsee', 'Aarufers', 'Wintcrfutter', 'OberHohlen', 'Cour Sumiswald', 'Rothisches', 'Gmligenthlchen', 'Längeubühl', 'Das O', 'Roten', '- genbhl', 'Mhle', 'Schwendi Schwende', 'Spiez Jnterlaken', 'Kandersteg Kirche', 'Obertoffen', 'Nebengeb', 'Oberbnrg', 'Ober-Aarjoch', 'Zihlbrcke', 'InnsIinMn', 'St. Hnbberg', 'Graneggstutz', 'SenseThals', 'Sani', 'Trümmletenthal', 'Bleiken Schaubhaus Höfe', 'Erdpech', 'AarbergerMooses', 'Fermel', 'Klein-Mhleberg', 'Bärenflühli', 'Hchstetten', 'Ptschol', 'Kanderbrügg', 'Dürrbach', 'Offenburg', 'Reitbahn', 'Abthl NiederMuhleren Seftigen', 'Axalp Hinterburg', 'Adelbodenthl', 'Kalluach', 'Walde', 'Breu', 'Klein-Dietwyl', 'Kuratli', 'Tschugg Torf', 'Gisferhorn', 'S.idelhorn', 'Das idau', 'BiglenEnetbach', 'Mnchenbuchfee', 'Tschingelgletschers', 'Stellihorn', 'Frauchwyl', 'Giegisperg Hof Haus', 'Steinb alp', 'Ober-Aarhorn', 'Aarziele-Rain', 'Torfes Kien', 'Stauffer', 'Regsau', 'Felsengebirgs', 'SchwenLi', 'Kastvogtei', 'Frienisb', 'OberAarhorn', 'Henenschwand', '- tigen', 'Bodenzengrat', 'Bern Aarau', 'Reckenthal', 'Brienzer-Rothhorn', 'Mineralbad', 'via stratn', 'Palstina2', 'Grafenstein Grimmenstein', 'Eisenstein', 'Htaberg', 'Brechbhler', 'Wachsens', 'Pfarrd Zimmerwald', 'Aare Bremgarten', 'Aarberg Brücken', 'Oberthor', 'Psarrdorf Zngeh', 'Bder berg', 'Petri', 'Büttelspach', 'Weißensteinhölzli', 'Gem Gnggisberg', 'Wilderswhl', 'Doppelbnrg', 'Waggenmattgut Waggeumatt Haus Läng', 'Käsershaus', 'Scharnaehthal', 'Unteraargau', 'Sumiswald Trachsclwald', 'Ochlenberg Staufen', 'Schünen', 'RiggisbergWyslisaustraße', 'Amsol', 'Vincenzenstift', 'Grindelwald Pfarrd Wellenberg Hsrgr', '- Simmenthal', 'Bern Zimmerwald', 'Schlachthaus', 'Oberfeld Ort', 'Kuhlauenen', 'Sedel', 'Könitz O', 'Schwanden N', 'Hru Trog', 'Arch', 'Frutigen Bern', 'Hinter-Biembach', 'Nessen', 'Säeune', 'Hsr Mitholz Ueblenberg', 'Std Zmittenholz Felsenburg Zwischeubäch', 'Grnegg', 'Burgdorfhölzchen', 'Grindelwald Dem', 'IlutlUviluro', 'Melchnau Pfarrdorf', 'Negenbolshorn', 'Weyer Hollanden', 'Reben Schloß', 'Studcr', 'Rietwyl', 'Amsoldingerfee', 'Weicnburg', 'Drienz', 'Jnterlakeralpen', 'Rti', 'Rathhauses', 'Gro-Strnbel', 'Dorsch Hub', 'Frienisberg Kramburg', 'Büttenbergs', '- zenbnrg', 'Mühleberg Zugeh', 'Soau', 'Geyachbergs', 'Hohenalp', 'Grindelwald Bußalp', 'Ried-Aesche Aesche-Ried', 'Rtli', 'HornbachSchnlhaus', 'Mure', 'BürenAns', 'Rohuscrn', 'Blumenstein Thierachern', 'nterdorf', 'St. Sebastians', 'Aebtingen', 'Bucheggbergthlchcn', 'Niederhünigen', 'Redtligen', 'Dornbühl', 'LrkinZvon', 'Kaplanei', 'Reinisch Frutigen', 'Strub', 'Werdenberg', 'Gandeck', 'Gelmer Gälmer', 'Martiegg', 'Hochwald', 'Schmiedenviertel', 'Saussure', 'Utvnbiil', 'Balm Dun', 'Thuner Kap', 'Nieder-Simmenthal', 'Gächliwyl', 'Reinifch', 'Rümligen Riggisberg', 'Rothachen', 'Zweilütschinen', 'Willisau Huttwyl', 'Burgruine Gave', 'Rüwethal Nychigen', 'Lauterbrunnen Abthl', 'Baumgartner', 'Bach Grindel', 'Stutz', 'Deiwyl', 'OIiunoIlinSeu', 'Hrn', 'Martins sel', 'Sausbach', 'St Johannseuhans', '- stock', 'Nüblihorn', 'Bern Wallis', 'Haulerberg', 'Pfaffenmoos-Hlzli', 'Bielersee Westlich', 'Gran egg Hof', 'Diese Bäuert', 'Gsteigth', 'AllenwylKosthofenweges', 'Kosen', 'Frntigerland', 'WildElsigen', 'Schwarzsee', 'Hahn', 'Allgemeinen Oberland', 'Heidbühl', 'Drem', 'Tscherlschisthal', 'Bantigen', 'Aarbodenthals', 'St. Gallentag', 'HabsburgLauffenburg', 'Lpssach', 'Brunngaffe', 'Notenflue', 'Mettenbhl', 'Seewel', 'Räthe Bern', 'Mnnsingen', 'Bnben', 'Kirchenrath', 'Gem Hellsau', 'Hellischwand', 'Gnttanncn', 'Krone Gasthof', 'Murzeudon', 'Rättli Feld', 'Mhleberg', 'Griudelwald', 'JlfisViertel', 'StA Amfoldingen Pfarrdorf', 'Bache Kloster Höfe', 'Jmvbcrsteg', 'Ebendahin', 'Bühlzaun', 'Berg Birren', 'Walkrin', 'Burgdvrf', 'Blmlisalp', 'Weißenburgbaö', 'GroßHorben', 'Saanenlande', 'Kurzenoergs', 'Hessikofen Hettiswyl', 'Vortheilhaft', 'B lattiberg', 'Hsr Alp', 'Waldkilchenfeld', 'Ueber Blattenweid', 'Walperswhl Nidau', 'Frieswylstrae', 'Whlerbrücke', 'Emdorf', 'Rothenkasten', 'Martins', 'Rüthihof', 'Nydeckbrückgasse', 'Morizen', 'Heerden Hirten', 'Hauptwachtplatz', 'Wetterh', 'Spirenwald', 'Waldberges', 'Luginbhl', 'Mühlenen Frntigen', 'Knizthal', 'Breisgan', 'Galgacker', 'Eigergletscher', 'Nieder Btschel', 'Aspiwald', 'Briigglen', 'Saanenthal', 'Fluh Höfe', '- lauistock', '- ropa', 'Gserz', 'Mööslin', 'Amtsschaffncr', 'Pfaffnach', 'Wiesen', 'Gysdorf', 'Dr', 'Seeflnh', 'Falkenplätzli', 'Merligen', '- Simmcnthal', 'Mailänderkriege', 'Ris', 'Spitalbhl', 'Hindelbank St', 'Wynigen der Straße', '8unAlau', 'Bernerisch-Messen', 'Burgen', 'Herzogeubuchsee', 'Lbl', 'Gohlhaus', 'Haus Glissen', 'Tschuppelhäuslein', 'Thal Grindelwald', 'Weißcnburg', 'Aarmhle', 'Kapfenberg', 'Grauen-Schwesternhaus', 'Fehlistutz', 'Schiltwaldfluh', 'Vohnerz', 'Die Port', '- und Nieder-Alchistorf', 'Tfchamerey', 'Grimsclstrac', 'Bergjoch', 'Schlenmenberg', 'Füßli Schweiz Museum', 'Goldenmattgathor', 'Simmenegg Bern', 'FcuerS', 'Landw', 'Leiigenberg', 'Gsür', 'Gotthardstrae', 'Stuttgart', 'Bäuert Entsch', 'Tiefenau', 'EngiHalbinsel', 'Scheurer', 'Alchenfih', 'Nieder-Sinnnenthal', 'Niedern Spital', 'Kderegg', 'Nifel', 'Unter-Stutz', 'Gder', 'Wohnhsr', 'NiederGoldbach', 'Hochgsträß', 'Mnsterterrasse', '- Namsern', 'Gandeck Moräne', 'Frauenkloster', 'Auerdorf', 'ölomvston', 'Teufenbach Tiefenbach', 'Ltmplitx', 'Hattingen', 'Trunen', 'pcrswyl', 'Bellmund', 'Kzunis', 'Juter', 'Aarbergerstraße', 'St Schangnau', 'Aargletscher O', 'Lroolllnl', 'Oelmühle', 'Hiltbrand', 'innedasKlap', 'Constanz', 'Stdn Weges', 'Burgernziel', 'Oeli', 'Weim bergen', 'Bällitz', 'Langenegg-Grat', 'Pohleren', 'Nydcckbrücke', 'Mrtini', 'Gasthans', 'Alpweiden', 'Oberthorbrücke', 'Belpstrae', 'Stadholz', 'Schloß Burgdorf', 'Htschigen', 'Scheidcstraße', 'N.', 'Geihofbach', 'Stifts', 'Lkoullalle', 'Furkapaß Vgl', 'M §', 'Aeschbacherschachen', 'Dießbach Unter', 'Solo', 'Haus Zinsmoos Hsr', 'Frisching Bern', 'Lindenhof Basel', 'Spitalkirche', 'Mnchenbuchsee', 'Billigen', 'Noscnlaui-Bad', 'Trub', 'HellSau', 'Buren Aarberg', 'Banm', 'Walpcrswyl', 'Torf', 'Saone', 'Tannenbühl', 'Jnnkerngasse', 'Conr Bnrgistein', '- Lngenbergs', 'Mrsried', 'Lüt', 'Lütschine', 'Illusigus', 'Das Rüggisbcrg', 'Brienz Riuggenberg', 'Gürbethal', 'Kiesenbachs', 'Rebhügel', 'Goßliwyl', 'Gülten', 'Männlifluh', 'St Colombes', 'Brenegg', 'Nunclorvllltt', 'Belp Jak', 'Oertchen Riedli', 'Läng', 'Heiteren', 'NiiegsbachViertcl 618 Rücgsegg', 'Walliser', 'Ried Scheidgassen Niederdorf', 'Krö', 'Tieenberg', 'NiederSinnnenthal', 'Wei-Ltschine', 'Pfarrdrfchen', 'LaudiswylBezirk', 'Wer', 'Urathshörnern', 'Brandösch', 'Breitholz', 'Bürglen', 'Wyachcngrabcn', 'Museum naturhistorischcS', 'Tiemtigen Weiler', 'Haus Wirth', 'Mühledorf', 'Mädenschulcn Töpferwaare', 'Hohwürz', 'Rxau', 'Mura', 'Schellenwerk', 'Links', 'Schwarzseebade', 'Steinbrüche', 'Süri', 'St. Burgdorf', 'ZunfthauS', 'Nitzbach Nizbach', 'Nürnberg', 'Suls Std Reichenbach', 'Mhle berg', 'KänelGanterisch', 'Khrcchten', 'sterreich', '- Weienburg', 'Mättenbach', 'Kryingen', 'Jnterlaken Bern', 'Bargen Kallnach', 'Tscheuten', 'Tannenwald', '- cgg', 'Guardian', 'Weißenstein', 'Könizberg', 'Asfoltern', 'Jaggis', 'Khburg', 'Filderichbach', 'Almis', 'Bucheggberg Kriegstetten', 'Allwandingen', 'St Johannscnhaus', 'Stocken', 'Curried', 'Wachtthurm', 'Oberhofen-Gontenstrae', 'Sollalkelvn', 'Wyssa urk', 'Std Ueber Form Muschelsandstein', 'Nachbardrfch', 'Neubrcke', 'Feutersop', 'Villa iXova', 'Gampelenmoos', 'Heid Dorf', 'Tscheppach Tschingel', 'Kilchbühl Kilchboden', 'Schiedgcrichtssprnch', 'Pfaffenmoos', 'Diese Burg', 'Ltschthal', 'Stadnz', 'Bern Luzern Unterwalden', 'Snmpftiefen Schwarzenegg', 'Herzogenbuchsee Wangen', 'Moors', 'Burgcrenzicl Altenberg', 'Rohrbachstein Mittagshorn Rawylhorn', 'Die', 'Trfleinbez', 'Moos Hsr', 'Alp Engstligen', 'Btingen', 'Kiltberg', 'Wolhausen', 'Lnonlbaoli', 'Mühlestcttlenhof Mühlethal', 'St. Beatenberg', 'Zziwyl', 'Fundort', 'Thrishausstr', 'Sumiswald Joh', 'Kra', 'obern Aarthal', 'Gerol', 'Därligcn', 'Zazenwyl', 'Rath Bern', 'Tschugg Abhang', 'Wildstrubel', 'Btterkilw', 'Boßwyl', 'Alfermee', 'St Urban luvlistvtte Innvkst Thnnst', 'Halbinselterrain', 'Neuenegg Forst', 'St Bcatenberg', 'Rawylpaß', 'Ro', 'WntillMlo', 'Murten Kirch', 'Steg-Lindach', 'Querstrae', 'Afflentscheu', 'Whl', 'Blasen', 'HopfcrnSchach', 'NiederJbach', 'Std Ried', 'Illptinwnt', 'Std Bern Hindelbank', 'Ninderhorn', 'Neckhollern', 'Trimstein Dörfch', 'Lenzburg O', 'Suberg', 'St Peter', 'Stockenthal', 'Nov', 'Thun Vgl', 'Völligen Bern', 'Hcrbligen', 'St. Gotthard', 'Wascn', 'Rebgut', 'Khliwyl', 'Rybrücke', '- tingeu', 'Wynigcn', 'Vineenz', 'Negsau', 'NiederSimmenthal Dürstetten', 'Rtschelen', 'Aargletscher', 'Ober-Bucrt', 'Wynigen Burgdorf', 'Hinter-Kienthal', 'Kupferhammer Oel', 'Worbstraße', 'Rderswyl', 'Gro-Viertel', 'Heimwesen Boppigen', 'Grthlis', 'Thunersee Krattigen', 'Spühlibachs', 'Gmligenthal', 'Bellenkilchen', 'Khberg', 'Klenthal', 'Ober-Aarhorns', 'Waldcantonnemente', '- bchlein', 'Urbachthals', 'Kap Nidau', 'Mattenhubel', 'Walterswylhof', 'Glysi', 'Lauenensees', 'Därstettcn', 'Steiger Münsingen', 'Ksltonbrunnon', 'Adrians', '- wald', 'Gohl', 'Brisbach', '8uisse', 'Krauchthal Hsr Bühl', 'Rhonegletscher', 'Brüttelenbad', 'Tbdingen', 'Kern', 'Kühlewyl', 'Durgdorf', 'Saanen Abthl', 'Schrcckenbrunnengasse', 'Stähelegg', 'Meyenbach', 'Zsenberg', 'Buchsee Pfd', 'Badegeb', 'Vlliz', 'Bhnlin', 'Mäder', 'Herzogennchsee', 'Sestigen', 'Gchliwyl', 'Ooenctork', 'Kander Kandergrund', 'Eggerdingen', 'Faulhvrns', 'Blasenhorn', 'Alpenreisen', 'Frittenbach-4l', 'Laudsch Frutigen', 'Harder nw', 'Frauenkappelen', 'Solothnrnern', 'Rosenlaui St', 'Saxeten Stdn', 'thal', 'Otzenberg', 'Ligerz Vllll', 'Hursellen', 'St Urban', '- buchsee', 'Mannenbergs', 'Bunschen', 'Uebergangs', 'Nagelschmiede', 'Lanbholz', 'Bäuert Niedern', 'StockhornKB', 'Bötzingsn', 'Jnlande', 'Rtzliberg', 'Mohr', 'Judengasfe', 'Muri Bern', 'Sury', 'Spitalbühls', 'Hoh', 'Büren OberBüren', 'LauterAarhorns', 'Fluh Flüh', 'Sömmcrnng', 'Lohmatt', 'Mariä', 'Znll', 'Tannenbhl', 'Wiedlis', 'Lohner Vgl', 'Rußland', 'Heimenhausen Stäg', 'Vnrgstalls', 'Tbnnersee', 'Nieder-Oesch', 'Elblingen', 'Sulz urk', 'Brg', 'Wstethal', 'Unter-Diebach', 'Diebach', 'Aegertenberg', 'Mnslngen', 'urk Gastron', 'Wig Wik', '- platzgasse', 'Krrchlindach', 'MovsAffvltern Moosbad', 'Urtenenbach', 'Hügellabyrinth', 'Gadmen Zinkenstock', 'St Dieser', 'Frieslihaus', 'Lngenbhl', 'Muristaldcn', 'Fürstenth Neuenburg', 'KirchbergEmmenbrücke', 'Mittannen', 'Probst Jnterlaken', 'Wallfahrtskirche', 'St. Colombes', 'Aeschiegg', 'Dietwyl', 'Reichenbach Mülinen', 'Zyet', 'Buchensteg', 'Eberh Kyburg', 'Harris Harris', 'Burgistein Oberwyl', 'Thun Abtheilung Strätligcn Thun', 'Ursenbach Nohrbach', 'Jann', 'Kunidsy', 'Ormondsthale', 'Kappeli', 'Navensburg', 'SIwrceliiiAvn', 'Klsterlein', 'Webern Zunfthaus', 'Jffigenthale', 'Bunfahl Bonval Bonfal V', 'Vine franz', 'Grorath', 'Ersigen Oberösch', 'Olden', 'Doracher', 'Alpen Tschuggen', '- land', 'Dießbach Hauben Stalden Hünigen', 'Reggis', 'St Ilrban', 'Tufbach', 'Griudelwald Jnterlaken', 'Stcffisbnrg 1276 Job Steffisbnrgl 1279 Rud', 'Schloß Landshut', 'Thalfläche', 'Rhnkhofen', 'Reiffenmatt', 'Halerberg', 'Haus Oesterreich', 'Rthenbach-Sdernstr', 'Ramsei', 'Schloß Gutenburg', 'Hinter-Kicnthal', 'Ntols', 'Freiburger Straße', 'Geils', 'Ober-Wichtrach', 'Obstberg', 'Von Bächen', 'Höh', 'Schlößli Hof', 'Ochle berg', 'Sigriswylgrat', 'Suldthals', 'Hundsschüpfen', 'Aarberg Seedorf', 'Bchlisbach', 'Büttlosa', 'Trimlenbad', 'Gromann', 'Kronburg', 'Heloetia', 'Rüblenberges', 'Althaus', 'Albristhorns', 'Lötschthal Wallis', 'HühnerbachViertel', 'Erlisbach', 'erDießbach', 'Waldkirchen', 'Ndispach', 'Marcuard', 'Groschneit', 'Stocken O  N', 'LuolnIIon', '- perlublein', 'Gwärtistock', 'Schönislehn', '- stgen', 'Thurm BinserenHubel', 'Schulkadettencorps', 'Unterdorf', 'Jsely', 'Schlosses Pfarrhofes', 'Worblenfall', 'Nieder-Siebenthal', 'Ziegler', 'Cafo', 'Wydc', 'Bibereu', 'Melchthal Unterwalden', 'Kaseren', 'Schwendi Hsr Stalden', 'Strätlingeu', 'Mühlbachs', 'Trübtenbach', 'Birch', 'OltinZen', '- slh', 'Buchsee Kirchlindach', 'Schwarzenburg Seftigen', 'Finsterhennen', 'Commenthurei', 'Brunbach', 'Balderstal', 'Stockhornkette', 'Thunstctten', 'Bucheggberges', 'Solothurnerlandstraße', 'Jnu er-Emdthal', 'Hueben', 'Drstetten', 'Grvrath', 'Schüpfen', 'Venncrquartierc', 'Entsch', 'Geren stein', 'Biberist', 'Wigisperg', 'Eiger', 'Heinr Buchegg', 'Bracher Bend', 'Wurstemberger', 'Saaner-Wald', 'Lybachthal', 'Kehrli', 'Heidenstatt', 'Gollaten', 'Rüthi Filialdorf', 'Simmenstnrz', 'Grbcn', 'Frittenbach-Viertel', 'Bolzisberg', 'Salzbohrvcrsuche', 'Gerstenhorn', 'Wattenwpl 683 Wattenwyl', 'Mttiwpl', 'Enzi', '- berg', 'Grath Groth', 'Lüttiwyl', 'Schalunen', 'Vgl StWA', 'Klsterli', 'Oele Reibe', 'Hlzli', 'Strahlhorn Strahlberg', 'Kaiserthrones', 'OstermundigenWorbstraße', 'Bern Std Belp', 'Eintheiluug', 'Bärselbach', 'Urnerland', 'Murtnerthor', 'Giesingen', 'Buchholterberg Wachseldorn', 'Berns urk', 'Laugenstein', 'Bremgarten Wohlen', 'Andristmatti StA Andresmatten Hsr Bärischmatte Barischmatti Hsr Praffen', 'Oberbren', 'Ottelbad', 'OütsI Illusigus', 'Güzischw', 'Thunerseestraßc', 'Wohng', 'Teufelsburg', 'Das Pfarrdorf', 'Zihl Gampelen', 'Kser', 'Iluclisu', 'Trnb', 'Thun Ried', 'Str Herzogenbuchsee', 'Rickersholz', 'Nhonethals', 'Hochalpen', 'Balmboden', 'StegLindach', 'Münsterterrasse', 'Allmendingen Scherzlingen', 'H', 'Planalp Blanalp', 'Schlli', 'Schöpf', 'Krummeney', 'Lammerhorn', 'Allmenden', 'Gadmcnfluh', 'Schenkelgasse', 'HünliWaldhügels', 'Wcrdthvf', 'Obcrburg', 'Schloß Amtssitz', 'Matzenried', 'Bern Hindelbank', 'Stcuri', 'Ober-Steckholz', 'Rotenflue', 'Grbeu', 'Schumacher', 'Gletscherbach', 'St Amtssitz', 'Bern Emmenthal St. Bern', 'Belp Kehrsatz', '- Klein', 'Bern Seelhofen', 'Pfarrbaus', 'Schweizerlandes', 'Mauergraben', 'St. uzen', 'Dotzigen Büren', 'Gmligen', 'Saffoltern', 'Renhans', 'Tossenhorns', 'Rutzwyl', 'Wimmenowa', 'Wachthubel Hsr', 'Obermatt Wirthshaus', 'Namen Balm', 'NO', 'Strlcr', 'Brüht', 'Srihubel', 'Thierarzneischnle', 'Thormaun', 'Alpenpsad', 'Oblingen', 'Bad-Weiler', 'Aventicnm', 'Weibel', 'Gurgeten', 'Wabern Groß', 'Schloß Trachselwald', 'Obern Spital', 'Schlösser Fels', 'Wrgisthal', 'Weinwachs', 'Stanbbachs', 'Btterich', 'Brandts-Kyburg', 'Zeminis', 'Biberen Landger Zollikofen', 'Brieuzerb', 'Erlispach', 'Stockhorn der Reutigen', 'Eyberg', 'obern Straße', 'Nesson', 'Obere Spital', '- gisberg', 'Herrenvogel', '^-', 'Arni Dorf', 'Ried Dörfch', 'Wange', '- Ursenbachs', 'Luinmae', 'Knizstrae', 'Schloß Brücke', 'Sigriswyl Thun', 'Moosböden', 'Lauterbrunnen Gimmelwald', 'Diesb ach', 'Rawylhorn', 'UnterAargletscher', 'Nefsenthal', 'Balmos', 'Schlup', 'Nieder-Bleikcn', 'Grnenmatt-Viertel', 'Strätligen', 'Jmerius', 'Haus St', 'Freiburgstrae', 'Aegerstein O', 'Engstlenseelein', 'Mhlestcttlenhof', 'Burk Sumiswald', 'Shromk', 'Rm', 'Hoffstetteuk', 'Meiringen St', 'Negvtiant', 'Buchsee urk', 'Marbot', 'Drligcn', 'Oberschönegg', 'Hengstfluh', 'Schnthal', 'Distelzwang', 'Triftbach', 'Gruber Bern', 'Alten Grabe', 'Walpurgis', '- lingen', 'Simmenthal Albristhorn', 'Brandschbach', 'Nämi', 'Oberwyl Weg', 'Biberach', 'Spitalböglein', 'Muralt', 'Neubrück', 'Tnn', 'Niederfultingen', 'Bderberg', 'Wynigen Nieder', 'Btzingsn', 'OberGoldbachB ezirk', 'Rudolfs', 'Buchholterberg Thun', 'Tüscherz', 'Rohrbachs', 'Berfi', 'Sigenthaler', '- schinenthal', 'Knigsthal', 'üütoiplatz', '- strae', 'Alabasterweiße', 'Aeschauberg', 'Junten', 'Mühlidorf', 'Teilenbrg', 'Zihl Brügg', 'Attinghausen', 'Däfi', 'Weid', 'Hohenalp Lauterbrunnen', 'Schluep', 'Vienne', 'Kalberhhni', 'Wyttenbach-Biertel', 'Bavweidli', 'Leonh', 'Grenzmarchen', 'Janzcnhnns', 'Eblingen', 'Bdeli', 'Zosingen', 'Gimmelwald Mürren', 'Rathhans', 'Muhleren', 'Wydenloch', 'Dündenhorn', 'Schanze', 'Whnau Aarwan', 'Obwaldenschen Engelberg', 'Neu-Landorf', 'Schaafegg Heimwesen', 'Hol', 'Mau', 'Karthause', 'Hosen', 'Wolf Aargletscher Ober', 'Heltstttegg', 'Lchligut', 'Kandersteg St', 'Möösli', 'Frei', 'Metzel', 'Stettlen Vechigen', 'Brselbach', 'Köniz Aegerten', 'Mnfiugeu', 'Te Neuenstadt', 'Steigelberg Stigelb', 'Freiburgstraße', 'Hünigen Freimettigen', 'Nri', 'Weißenau', 'Vilett', 'Oberaargletschcr', 'Schloß Justinger', 'Bätterkilw', 'Mus', 'Rebberg', 'Mettenbergbrücke', 'Obermuhlern', 'Einwohnergem', 'Bürglcn', 'Steigelhorn', 'Tschameri', 'Egerdo', 'Johannserhau', 'Schloß Aarberg', 'Wirthshause', 'Urk', 'Brggen', 'Schloberg', '- posen', 'Znterlaken', 'Ryken', 'Husergr', 'Affoltern Moos', 'Nydeck Dahin', 'Erorbernng', '- bachthlchen', 'Rosenlauigl', 'Laubegg Spiez', 'Festlande', 'Moos-Affolternwald', 'Klingenberg', 'Gallentag', 'Erzeck', 'Lthy', 'Bmpliz', 'Lastwaage', 'Chablais-Moos', 'Mllen', 'XnsoltinAsn', 'Uebrigens', 'Gümligenthal', 'St Gumiswyl', 'Bätteualp', 'Habsburg-Kyburg', 'Ranflüh', 'Bremgarten Oberlin', 'Frutigen Das Thal', 'Melchsee St', 'Hofstatt Bremgarten', 'Lntschinen', 'Sense', 'Felsstocks', 'Brne', 'Ganthi', 'Sehohalden-Viertel', 'Aargauerstr', 'Reömann', 'Rümlingen', 'Mhlidorf', 'Berken', '8rmoim', 'St. tumbuok', 'Helferci', 'Mönchshorn', 'AußerBlumenstein', 'Walterswyl-Hof', 'Marmor', 'Stutz Thurnen', 'StM', 'Oranicn', 'Baschiloch', 'Ober-Goldbach', 'Ninggis', 'Raine', 'Triftengletsch', 'May-von', 'Schifflände', 'Jnn erB lumen', 'Stcklein', 'Prüm', 'Schlosse', 'Wengi St Bern', 'Schloß Brandis Feuer', 'Brünig Std', 'Wattenwhl Blumenstein', 'Hannenmoos', 'Gsterg', 'Vilmcrgerkrieg', 'Dosel', 'Dieses Schloß', 'Ried.', 'Pfarrb 1775 Thörigen', 'KleinTietwyl', 'Drrmhle', 'DernerAlpen', 'Mittaghorn Elsighorn', 'Engstligen Kandergrund', 'Grciffen', 'Oltschenen', 'Goldsand', 'Riesen', 'Frutigen Nieder', 'Bau', 'Mrsperg', 'Mngistorf', 'Almisberg', 'Ettiswyl', 'Aechen', 'Munizipalrath', 'Forst', 'Heimathlein', 'Grimselstraße', 'Mülinen Mühlithal Graben', '- Affoltern', 'Sch Mühle', 'Schnenberg', 'Wynigen St', 'Cistercienserordeus', 'Niedermuhlcrn', 'Zwischenbch', 'Luegberg', 'Kaufm', 'Diemtig berg', 'Lauenen Thal', 'Bcnd', 'Konolfingen NiederWichtrach', 'Schulthei', 'Habsburg-Kybnrg', 'Hirsboden', 'Kap Bern', 'Das Mühle', 'Teiwyl', 'Pfarrd Koppigen', 'nitz', 'Rath Burgdorf', 'Wimmis Tiemtigen', 'Bor', 'Brüchle', 'Saumstraße', 'lütschine', 'Pfranmholz', 'EriswylDorf', 'Ns', 'Mühleberg Pfarrdorf Kirch', 'Bex', 'Furgge', 'Aar Weissenau', 'Breitmoos', 'Lan', 'TurbachTh', 'Stdn Gurnigelbad', 'Zwygart', 'Röthenbach', '- Burgund', 'Albrist', 'Burgdorf-Kapitel', 'Sügiez', 'Wallis Sept', 'München Pfaffen', 'Ncuenburgersee', 'Kien Worb', 'St. Urban', 'Synoden', 'Marziele Marzielethor', 'Gotteshauslente', 'Innere Hsr', 'Alpschelen Alpscheli Berg', 'Eschlischwang', 'Saanen Rongemont', 'Flüh Fluh', 'AeschlenAlp', 'Rdligen', 'Nentigcn', '- Dettigen Hosen', 'OberAarhorns', 'Nieder-Sibethal', 'Buntsch', 'Othmarsabend', 'Kandergrien', 'Sternenberg Malefizsachen', 'Bttcnalp', 'Twann Nidau', 'Wangen ried', 'Bern 1361 Iwrlom', 'Herzo', 'Rath Solothurn', 'Stadtöach', 'St. Ilrban', 'Gurbrü', 'Schnisegg', 'Pfarrhause', 'Kirchets', 'Chamouny', 'Rnkh', 'Uri Schwyz', 'Mauritius', 'Steinbock', 'Rcdi', 'Gwatt Schorren Buchholz', 'Balm Stettlen Vechigen', 'Schultheißcnamt Burg', 'Geißhof', 'Uhrmacherei', 'Martiöegg', 'Bnigen', 'Vordertbeil', 'Burk Balm', 'Kalli', 'Mayenfahl', 'Langenthal Einwohneru Burgergem Unt', 'Str', 'Gilomen', 'HuttwylerAllment', 'Kander Selten', 'Häuf', 'Neutigen', 'HabsburgKyburg', 'Thieranatomie', 'O', '^', 'Altcrthumsspurcn', 'Wahlalp', '- lodingen', 'Franmattweid', 'Kranchthalberg', 'Schweiberg-Drittel', 'Dießbach Kirchlindach', 'Sigristenhof', 'St. Urbau', 'Tru bsch', 'Holligen Käderegg', 'Hruberg', 'Brienzerseestrae', 'Brnigen', 'Lüonol', 'Aargan Bern', 'Schongau', 'Todtenkirchhof', 'Leissigen Jnterlaken', 'OomiiiekinAen', 'Deißwyl', 'Torfstraße', 'Lüterkofen Nennigkofen', 'Lauenen Gsteig', 'Thnnstetten', 'Signau Trachsel', 'Bernegg', 'St Bern Konolfingen', 'Alpiglen Ober', 'Gave', 'Wandfluh', 'Ncichenbach', 'Brunnqueüe', 'Atigschwende', 'Wdischwyl', 'Lenkih', 'Sibethal', '- Btzberg', '- orn', 'Aar Ehemals', 'Aeschlen Aetigen Pfarrdorf', 'Der Limpach', 'Trajan', 'Tomdekan', 'Haus Feuer', 'Altren', 'Hs', 'Hochgstr', 'Morgarteu', 'Bäuerten Wenge', 'Lauter-Aarhorns', 'Frutigcn', 'Egerdongaffe', 'Balzenwyl', 'Steiget Brücke', 'Tampfschifffahrt', 'Stettler', 'Drrgraben', '- und Nieder - oder O. - und N. - Bttschel', 'Koniz', 'Hahnenmoosbergli', 'Vipern ntia', 'Chamberges Kappelhäuslein Haus', 'Nieder-Dipp', 'Mühlau', 'Trrmhle', 'Limpach Pfarrdors', 'Mülenen', 'Wieniger', 'Bangerten', 'Gasse Hauptgasse', 'Breitenwald', 'Jmerins Vllll', 'Gdel', 'Glatthard', 'NömischeAschentöpfchcn', 'Kapf Rebgut Hsr', 'St. Patten', 'Scfinenalp', 'Schloß Schadau', 'Grubenwald', 'Ilchvlliwl', 'St Maurizen', '- Ursenbach', 'Str Burgdorf', 'Haus Kyburg', 'Könitz Pfarrdorfu Bern', 'Jsrazweil', 'XIII Kapfgut', 'Ledi', 'Waldstrom', 'Joch Jochberg', 'Btschelbach', 'Wengi Bern', 'NiederWirtneren', 'Noggwyl', 'AltBubenberg', 'Kornhansplatz', 'Stg', 'Megisserhorn', 'Bltsch', 'Berner', '- Lehmbach', 'Sefilütschinenbach', 'Reichenbach Heutligen', 'Var', 'Bellerive Std von Thun', 'Büttiosa', 'KleinErlenbach', 'Zrich', '- bachthal', 'Cvnradsau', 'Nsch', 'Gutenbnrg', 'Schwanden-Viertel', 'Hauptthales', 'Eiuwohnergem', 'Sanetschpaß', '- Alpbach', 'Aarbergerstrae', 'Gutisberg', 'Bannwyl-Langholz', 'Emmenthalstrae', 'Grenzen', 'Lauterbrunnenthales', 'Thun-Kapitel', 'Otterbach O', 'Oberländer Schnee', 'Oertchen', 'Drrensee', 'Guggersbach', 'Rahnflüh', 'Eriswyl Std', 'Furenweid', 'Gries', 'Nydeckbr Bern', 'UnterWaltrigen', 'Ochsenkopf', 'Vremgartenwaldes', 'Bätterkinden Bern', 'Tracbselwald', 'Schilt', 'Schloß Scheuer Hof', 'Wangen amOenzbach', 'Gsteigthales', 'Mühlethals', 'Brcn', 'Gump Tiefe', 'Luzernstrae', 'Murzclen', 'Hcidenstatt', 'FarEs', 'Dachnaglergrabcn', 'Alb Bonstetten', 'Schöftland Alb', 'Dirvlie', 'Jaunthales Jann', 'Feldhof', 'Gunten', 'Burghalde', 'Thunstraße', 'Leiiggrat', 'Rynach', 'SchützenHans', 'Brand', 'Jnuerdorf', 'Lindenfeld Thörigen', 'So', 'Gastren', 'kirchl Stifte', 'Jttishäusern', 'Leiigermarch', 'Rüti Wyßenflnh', 'Oberbrhl', 'Schwefelgas', 'Bremgarten Pfarrort Schloß', 'Str Obersimmenthal', 'Schupposen', 'GroßAffoltern', 'Rüfenacht', 'Oeschincubach', 'Savoyen Gümmenen', 'Haus Snmiswald', 'Nydeck-B', 'Weienau', 'Heimathen', 'Bümplitz', 'St. Pfarrdorf', 'Gem Rumending Rnmedingen', 'Bußalpbach', 'Std Kirchdorf', 'Laucnen', 'Villars', 'Anshelm', 'Villmergen Linden', 'Hh gant', 'Weißeubnrg', 'Engibrcke', 'Kttikofen', 'LenkHahnenmoos', 'Strtlingen', 'Maser', 'Urbachth', 'Schmalzgrube', 'Höble', 'Diirrenmatt', 'Gehrisberg', 'Gibcl', 'Hagel', 'Klösterli', 'Brningen', 'Arconciel', 'Urbachsattel', 'Thörishausstr Brücke', 'Mnchenwyler', 'Limpach Fraubrunnen', 'ald', 'Kalberhhnibach', 'Bühlhof Bümpliz', 'Gem III Jffwyl', 'Angstmatthorn', 'Abth Schattenhalb Oberhasle', 'Lorbru', 'Bergacker ArniBezirk', 'Eigenthum', 'Kurth', 'Oenzfall', 'Palästina', 'Tscherz', 'Burgdorfern', 'Obermatt Feldmoos', 'Amsoldingcn', 'Egli', 'Ocmittntus', 'Knitz', 'OitinMii', 'Glashütten', '- tclbach', 'Fluspath', 'Breuw', 'Zum-Wald', 'Napperstübli', 'emmenthal Alpgem', 'Dndenhorn', 'Grüniberg', 'Fitzers', 'Allenberg', 'Bittlosa', '8nneti', 'Brück', 'Tromwyl', 'Klosterhubel', 'Kirschwachs', 'Mhlethaler', 'Hof Graben', 'Hinterga', 'Trbtenbach', 'Kirschwasser', 'Bühl', 'Hohenstollen', 'Bleien', 'Torfes Gals', 'Bttelspach', '- ltschine', 'Honig', 'Hsrn Franen', 'Fllestntz', 'Mühle Säge', 'Kandersteg Bühl', 'Iiobu Inmbn', 'Gambach-Ryffenmattstrae', 'Schultheienthor', 'Emmeuthal', 'Erlach Neuenburg', 'Lützelflüh', 'Nydcckbrcke', 'Ibten Jahrh', 'Wallendors', 'Eggenderg', 'Twannsluh', 'Hasli Rüegsau', 'Simmenthal aushnlsswcise', '- garten', 'Laup', 'Btschels', 'Privatsch', 'Folgendes Reuigen Ober', 'Grimsel Juchli', 'toiplatz', 'Ilnolwnlmoli', 'Urnerlande', 'Bielersees Tüscherz Twann', 'Tbring', 'Aarberg kirch', 'Mittholz', 'Ober-Jbach', 'BernerAlpcn', 'Fluhsee', 'Grnenberg', 'Thor', 'Wirthshaus Schmieden Gasthof', 'Bandelier', 'Frieswylstraße', 'Arlesheim', 'Laubbach', 'Sderen', 'Zieger', 'Kilch', 'Könizstraße', 'Wispillenhorn', 'Sefincnthal Jnter', 'Dungelschuß', 'Hochwart', 'Martishubel', 'Boden', 'Geilbach', 'Nidau Aarberg', 'Str Wattenwyl Blumeustein', 'Geißschwand', '- navien', 'Obere Stadtgem', 'Scharnachthal Frutigland', 'Bern Fraubrunneu Wangen', 'Trütlisberg', 'Bttingen', 'Engstlerjoch', 'ArniBezirk', 'Schermenholz', 'Breitlauenenalp', 'Rdcrswyl', 'Regsau-Schachen', 'Drrenwald', 'Enzen', 'Erlen Weiden', 'Von Scherzlingen', 'Bietingen', 'Twrenbach', '- gen', 'Thl', 'Frutigeuamtsmarch', 'Merzenchumm', 'Conolfingeu', 'Hchlisbhl', 'Lternen', 'Buchsee Worblaufen', 'Nydegg-Brcke', 'Saanen Das Pfarrdorf', 'Rüderswyl', 'Guttannen Gadmen', 'Wyler Grund', 'Thürme', 'Vrüggfeld', 'Oppligen', 'Strahleck', 'Spiez Brünig', 'Lotus', 'Nydeckbrückc', 'Nnterwalden', 'Sels', 'Waiden', 'Neggisbcrg', 'Vinclz', 'Nieder Bipp', 'Grindelwald Pfarrd Jsch', 'Schwbis', 'Buchenwald', 'Th', 'Kandcrthal', 'Burgerraths Bern', 'Ezelkofen', 'Anziehendes', 'AußerKrankenhaus', 'Steffisburg Alchenfiüh Zollikofen', 'Vierwaldstttersee', 'Nieder-Emmenthal', 'Weißenburg', 'Glashütte Lauterbrunuen', 'Frutigbad', 'Posthause', 'Kohlhaus', 'Hessenhof', 'Std nordwestl', 'Hemlismatt Emlismatt', 'Murren', 'Nathsspruch', 'Pfarrh', 'Tbalhaus', 'Turbach-Th', 'Pfarrd Ligerz', 'Aarganer', 'Obstwachs', 'Hgli', 'Reulissen', 'Adelrein', 'Hardcrn', 'Ruland', 'Oenz Nieder', 'Lurgund', 'Bern Vlll', 'Rothenfluo', 'Schüpbergs', 'Senn', 'Krattiggraben', 'Vad Fritzenbach Stofselberg', '- wyl', 'Weißbachs', 'Bodezen', 'Balm Oberwyl', 'Simmeu', 'Melchenbnhl', 'Wrzbrunnen', 'Bern VuItinMa', 'Gem Bucheggberg', 'Schlueb', 'Wohngeb', 'Nöthenbach', 'St. Schangnau', 'Tttlingen', 'Thorbcrg', 'Arni-Drittel', 'Habsöurg', 'Mayen', '- telbach', 'Blankenburg Stdn Bern', 'Lnsperg', 'Egkenbühl', 'Leimeren Hattingen', 'Lnterkofen', 'Zihlmatt', 'Frutigen Eggen', 'Gentelbachs', 'Alp Sch', 'Gsteigthal', 'Mrkte', 'Schneggengaß', 'Valdratzstal', 'Brienz Pfarrdorf', 'Gyuch', 'Schmutz', 'Käsichgäßlein', 'Sennberge', 'Hochjägi', 'Juden', 'Mengen', 'Krambnrg', 'Grindelwald Jnterlaken', 'Abthl Vorderrüthi Seftigen', 'Gem Oberthal', 'Kanderbrgg', 'Kuhrechten', 'Mäderhorn', 'Bütigkofen', 'Schloß Hünigen', 'Jezikofen', 'Gländ Güter', 'Bhl', 'Vogt', 'Bramberg Laupen', 'Zollbrücke', 'Laupcn', 'St Jmmerthal', 'JschmattenThälchens', 'Brändlisegg', 'Hubel Dorf', '- Heimwesen', 'Zelg', 'Bietzwyl', 'Könitz Muri Ober', 'Landstuhl Sternenberg', 'Dungelbach', 'Dberlande', 'Wangen N  O', 'Telli', '- kette', 'Dorsmarch', 'Ligriz', 'Adelboden Ueschtnenthal Vgl', 'Seelandes', 'Ptschel', 'Rüschegg', 'Niederdorf', 'Schloß Pfarrdorfu', 'Schloß Wimmis', 'Saxe', 'Rud Aargau', 'Aeffligen', 'Ausland', 'Steg Weg', 'Hänglihorn', 'Schneidemühle', 'Sandackcr', 'Rud Strätlingeu', 'Riedstätt', 'Zugeh', 'Kisen', 'IVootiorswonllo', 'HornbachKurzeneigraben', 'U', 'Gsteig Jnterlaken', '- dach', 'Marggi', 'Fahrni Bnchholterberg', 'Burdollf', 'Hoburii', 'Jagdbnrg', 'Hh', 'Mühlebach', 'Brach', 'Außerschwand', 'Nieder-Wirtneren', 'Opelingen', 'Mnrgeten', 'Kirchb erg', 'Schlobergs', 'Schluchttheil', 'Worb Bern', 'Ranchenbühl', 'S  W', 'Vvuauei', '- Oenz', 'Hnbel', 'Antonienhauses', 'Prm', '- lenbach', 'Hinaufsteigens', 'Aarlanfs', 'Wigger', 'Schar', 'Brünig Lungern', 'Kandcrbriigg', 'Thalgrnnd Dungel', 'Ltschine', 'Krinnenalp', 'Schaub', 'Kandersteg Frutigcn', 'Langenthal Langenthal', 'Glcknerthor', 'Thierachern Thun Langenegg Blattenweid Ober', 'Almenden', 'Schlipfen', '- Staldenstr', 'Glstschhorn', 'Pfarrd Vechigen', 'Fräschelz', 'Hnni Jak', 'Hürn', 'Engi zerstr Hsr', 'Wohnhsrn', 'Gorgen', 'Vrandis', 'Wyenbach', 'Erlcnbach', 'Hammerschmied', 'Mnchegg', 'Str Ltzelflh', 'Spiez Niedersimmenthal', 'Diesbach Kiesen', 'Niederhusern', 'Zollikofcnstraße', 'Riedburg Höfe', 'Liebiwyl', 'St. Hochthal', '- Otzenberg', 'Heerden', 'Brnigpa', 'Schüpberg', 'Miwrule', 'Guggisberg illontouolün', 'Walterswylhof Kiltbächlein Walterswvl Boden Hof', 'Rüblihorn', 'FinsterAargletschers', 'Gummen', 'Hüttlingen', 'Arnoldsmühle', 'Römerzeit', 'Arnisch', 'Perrot', 'Faulensee Hsr', 'Martig', 'Saane Laupen Gümmenen', 'Trechscls', 'Zoß', 'Reichsland', 'Rysfersegg', 'Stauden', 'Lilvort', 'OberBalm', 'Gem Goldiwyl', 'Bühlhof', 'Jansbach', 'Neudruck', 'Goliwyl', 'Wrl', 'Schatt', 'Einwohnergem Wangen', 'Nydeckkirche', 'Bräschgengraben', 'Svlothnrn', 'III BumbachDrittel', 'Niederbipp Wangen', 'Weiler St Hochalp Hof', 'Eichholz Ban', 'WylerOltigen', 'Bri enz', 'SüdOst', '- fingcn', 'Mrigen', 'Bättwhlholz', 'Jffingenth', 'Nrnberg', 'Bndihorn', 'Engstligen-Thal', 'Nonbijou', 'Brunner Alb', 'Klösterlein', 'Erlach Fuß', 'Oltin', 'Allmen', 'Schyuen', 'Bremgartcn', 'Dali', 'Stubenwirthsch', 'Kirchhofmauer Fundament', 'BndIey', 'Napperswyl Aarberg', 'Kiberg', 'Teuffenbach', 'Negot', 'Riuderhorn', 'Spins', 'Torfmoor', 'Grauholz Unterweg', 'Ludnung', 'Schützenmatt', 'Stettler Nr', 'Schwanden O', 'Schup', 'Bntscheleck', 'Schuposen', 'Ghiirn', 'Walliser Aletsch', 'Lhßbach', 'Grnenbachs', 'Hinterbnrg', 'Mittellöwen', 'Finsteraarhorn', 'Ipos', 'Mühliberg', 'Hegspach', 'Aattvangen', 'Egg-Viertel', 'Saanebrücke', 'Weienburg-Bad', 'Kirchgem Oberwyl', 'Schwaben', 'Bern Solothurn', 'Schaufelbhl', 'Ritter Steffisburg', 'KleinTwann', 'Rothberg', 'Gilbach-Bnert', 'Schwalmeren Vgl', 'Emmen-Viertel', 'Rucf', 'Kolchenthal', 'Scharnachthal Falke', 'Brspach', 'Villen Pillon', 'Tittlingen', 'Haselstauden', 'Büttenberg', 'Eichihfe', 'Flschberg', 'Thal der Lenk', 'Kantons', 'Fischezen', 'Länggasse', 'VVglperirv', 'Worblen', 'Belpbergs Gerzensee', 'Juchen Einw', 'Suggithurm', 'Rüeggisberg', 'Aek', 'Homberg Thun Der Gipfel', 'Lrlombnoli', 'Grtter', 'Den Schneelauinen', 'Rdeli', 'Oberaargatt', 'Bern Bern', 'Neubrck', 'St Oeschenbach', 'Valmeck', 'Ebersold', 'Thalgelände', 'Bänert Gadmen', 'Word', 'KileyAlp', 'Zwetlütschinen', 'Lutsch', 'Wäsemli', 'Brenzikofen Eichi Höfe', 'Jochberg Engstlerjoch', 'Schmidengasse', 'Huudestall', 'Schuppose', 'Ksershof', 'Simmenbrücke', 'OberLindach NiederLindach', 'Sphlibachs', 'Twing Bann', 'Sohlflnh Scheibe', 'Bergthals', 'Bern Brunnadern', 'Bälliz Hsr', 'Bäderegg', 'Bnrgbhl', 'Roßalp Noßboden', 'Herzwhl', 'otthard', 'Affoltern Pfarrd XIV', '- genbuchsee', 'Nieder-Goldbach', 'Chrinnen', 'Thörigen', 'Kriechwyl', 'Ober-Wynau', 'Murtenstrae', 'Watteuwyl', 'Hiltolfingen', 'Schloß Reichenbach', 'Bitlosa', 'Schngau', 'Mhlibach', 'Blttisbachs', '- gisthal', 'Rmlisberg', 'Twingmühle', 'Geisberg', 'Kühberg', 'wyl', 'Alp Hinterburg', 'Grimselstrae', 'Bühlbach', 'Botanischer Garten', 'Kühlewyl Kühliwyl', 'Mnnimatten Frienisbergerwald', 'Stadttheil', 'Ins Erlach', 'Berge Gurten', 'Aarberg St', 'Engstlerberge', 'Lüzelflüh', 'Emmenstuß', 'Krn', 'Mhlithal', 'SpitalackerViertel', 'Winkle', 'Rormos', 'Diebach Konolfingen', 'Ober-Wstenbach', 'Nufshausen', 'Pfrundhofstatt', 'Kri', 'Morgenröthe', 'Schloß Laupen', 'Gelmer', 'Elseggen', 'HaslebrückUetigenstraße', 'Bremgarten Reichenbach', 'Sensenb', 'Seitenthal', 'Untersteckholz', 'Trttlisberg', 'Jegenstors', 'Eu', 'Riprechtsgrat', 'Beitiwyl', 'Bleiben', 'Tschuggen Alterthümliches', 'Grünenberg Langeustein Schnabelburg', 'Pfaffenhorn', 'Zehntens Brüttelen', 'Hürlisegg', 'Laueli', 'Neucnstadt', 'Schw arzenberg', 'Weißenbnrg', 'Chrinnenberg Krinnenalp Alp', 'OberWichtrach', 'Ilunciv', 'Nogget', 'Lichtmeß', 'Faulhorn Stdn Rothachen', 'Zürich', 'Ammertenth', 'Ehrom', 'Gieblitz', 'Grsisberg', 'Pabst Engen', 'Der Zehnten', '- Bergthal', 'Folgendes', 'Hlischwand', 'Aeschbacherschachen Schachen', 'Burgenstein Stdn', 'Finkenhubel', 'Entschers', 'Aegerten', 'GilbachBäuert', 'Gsteigthale Kts', 'Hintereggen', 'Obrecht', 'Nieder-Jbach', 'Brnnlein', 'Wrgistabl', 'Bochti', 'Bhmen', 'Bönigen', 'Burgercnz', 'Veatenberg', 'Rohrbach Aarwaugen', 'Thalbecken', 'Alabaster', 'Rothkumigrat', 'Lugibach', 'Melch', 'Tschndi', 'Freibnrg Breisgan Freibnrg Uechtlande', 'Lnggasse', 'Schnlh', 'Imporii', 'Engt', 'Mooseck', 'Bettenalp', 'Grimselstr', 'Gyrizenmoos', 'Bade Blumenstein', 'Spitzenberg Langnau', 'Ob', 'Lanbegg-Zollstatt', 'Bartlome', 'Bern Konolfingen', 'Htt', '- berge', 'Ramseren', '- Blumenstein', 'Kirchdorf Pfarrdorfu ehem Landger Seftigen', 'Moüens', 'Aeschi Eschi Ober', 'Zwingelh', 'Schleumen', 'Schlle', 'Wetterhoru', 'Helfereibez Rüschegg', 'Schwarzen', 'Münsters Bern', 'Gasthof Mühle', 'Zweiltschinen', 'Gugger', 'Riedergrat', 'Mnchenstein', 'Rnen', 'Thuner-Allmend', 'Grimsclstraßc', 'Hilsenenbrunnen', 'Scsterzligbrücke', 'Gnggli', 'Lschthal', 'Pfarrgem', 'Schloßmühle', 'Lyß', 'Kastelbühl', 'Burgbühl', 'Schloß Burgdors', 'Bort', 'Emmenthal Oefters', 'Erlach Landeron', 'Stucky', 'Huttwyler-Allment', 'Oberstutz', 'Neu-Schweiz.', 'Haus Boden', 'Alpenseen', 'Bucheggschlößlein', 'Schohaldenschlacht', 'Därlig', 'Galmitz', 'Aeschi Spiez', 'Vll5', 'Bach', 'Opfingen', 'Schloß Thun', 'Ravcnsburg', 'Rüderswyl Schönholz', 'Mittaghorn', 'Neueneckau', 'St. Bad', 'Papiermühlestraße', 'Mitordens', 'Bennenwyl', 'Aar Völligen Bern', 'Kienboden Hohkien', 'St.', 'Wangen Bay', 'LvmirioliinAon', 'Bäuert Ptisch', '- O Aarberg', 'Ulm', 'Gysnaufluh', 'Kirchberg-Emmenbrcke', 'ChablaisMoos Berg', 'Gloswyl', 'Engehalde', 'Berner Schneegebirge', 'Unter-Aargan', 'Kehrsatz Belp', 'Alpeli', 'Klösterli Kreuz', 'Längenbach', '- Radelfingenstr', 'Hühnli Hof', 'StA Allmend', 'Gamchigletscher Vgl', 'Klein-Twann', 'Vuvrv', 'Kienthal Dorf', 'Lt', 'Susten Wasen', '- und Nieder-Emmenthal', 'Hinterdorf', '- Mnch', 'FlühLach', 'Pfaffengraben Haus', 'Ammerzwhl', 'Müllen', 'Rthi Rthihof', 'Balmer', 'Aarberg Bern', 'St JohanserHaus', 'Sempacher', 'Knno', 'Schloß Spiez', 'Hohen Namstein', 'Oestreich', 'Wyhony', 'Saanen Schreckhorn', 'Dvrsfluh', '8ierv', 'St. Lomannstag', 'b.Burgdorf', 'Wandelhorn', 'Fromberghorn', 'Thun Burgdorf', '- Murgenthal', 'Granholze Hofwyl', 'Morsee', 'Jura Gestlcr Tessenberg Justisthal', 'OberPlacken', 'Grispach', 'Thu St.', 'Fnsi', 'Lopsingen', 'Mufingen', 'Bache Zelg', 'Schloß Heimw', 'KleinDietwyl', 'Ettenheim Schwarzwald', 'UnterGoldbach', 'Flötzkalkes', 'Thal zeHr Rüegsau', 'Murgetcn', 'Refisberg', 'Nidflüh', 'Ridan', 'Erlenbach Frutigen', 'Militärspital', 'Käserz urk 1294 Xerssx Dorf', 'Rüegsau Rüegsau', 'Ostermundigen', 'Bütschibachs Bitsch', 'Sörenberg Marienthal', 'Konolfingen Zollikofen', 'Niederbipp Abthl Niederbipp Wangen', 'Münster Bern', 'Mslin', 'Gronov', 'Thälchen', 'Grindel Schulh Graben', 'Allm', 'Ranflh', 'Bödeli', 'Simmenthal Zweisimmen', 'Ncgotiant', 'Sandsluh', 'Gottl', 'Oberburg-Gut', 'Auer-Birrmoos', 'Seefeld', 'Steghalden', 'Zeig', 'Schlosse Reichenbach', 'Winkten Winkel', 'Oberlin', 'Tiessenberg', 'Haslib erg', '- greis', 'Furka Wallis', 'Maßholder Ulmen Aspen', 'Neuenstadt-Tessenbcrgstr', 'Alp Baumgarten', 'Tas', 'Längwald Bähnli', 'Nesselgraben', 'Fraubrnnneu', 'Graben', '- Lind', 'Bondersattel', 'Elsaß', 'Mnribach', 'Rinderwald Frutigen', 'Std Vgl', 'Ltrata', 'Schmidigenhof', 'Wangen St.', 'Golatenmattgaßthor', 'Rosenlanigletscher', 'Josua Diebach', 'Schafberg Kihrel Chirel', 'Ztveistmmen', 'Kalchstetten', 'Gurzelen Pfarrdorf', 'Bipp Wiedlisbach', 'Solberg', 'Leen', '- halde', 'Arlesheim Baselland', 'Aeltcre', 'Bienbach', '- Oenz Wanzwyl Heimenhausen', '- miswald', '- Wald', 'Trüttlisberg Std Lenk', 'Elsa', 'Wirthsh Kaufhaus', 'Weien brg', 'Rüschegg Std', 'Nothcnbaum', 'Doffenhorn', 'Höhe', 'Thierbergs', 'Bern Abr', 'Sommerlatt', 'Egernschwand', 'Bärhegcn', 'Zringen', 'Wirthshaus Kalchofen', 'Lngeubhl', 'Pfarrdvrf Nthi', 'Patrizier', 'Luzern Entlibuch', 'Brbach', 'Ghsenstein', 'Rohrb', 'Dorsch', 'Jrrenbause', 'Laui', 'Grenz', 'Mühlethurnen', 'St. breit', 'Berggeländes', 'Oberbcrg', 'Nenbrcke', 'Hohkien', 'Jaberg Zügeln', 'Walkringen Höchstetten', 'Brienzergrats', 'Wyßenstaldcn', 'Musterthal', 'Maybach', 'St. Maria', 'Sulgcnbach-Viertel', 'Bram', 'Nngerols', 'Münnenberg', 'Alezbach', 'Thale', 'Schachenhof', 'Steinbergglctscher', 'Vvlkssch', 'Mahleren', 'Neubrckrain', 'Wohlen Hubel', 'Gadmen Thal', 'D', 'Bänderwald', 'Mhleth', 'Grchwyl', 'Gem Bremgarten', 'Rüegsau', 'Brienz Jnterlaken', 'Zehntens Gasel', 'V', 'Solothurn U', 'LauterAarhorn', 'Twiug', 'Allenwyl-Wald', 'Lindach Lind', 'Goplism', 'Traubachegg', 'Neßleren', 'Chumigalm', 'Münzsammlung', 'Bttwyl', 'Nothach', 'Te', 'Sal', 'Obernz', 'N.O', 'Berge Gletscherund Alpen', '- tenthal', 'Vanelberg', 'Gern III Schoren', 'Moos-Affoltern', 'Simmenthal der Wallisergr', 'Seehorns', 'Rderswyl.', 'Däfiloch', 'Brgglcn', 'Bürglen Kirchort', 'JbachHubel', 'Schwarzlütschiue', 'Allmeng', 'Koppigen Burgdorf', 'Bleyenbach-Ntschelenstrae', 'Brienz Ninggenberg', 'Röthenbach Signau', 'Spittler Pacht', '-', 'Msching', 'Burghorns Brienzergrat', 'Neuenegg Gümmenen', 'Blattenstein', 'Langenthal-Melchnaustr', 'Falchernbach', '- banmenhubel', 'Hintere Hof', 'Lauter-Aargletschers', 'Wyken', 'Wildstrnbels', 'Engelbrg', 'Beittenwyl', 'OberBrandhubel', 'Bottigen N', 'österreich', 'Hornviehs', '- Balm', 'Egertengasse', 'Edlen Aarwangen', 'Spiez Mannenberg', 'Aargauerstrae', 'kyburg Urbar', 'Edlen Lindnach', 'Aeschlen Hsrn', 'Pieterlen Bremgarten', 'Mhlethal', 'Sandstein', '- simmenthal', 'Bitsch', 'Türrmüble', 'Graben-Viertel', 'Soowilo', 'Ammannsegg', 'Tausch', 'Vucheggberg', 'Palme', 'Wynigc', 'Altenbcrg-Viertcl', 'Chrom', 'Griinsel', 'Mbleberg', 'Std Loh Loch Hsr Prasten Marchgraben Haus Achseten', 'Metzger', 'Johannsen', 'Lauenenseelein', 'KrMmuMu 1181 IlerMmuMn 1201 Ergs', 'Vrnzikofen', 'Flschackern', 'Schpberg', 'Burgdorfhlzchen', 'Jaspis Granit', 'Obcrbipp Wangen', 'Twann Geicht', 'Mnrtenstr', 'Niedernz', 'Tschanen Alb', 'Schppbach', 'Kantonsmarch', 'RomooserEnzi', 'Hrenberg', 'Ober-B', 'Gottstatt Aegerten', 'Alpberge Waldhöhen', 'Balmberges', 'Frienisberg St.', 'Neuenegg VLO', 'Kanderffeg Bütschels Häusergr Kan', 'Forstn Welschland', 'Höfe Hötschigen', 'Brttelenbad', 'Taunlihorn', 'Bülikon Hof', 'Vremgarten', 'Helferei', 'Rühnkhofen', 'Olisch enenburg', 'orb', 'Dorssch', 'Gcrenhorn', 'Nieder-Enzi', 'Lengacher', 'Pfaf', 'Rterichsbodeu', 'Spreitlauine', 'Eggstein', 'Aeschlen-Alp', 'Gutenbrnnen', 'Halbbrigadc', 'Bergdrfch', 'St Georgeutag', 'Ackerfelder', 'Langenthal-Kapitel', 'Bern Luzern', 'Jnterlappen', 'Bisth', 'Freisttten', 'Otten', 'Sriswyl', 'platzgasse', 'Emme zerstr Lauperswyl', 'ScheidgassenViertel', 'Wcienburg', 'Gruben', 'Wil', 'Srmmenthal', 'Bern Balm', 'Achsetberg Bort Der Stafel', 'Großer Spital', 'Wimmis Amsoldingen', 'Landmarch', 'Hüpfenwald Hupfen', 'Eichbhl', 'Rain', 'Sckwy', 'Schwalbe', 'OumilmZiu', 'Bäniseck Schafweide', '- haldc', 'Grvßrath', 'Altenberg Schwarzes', 'Oschwand', 'St. Beat', 'Elenden-Hcrberg', 'Pilatus', 'Grssisperg', 'Hinderlappen Unterseen', '6u4om', 'Uetendorfberg Amsoldinge', 'Thalstrecke', 'Seehalten', 'Seelibhl', 'Pfarrdvrf', 'Jnnerdorf', 'Brüggelbach', 'Bnchenlaubs', 'Gwatt Einigen', 'Nizbach', 'Münchenwyler', 'Lckadt', 'Schenchzer', 'Signau Langnan', 'Kienthal Frutigen', 'Thurnsn Seftigen', 'Bätterich', 'Aenetbachberg', 'Hilterfingc', 'Thunerstraße', '- riettaz', 'Enetbach Aenetbach Lnonlbaoli', 'Gemeindsbczirke Bach', 'Rz', 'kollevuo', 'Frobnrg', '8angenthal-St.', 'Uettligenseld', 'Lauperowyl', 'Andr', 'OberTießbach', 'Dahin', 'Affoltern von Weingarten', 'Mnchenwpler', 'Königsthal', 'Tannenhof', 'Instinger', 'Niedcrbipp', 'Hubberg-Viertel', 'Psarrdorf Hasle', 'Bhlikofen', 'Llingen', 'Nothstaldcnhof Hof', 'Grnd', 'Unterschwendi', 'Fahrni Steffisburg', 'Feldgcmarknng', 'Falch', '- zensee', 'Eis', 'Schwarzwasserbrcke', 'Ulm itz', 'NiederLindachwald', 'Pfarrd Worb', 'Wannengrat', 'Herrsch Toffen', 'Jfeltwald', 'Mhlethals', 'Bütschifluh', 'WRO', 'Suleck Vgl', 'Weien', 'Nieder-Gurzelen', 'Grünenberg', 'Vern', 'Nidau Walperswyl', '- Sd-Ost', 'Thalnngen', 'Saahli-Bez', 'Saanenlandes', 'Str Büren', 'kirchl', 'Bnchseebnch', 'Gro-Ammertenhorn', 'Schwcikhvf', 'ArAuurvv', 'Schuttgeröll', 'Haus Bern', 'Winkelbachmühle', 'Nüthi', 'Thronegg', 'Schnenfels', 'Storchengut', 'Brunnen', 'Bur', 'Aar Wankdorf', 'Rttiberg', 'MooS', 'Roßknubel', 'Näheres', 'Nchtland', 'Mühlethal Hsr Mühlen', 'Pfarrd Mnsingen', 'JnnerOrts', 'Nied.', 'Stämpach', 'Welsch-Neuenburg', 'Buri', 'Kalchstctten', 'Burgnnden', 'Waldhgel', '- sel', 'Dorfberg', 'Brienz Aeschi', 'Thörigenmatten', 'Dzberg', 'Lammerhorn GroßStrnbel', 'Sädelstngen', 'O. - N. - Weiler', 'Bieberach', 'Heidenmoos', 'Ortsadel', 'Reuß', 'Narrenbach Oeyen', 'Geißenthal', 'Scmetsch', 'Jochpaß', 'Mühlenen', 'Oberburg Hasle', 'Signau Ehre', 'Kastelbhl', 'Moor', '- Lindach', 'Lanterbach', 'Brombeerstrauch', 'Sumiswald Bern', 'Mnchy', 'Arni HornbachKurzeneygraben', 'Goldpisberg', 'Neucn', 'Lungernsee', 'Weinm', 'Ritzlihorn', 'Ortelengrat', 'Ningol', 'Guntcn', 'Ltschenberg', 'Freiburg St Murten', 'Lambbad', 'Aeuszere', 'Franoz', 'Büren Urk', 'Siechen Thun', 'Brriswald', 'Murten Laupen', 'Agiet', 'Brchbhl', 'Jsenbollingen', 'Grüsisbergs', 'Eck', 'Brienzersce Unterseen Jnterlaken', 'Giltstein', 'HasleOtzenberg', 'Gilb ach', 'Zinkenstöcke', 'Brning', 'Thalenge', 'Grafenbühl', 'Auerbach', 'Saanen Pfarrdvrf Thal', 'Erl', '- Oltigen', 'Schwarzlütschine', 'Grindelwald-EiSmeer', 'Hciligbühl', 'Frb', 'Almend', 'Kabisberg', 'Fahrbhlgasse', 'Muristalden', 'Grfisberg', 'St. Solothnrn', 'Lemerkenswerth', 'Lcnginen', 'Schlegelholz', 'Türrenroth', 'Kirchbühl', 'Ltschenth', 'Titlis Unter', 'Brfischenhaus', 'Jnu', 'Kriechenwyl', 'Vrlumünoü', 'Jffighorn', 'Ober Stcckholz', 'Brönni', 'Fuetcr', 'Luxus', 'Buchen Linden', 'Strt', 'Erbs', 'Brstenegg', 'Brunngasse Zeughaus', 'Kpfcr', 'Herzogenhaus', 'Langeten', 'Torfgasse', 'Schwerte', 'Teufelsburg Nüti', 'Landstraße', 'Triftenstock', 'Cartu', 'Schpf', 'rfch', 'Scheideck Grindelwald', 'Bahlisalp', 'SchallenbergWald', 'KalberhöhniThals', 'Tessekon', 'Forst Gurzelen', 'Schloß Nidau', 'Wiesenlaud', 'Ochlmühle', 'Alp Oberaar Aaren', 'Bechlen', 'Aeschiberg', 'Wallismatt', 'Br', 'Tachnaglercngraben', 'Zeerlederhaus Hof', 'Lanterbrnnnen', 'Lauter-Aarhorn', 'Frittenbach-Scha', 'Wohugeb', 'Scheid egg', 'Hasler Landsgem', 'Klein-Burgund', '- sching', 'Liebi', 'Niederwangen', 'Asra', 'III Uebeschi', 'St. Johaunsen', 'OberTettigen', 'ArniBerge', 'Frutigen Adel', 'Dietrichshause', 'Biet Erlach', 'Schenß', 'Hochburg', 'Dicbach', 'Roth-Bezirk', 'Strät', 'Gum', 'Schiltbach', 'Müzlenberg', 'Gsteig-B', 'Habeggcr', 'Kuiz', 'Flugbrunncn', 'Oertli Hof', 'Rothstaldcnhof', 'Engstlensennhütte', '- storf', 'Mrchen', 'Etzelkoven', 'Gynaufluh', 'Neuenegg Recht', 'Orpund Mett', 'Bietenwyl', 'Rohrbachgraben 613 Rohrmoos', 'Der Kirchthurm', 'Oossoim', 'KrummenackerWeidli', 'St Gallen', 'Ltzell', 'Btschifluh', 'Münsingen Tessikofcn', 'Oberey', 'Groß', 'Mätteli', 'Chorhans', 'Thalhang', '- senlaui', 'Kypbcrg', 'Vorberg', 'Bäuert Gilb', 'Linden Galgeuhübelein', 'Affenthal', 'Abthl Wilderswyl Jnterlaken', 'Bergweiler', 'Burgdorf VII Nied', 'Burgener', 'Gysenstein-4l', 'Palmegg', 'Trachsel', 'Kessithurms', 'Hof Landsitz', 'Oberhofen Unterscen', 'Steinberg Thierberg', 'Kurzen', 'Burgdorfhölzlein', 'Alp Breitenwald', 'Wildeschwand', 'Matten Filialdorf', 'Aanderbrgg', 'Alchenflüh Rüedligen', 'Almen', 'Reichenbach Frutigen', 'UIiokdn 1303 UrMllcolon 1325 Etzli', 'Trrbach', 'Srenberg', 'Suldthal Haus', 'Obergerwern ZunfthauS', 'Ober Simmenthal', 'Nydau', 'Leibgedingeu', 'Ar-ara', 'Privatschnle', 'Adelsbhl', 'Bifang bivrmel', 'Erlach Bern', 'ZHvald', 'Faulhorn Vgl', 'Fcldmann', 'Gram', 'Gypsmhle', 'Maybach Meyenbach', 'Sanbergbach', 'Bclpberg', 'Gurnigelbade', 'Hsrn Wirthshaus Krone', 'Greub', '- bergs', 'Bucholterberg', 'Brgg', 'Gampchi', 'St UnterStutz Dörfch Hsrn St', 'Sagiweidli', 'Mägisalp', 'Rickli', 'Bisthum Lausanne', 'Rämisgumm', '- Bern', 'DettenLhl', 'Diechterhorns', 'Pörisberg Bürris', 'Lehmbach', 'Thurm', 'Güterbez', 'St. Enswyl', 'Rthihorn', '8aiocIurum', 'Gundiswyl', 'Gurnigelba', 'Gem III', 'Gsgeu', 'Gampelen kirch', 'RiedViertel', 'LauperSwyl-Viertel', 'GambachRyffenmattstraße', 'Gadmenthale', 'Mühlethal', '- Rothbachs', 'Colombes', 'Aelpligletschers', 'InZsroe', 'Fera', 'Feldweid', 'Tschertschis', 'Bielerseestrae', 'Rcgsegg', 'NiederBützberg', 'Tas Haus', 'Aeckeru', 'Eck Egg', 'Rap', 'Thurnen Abthl Burgistein Seftigen', 'Haslebach', 'Büetigen', 'Thunersee Schutthalden', 'Krummeneck', 'Zweisimmen', 'Thals Dahin', 'Weißensee', 'Velscheu', 'Grabenstraße', 'Bad Std', 'Frutigstrae', 'Münster Gran', 'Einsiedeln', 'Polern', 'Auer-Latterbach', 'Vord', 'Sachslenthal Sachslen', 'Horben Reuti', 'Maa', 'Aarstrom', 'Vechigen Pfarrdorf', 'Bren', 'JnnerBirrmoos', 'Holzhalb', 'Höchstetten Konolfingen', 'Mathys', 'Jnterlaken Gsteig', 'Bades Rohr', 'Bettenhansen', 'Frutigerstrae', 'Byfang', 'Habchenwaldes', 'AlteubergTrittel', 'Das Pfarr', 'Reichenbach Schloß', 'Ursenbachs', 'Axalp Vgl', 'Hcidbhl', 'Schloß Bipp', 'Schafeck', 'Kolchosen', 'Neumühle', 'Uebcrfluß', 'Gwatt Vgl', 'demWorb', 'Mnringen', 'Wimmis Pfarrdorf', 'Drr', 'Mrisried', 'Küherhans', 'Vincenzenstist', 'Uusslev', 'Flös', 'Schongau Schöngan', 'llotraobiiiAön', 'Uelisbrunnen', 'Wassernoth', 'Balmberg Hs', 'Lauinen', 'Gottesacker', 'Flühlerche', 'Därstetten Pfarrdorf', 'Erlenbacb', 'Kiltbhlhof', 'Bleiche', 'Farn', 'VozwAS', 'Wolfg', 'Papiermühlestraßc', 'Orbacb', 'Vinzenzenstift', 'Hilterfingen Stocken', 'Holligeustrae', 'Brnigs', 'Vroburg', 'Lütschinen', 'Eriswpl', 'Steinegger', 'Paradies', 'Ltschinen', 'Wegscheide', 'Schwefelkiese', 'OberSeftigen', 'Panner', 'Zuzwyl', 'OppligenBerglein', 'Littcwyl', 'Mürren Ammerten', 'Suls', 'Stühlingen', 'Kolleren', '- perg', 'Gsteig Gsteig', 'Ghrn-Mertel', '- wyler', 'Ober-Simmenthal', 'Aeschlen Dahin', 'Dorsch Hsrn Mühle', 'KleinRoth', 'LyßHindelbankstraße', 'Unter-Urbach', 'Palästina2', 'Dietenwald', 'Predigerkirche', 'Zollikofen StA Urkundliches', '- brunnen', 'Koruamt Bern', 'Bad Oswald St Doset Schlößli Tauberhäusli Schloß', 'Büren', 'Bowegsthürlein', 'Handeck von Guttannen', '- Oesch', 'Nadelfing', 'Bockigen Man', 'Aeschi Leißigen Spiez', 'Affolter', '- Brchegen', 'Unter', 'Hohgante Furke', 'Bramergs', 'AußerBirr', 'Waldesrand', 'Kirchgem Languau', 'Mllenberg', 'OZo Nach', 'Weihorn', 'Hrlisegg', 'Gstaad Std S', 'Schwab', '- der-Simmenthal', 'Simmeuthal', 'Ober-Eichi', 'Bissen', 'Pleuerein', 'Stein Hsr amTschug', 'Grbethal', 'Krayigen', 'Holligen-Viertel', 'St AntonienRitter', 'Neust', 'Brunnenbachbad', 'Unterfluh', 'Jnterlakcn', 'ach', 'Tuftbach', 'Lthi', 'Gontcn', 'Beatcnberg', 'Kernenried Urtenen', 'Bechlinen', 'Becher', 'Freiburgisch-Ferenbalm', 'Räzliberg Daran', 'Wynau Ehemals', 'Silberbühl', 'OberSulgenbach', 'Ringoldingen', 'Detigenwald', 'Wyßachengraben', 'Bierhübeli', 'luzcrn', 'BernerHochalpen', 'Hülfe', 'Limpachthale', 'Gottftadt', 'Witschn', 'Köniz Bern', 'Aerlenbachbrcke', 'Jtenberg', 'Blatter-Ried', 'Mrren', 'Thal Snmiswald', 'Wig', 'Gen', 'Schöueck', 'St. Johannsen', 'Brüttelen', 'Schwengimatt', 'Ltzeloll', 'Gurmels', 'Etzenwyl', 'irk', 'Steffansfelden', 'Wytenberghorn', 'Tiefeuaubrcke', 'Aarzihle', 'Wärgisthal Bergbächen', 'Eggen', 'Barheggen', 'Vnchbach', 'Thun Steffisbnrg', 'Unspunnen', 'Nydeckbrckgasse', 'Secwyl', 'Bäuert Krattigen', 'solothurn Bncheggberg', 'Falkenpltzli', 'Unfern', 'Matten Grenze', 'Muristrae', 'Alpenwirtbsck', 'Oberbüren', 'Cliiniacenser', 'Jttigcn', 'Bern Thun', 'Bicrhbeli', 'Steinarten', 'Wiesenhöhen', 'Bren egg', 'Rodt', 'Ted', 'Aerlenbach', 'Doßenhorn', 'Brünnen', 'Gotthards', 'Schwarz', 'Schloß Hsr', 'Btscheleck', 'Simmenthales', 'Herzogenbuchsce', 'Pfarrdorf Wichtrach', 'Balm Ober', 'Gtzistihl', 'Schwarzhänsern', 'OberJbach', 'Waggeumatt', 'Strubeleck Frutigen', 'Krinne', 'Hinterbnrgseelein', 'Brumberg', 'Rauchmühle', 'Klaps', 'Büren Die Oberwyl', 'Btzbergcr', 'Zeiningen', 'Amsoldingen IV', 'Dantigen', 'Buren Man', 'Barthol', 'Laubbach Törfchen', 'Langenthal Brücke', 'Aetigen Lüßligen', 'Laucherhorn Suls', 'Gem Köniz', 'Brgglen', 'Finsteraargletscher', 'Doenhorn', 'Reisgrund', 'Predigerkloster', 'Sachslen', 'Jntertaken', 'Urech', 'Moos Hof', 'Twings', 'Münslngen', 'Posto', 'Birg', 'Eisenerz almcreckborn', 'Weiden Wiesen', 'Oyer', 'Gümligen Einwohnergem', 'Spital', 'Zeitglockenthurm', 'Mnchringcn', 'Wengi Wintermatt Alp', 'Bern Langnau', 'Heidenschnarre', 'Jsboden Jnter', 'Schloßdomi', 'Ebni Ebnit', 'Baselland', 'Straberg', 'Leuen', 'Afflentschen', 'Ref Bern', 'Enswyl', 'Ober-Balm', 'Affoltern Suberg', 'Briens', 'Brüggacher', 'Suselmatte', 'Gydisdors', 'Pfrund', 'Ulmitz O', 'Gyps', 'Wirths', 'StA', 'Pfarrrd Täuffelcn', 'Stnden', 'Zull 1710 Nothachen', 'Hünibach', 'Brgistein', 'Lochmannsbühl', 'Gassenhorn', 'Leim', 'UMM', 'Mnsters', 'Signau Thun', '- Abthl', 'Berghalde', '- Bubenberg', '- denbach', 'Gnertres', 'Tonisberg', 'Rfiswald', 'Cappele', 'Bowyl Würzbrunnen Oberhofen', 'Grafenried Gruben', 'Fahrstraße', 'Ochlenberg Homberg', 'Weiß Wörl', 'Vinelz Pfarrdorf Erlach', 'Clavalepres', 'Hühnerbach Hsr Höfe', 'Zmittenholz', 'Dentenbergs', 'Düzberg', 'eidegg', 'Alp Tschuggen', 'Garzen', 'Konrad', 'Salp', 'Palm', 'Saage', 'Icgenstorf', 'Unttcv', 'Podagra', 'Dießbach', 'Bisthnms Konstanz', 'SulgcnbachViertel', 'Wyttenbachgraben', 'Langenthaler-B', 'Bchtelen', 'Ringgis', 'Drstettcn', 'Twrenbachgraben', 'Gadmen Grindelwald', 'Schloß Twing', 'Mz', '- gletscher', 'Blümlisalp Winteregg', 'VLO', 'Kam', 'löükImMn', 'Närheggen', 'Simmenthal Uebrigens', 'Rebgut Echenbühl', 'Röthcnbach', 'Hinterburghorn', 'Thun St', 'AdelbodenHahneumooses', 'UZissclorl', 'IsthmusEingang', 'Kvsthofcn', 'Ltzelflh', 'OImrtreuLe', 'Sumis', 'Waldeck Graben Reichenbach', 'Mühleberg Ebersche KleinHöchstetten Wichtrach', 'Brswyl', 'Leuerenfeldcs', 'Aarjochs', 'Schlo Sch', 'Schloß Kirche', 'Zo', 'Jschbad', 'Seftigen Lindach', 'Obrist', 'Münsigen', 'Erbetlaub', 'Längenbühlsee', 'Pfaffenried', 'Ried Weiler', 'Schnbbl', 'Schadan', 'Frienisberg 1263 Frauchwyl', 'Vilmergen', 'Laupenstraße', 'Mittelaltcr', 'Schloß Nidan', 'Carton agefabrik', 'Egg Fluh', 'burg', 'Feren balm', 'Gadmensluh', 'Marchgraben', 'Lng waldes', 'Steinenbriinnen', 'Tabakfabrikation', 'Wartenstein Emmenthal', 'Rbeldorf', 'Pfarrhs', 'Gundischwyl', 'AußerOrts', 'vrf', 'Lüßligen', 'Gländ', '- laken', 'Bielersee St', 'VütschelViertel', 'Wystätthorn', 'Lötschenthal', 'Trachsclwald', 'Schauplatzgasse', 'Bonstettcn', '- Ob.', 'Trrenroth', 'Ritschard', 'Floßholz', 'Hasle Goldbach', 'Bösingen', 'Bucheggbergthälchcn', 'Nieder-Stocken', 'Oua', 'Bußalpgrat', 'Höhlisbühl', 'Schloß Buchsee', 'Geihubel', 'Osso', 'Emmentha', 'Großhorn', 'Schloß Bubenberg', 'Schoren-Almend', 'Hütte', '- Huttwyl', 'StA Bäche', 'Bellevne', 'Samuel', 'Aarzielethvr', 'Stiege', 'Bellikofen', 'Lerchen', 'Klima', 'Grandson Orbe', 'Bernerisch', 'Totzigen', 'Hauseck', 'Kienthal Vgl', 'Ontolsporg', 'Saage Schneidemühlen', 'Täuffelen Nidau der Pf', 'Prägelz hkreles', 'Schinkengasse', 'Jlisried', 'Geienthal', 'Reichsburg', 'Dürrenroth', 'Jsch', 'WildEisigen', 'Steffisbnrgl', 'Sigriswhl', 'Granholzes', 'Brügg', 'Gem Wyler Hasle', 'Rügen', 'Jttingen', 'Gurnigclb', 'Ballenbühls', 'Schloß Wimmis Jagdberg', 'Bregg', 'TwärcnViertel', 'Schwanden Dörfch', '- Maa', 'Merkwürdig', '- Allmeud', 'Tbales', 'Oberhvfcn', 'Juchart Dörfch', 'Grön Scheidwaldbezirk', 'Ticmtigthale', 'Münsingcn', 'Rpplisried', 'Brien', 'Burglauihorn', 'SehoßhaldenViertel', 'Gran', 'Sam', 'Krayligen Kreuzgasse', 'Matthias', 'Wüschen', 'Jakobshügel', '- Diebach', 'Nied. - Bleyenbach', 'Hornbach-Kurzeneigraben', 'Wald Märchen Brücke', 'Buwylgraben', 'Wald', 'Kerselen', 'Fellswall', 'Hugi', 'Pfarrhaus und Schloßgut', 'Weierhof', 'Std Solothurn', 'Alt-Bubenberg', 'St. St.', 'Franmatt', 'Thurm Schlaguhr', 'Horn', 'Gurtendorfs', 'St. Georgeutag', 'Barackenrain', 'UnterDießbach', 'Grindelwald Haslethal', 'Wallis Vgl', 'Lötschthal Strahlhorn', 'Völligen Abthl', 'Dänemark', 'Schöpfs', 'Morgarten', 'Aeschwald Hof', 'Lauenenhorn', 'Gerwern-Viertel', 'Aarganerheerstraße', 'Thörishaus', 'Siebenthals', 'Eichberg', 'Thl Kirchlindach', 'Borns', 'Horbengut', 'Ltschenthals', 'Schwäbis', 'Hirschmatt', 'Holol', 'Lterkofenbach', 'Donnerbühl', 'Kirchbhl', 'Bhlbubel', 'Thal zerstr Kirch', 'Mtigen', 'Altels Balmborn', 'SchwarzeneckErizstraße', 'Brandsch', 'Weienan', 'Gsür Adelboden', 'Thälch', 'Berncr', 'Bern Freibnrg', 'Helvetia', 'Thunerseestrac', 'Leuw', 'Barisch', 'Frick', 'Handeck', 'Grnenmatt', 'Winterswyl', 'OberDiesbach Konolfingen', 'KauderKanal', 'orf', 'Wahlerenhubel', 'Neubrücke', 'Aeschi Reichcnbach Frutigen Adelboden', 'Eichfeld', 'Tomann', 'Ramis', 'Große Spital', 'Stockenfluh', 'Latterbach StWA', '- Kohlholz', 'Thunerseestr', 'Bnchsgau', 'Scheu', 'Lngenberg', 'Nenhans', 'Kirchhgel', 'St. Martinstag', 'Lüterkofenbach', 'Eichholz Unter', 'kinpomi Ai8', 'Frittenbachgraben', 'Ober-Emmenthal', 'Tedligengraben', 'Kander Frutigen', 'Aarberg Affoltern', '- Emmenthal', 'Port Bräschgen Preschgen Hsr', 'Agraswyl', 'GroßDietwyl', 'Niederlindach', 'Brandts', 'Ober-Tettigen', 'Auerdvrf', 'Bümpliz Bümpliz', 'Beitenwyl', 'Ncueneck', 'Wildegg', 'Andern Vitriol', 'Weibachs', 'Thun Bern', 'St Bleuerhof', 'Riet', 'Nieder-Wichtrach', 'Stellhorn', 'Neunenen', 'Oberberges St von Saanen', 'Kleine Länggaß', 'Gcibhler', 'Schulhause', 'Forst Zwieselberg', 'Freigericht Steffisburg', 'Mhlen', 'Därstetten', 'Dieterswald', 'Tcywarzlütschinen', 'Buchseren', '- nenthal', 'Goldbachs', 'Vränzikofen', 'Bargen Pfarrdorf', 'Onxo', 'Walliserseite', 'Attenwhl', 'Grben', 'Roth Arni Lthiwyl', 'Brügg Brügg', 'InmsolinMn', 'Johannis', 'Gauchheil Hsrgr', 'Neggisberg', 'Habkern llnbvlmwn 1275 Uabioüorn 1309 Uaküerron', 'Falzenfluh', 'Schmiede', 'simmenthal der Lenk', 'Hundshörner', 'Entlebuch Burg', 'Lerch enberg', 'Faulhornkette', 'Wallis Wiewohl', 'Krn Albrist', 'Zunfthäuser', 'Schmieden', 'Tbnnersee Oberland', 'Bade Etivaz', 'Klein-Tietwyl', 'Jffigenth', 'Saone Burgund', 'Ar-ar', 'Erlenbach Nieder', 'Aarganerstraße', 'Grthof', 'Bruchenbühl', '- Neuhaus', 'Diemtigthales', 'Zihl Bürgten', 'Schwenkn', 'St Kaltenbrunnen', '- lenthal', 'St. lang', '- hofen', 'Unterscen', 'Ncucnschwand', 'Einstedl', 'Fontenen', 'Pfarrdorf Bümpliz', 'Bäuert Kirch', 'Klus', 'Klein-Emmenthal', 'Sennhütten Schwarzwald', 'Jstithal', 'Bäuerten Winkeln', 'Merligcn', 'Bramöergs', 'Teuscher', 'Thonschiefer', 'Multenmühle', 'Egrischwand', 'RüegsauSchachen', 'Khler', 'Galler', 'Agy', 'Gerisberg', 'Balmeregghorn', 'Hasenbnrg', 'Unterwalden Obwalden', 'Ländchen', 'Unter-Oeschenbach', 'Oberweng', 'Aaran', 'Sumiswald Langnau', 'Dornig', 'Orun', 'Gem Kandergrund', 'Ober-Ly', 'Wirthshaus Schmiede', 'StTM', 'Heidenhaus', 'Schilthorn von Lauterbrunnen', 'Mnfingen', 'Nothfallstube', 'Bremgartens', 'Tannlihorn', 'Rogg', 'Dali OberEichi', 'Laubeckstalden', 'Nydeckbrückenbaues', 'Doset', 'Hohwart', 'Sannen Ober', 'Lichtme', 'Nfiswaldberg', 'Gestlcr', 'Baumgarten Bern', 'Dürrenwald', 'Betschwyi', 'Leibundgut', '- W.', 'Seew', 'Höchstetten Dorsch', 'Schupf', 'Gerbe Hubenhof Hueben Lerch', 'Brttelen', 'Bäuert Hirzboden', 'TannenBad', 'Brodhusi', 'Gem Tüscherz', 'Hchstettcn', 'Oberwstenbach', 'Ratolfingen', 'Tschipperellen', 'Affoltecn', 'Alfermö', 'Thürings', 'Sünisberg', 'Urban', 'Rotthals', 'Lindenholz', '- Niederlind', 'Büe', 'Thun Pulvermühle', 'Thun von Neutigen von Thierachern', 'Hgschbach', 'Gasternthals', 'Trachselwald DasLandstädtchen Huttwyl', 'Büttschel', 'Burgdorser Kap', 'Ramsern', 'Jaberg Word', 'Kfichthurm', 'Jaberg StM 202', 'Edlen Priesen', 'Röthihorn', 'Wollenindustrie', 'Unspunuen', 'Wynau Pfarrdors', 'Bolligen Bandelier', 'Rüdeli', 'Stockbornkette', 'Wsch', 'Brnig', 'Bowegsthrlein', 'Bantsgen', 'Beinholz', 'Stadtwaldung', 'Alpberg', 'Vipern', 'Hintergasse', 'Heustrichbad', 'Oltigen Runtigen', 'Seebcrg', 'Irrenhaus', 'Lindenholzh', 'Türrmühle', 'Erbatta', 'Schpfen', 'Oberried Kerzerz', 'Freiburg Uechtland', 'Ueltschi', 'LauperswyttViertel', 'Melchsee', 'Hvrnbachgraben', 'Ebnefluh', 'Blumeustein-Bad', 'Margels', 'Kaltenherberg Kaltackerberg Weiler', 'Grterhof', 'Seewyl', 'Rebgut Wohngeb', 'buchsee Wangen', 'Ferenbalm Jerisberg', 'Beunberg', 'Aha', 'Aefligen', 'Gem BernerischMessen', 'Rötheln', 'Hornflnh', 'Jnkwyl', 'Lorraine', 'Hsr Mühle', 'Frutigcn Reichenbach', 'Sandsteinfelsen', 'Hnigen', 'Müufingen', 'Berchdorf', 'Haus Scharnachthal', 'Luolioltron', 'NüthiLängeneyWaldwegs', '- Fluh', 'Hohlen Rauchenbühl', 'SimmcnBrücke', 'Rormoos', '- hlzleins', 'Alpeuros', 'Meyringer-Thal', 'Ferenbalm KleinGümmcnen', 'Riesenau', 'LioüinAen', 'Grindelwald Thal', 'Engi Halbinsel', 'Jordan', 'Rüwethal', 'Palstina', 'Regsbachgrabens', 'Keßlergasse', 'Jsaak', 'Brodhäusi StWA', 'Längenbühl', 'Eschwyl Entschwyl', 'Egerten', 'Lötschenberg Lötscherberg', 'Obcr-Simmenthal', 'NiederDipp', 'Trb', 'Nägelisgrätli', 'Oberge', 'Eriz der Schwarzenegg', 'Unterthor', 'Trfch', 'HabstetttN', 'Neuchatel', 'Frutigen Aeschi', 'Buchholz Hsr', 'Halen', 'StA Mrchen', 'Wichtrach Kiesenbach', 'St. Oberaargau', 'Walkringen Pfarrdorf Kirchg', 'Freudenberger', 'Thales Mäniggrnnd', 'Rthi', 'Wynigen Hügli', 'Schwenden Chrinnen', 'Alphhe', 'Enz Enzberg', 'Münchringen', 'Blapback', 'BürgliWald', 'Stcinberg', 'UnterBühlikofeu', 'Zinkenstöcken', 'OltinZin', 'Erolswyl', 'Uttigen Thungschneit', 'Thunerstrae', 'Grdelisberg', 'Stürler Bern', 'Neuenfchwand', 'Schwar', 'Waadtlande', 'Alp Scheideck', 'Uechtlande', 'Wimmisbrücke', 'Ikons', 'Melchenbühl', 'Jochberg', 'Vnrgdorf', 'Nüncnflnh', 'Berner Oberlandes', 'Hochweydenalpen', 'Brglen', '- Ramsern', 'Wendenstöke', 'Topp', 'Srvsnckon', 'Oberei', 'Gipsreibe', 'Oberricd', 'Schmidten', 'Bühlbubel', 'Kantonsgr Bern', 'Bern Wohleyberg', '1uoobö8puoii', 'Schlößle Schlößli', 'Buchengehölz', 'Ober-Bipp nw', 'Drligen', 'Aarberg Walperswyl', 'Hürnberg', 'Lauterbrunnen Hasle', 'Thoracker', 'WeißenburgBad', 'Krähenbühl', 'Vühlfeld Hof', 'Bttscheleck', 'Nhnk', 'Thalgrundes', 'Worb Stettlen', 'Waldstrvm', 'Brtschi', 'Route', 'Kyburg Burgdorf', 'Ormond', 'Schnen-Frowen-Glein', 'Abthl Uetendorf', 'Blutthurm', 'Buch', '- derswyl', 'Mohren Zunfthaus', 'Heimath Byfang', 'Lyach', 'Guppenholz', 'Albligen Pfarrdorf', 'Schachen Dorf', 'Msern', 'Lvlothur', 'Emme Erstngen', '- Ly', 'Grindelwald Lauterbrunnen', 'Gnggisberg', 'Trub.', 'Gem XIV Ochle berg', 'ettenbergs', 'Ltzschenthal', 'Rütschelen', 'Kaps Vorder', 'Eschibach', 'Wald Münchenbuchsee', 'Ginn', 'Hauszins', 'Großrath', 'Qnerkette', 'Iluerens', 'VonZuzwyl', '- derschrinde', 'Grünenberg Babschwand', 'Oeler', 'Gasternthal Frutigen', 'Leissiggrat', 'Münster Granfelden', 'Bern Der Berg', 'Latreienbach', 'Utziugen', 'Engen', 'Weiler Dittlingen', 'Tessikofcn', 'SokeiäöM', 'Wildgerst', 'Hünigen Ober', 'Drrethan', 'Geniini', 'Wösch', 'Obersbach', 'Löhlisberg', 'Eoldbach', 'Sgiez', 'Mors', 'Kalkstein', 'Thores', 'Simon', 'Todtensee', 'Madrcisch', 'Lattrigen', 'Trogen', 'Große Räthe', 'St. Jvhannsen', '- Briswyl', 'Janzenhusen', 'SustenScheideck', 'Nblihorn', 'Franken', 'Habbach', 'Landwirth Oberwangen', 'St Morizen', 'Schreckhorns Gneis', 'Weißenburgbad Stdn', 'Kosthofcn', 'Matten', 'Erlengebsch', 'Kellerhals', 'Pfarrd Thunstetten', 'Gtch', 'Sundbach', 'Aar Bern', 'Badhaus', 'Egghlzli', 'Speichingen', 'Kirchthurm', 'Gool', 'Mauerhans', 'Wachthütt', 'Ev', 'Weienburgba', 'Kappelen Schup', 'Oltingen-Neuenburg', 'Brächershäuscrn', 'Mntschemicr', 'Barschwand - schwand', 'Gündlischwand', 'Gem Oberbalm', 'Enzberg', 'Mniggrund', 'Kalchmattenbergs', 'Schneehorn', 'Steigelschwand Stein', 'Gösgeu', 'Widdcrfeldgrat', 'Aebnitgnt Aebnit', 'Biberenflüßcheu', 'Bremgarten Bern', 'Fraubrunnen Regesten', 'Adlembhl', 'Eschau', 'Thun, ', 'Bützberg', 'Schreckhorns', 'Verona', 'Mediatland', 'Grn egg', 'Tannenb', 'Giegisperg', 'Kurzenberg Dahin', 'Kaps Hsr', 'Nrban', 'Tettnang', 'Wynigenthal', 'Laudvogtei', 'Opclingen', 'MoosAffolternwald', 'Grünen Lützelflüh', 'Wyler-Oltigen', 'Scheidgassen', 'Filialkirche', 'Vom O', 'Worb St', 'Hotel Bellevne', 'Alp Laushütten', 'Kirchhöfe', 'Thunstetten Pfarrdorf Aarwangen', 'Wichtrach Ober', 'Jungizehnten', 'Wiedertufer', 'Jdyllenlebeus', 'R', 'Brünig', 'St BrienzerRothhorn', 'Storr', 'Pletsch', 'Thal Lauterbrunnen', 'Namens Roll', 'Nägelisgäßlein', 'Hrn Pourtales', 'Brnunaderu', 'Schmitt Pilger Einsiedl', 'Torfbache', 'Hhnerbach', 'Burgisteiu', 'Aaran Zürich', 'Thdin', 'St Galler', 'Gümligenthälchen', 'Schpbergs', 'Hcrzogen', 'Mutach', 'Adelgoo', 'Chateau', 'Vlll Kalb', 'Niederdorf-Viertel', 'Rmkofen', 'Schadau 625 Schafalpen Schallenhaus', 'Mett', 'Renenberg Grenzstock', 'Jscher', 'BuchseeUrk', 'Stern enberg', 'St. Leerau', 'Sandsteinselsen', 'KyburgHabsburg', 'perswyl', '- Schwarzenbach', 'Barrakenrain', 'Prs', 'Wylerweg', 'Wynau O', 'Alfermo', 'Gerbe', 'Kirchplatz', 'Selbenzen', 'Alpen Burgistein', 'Schloßbergs', 'Rüschbach', 'Frthen', 'Sumiswald Eriswyl', 'Oberwallis.', 'Hohrain Weiler Hsrn', 'Stadttbeiles', 'Emme Breitenegg', 'aargau', 'Gfäll', 'Araris', 'Blanalp', 'Bourgeois', 'Drligbachs', 'Privatsamm', 'Freuudhorn', 'Lochberg Gridenbergli', 'Vttlosa', 'Gummalp', 'Reisiswyl', 'Reuti', 'Münchcnbuchsee', 'St Martins Altar', 'Geicht', 'Llisberg', 'Gerber', 'Steinkohlen', 'Wvnau', '- Untcrhards', 'BlumensteinBades', 'Rauchenbhl', 'Knitzberg', 'Blümlisalp', 'Gem Koppigen', 'Vnrgvogtei', 'Rthcnbach', 'Reu', 'Bern.', 'Gggisberg', 'Stöcklein Bärenried', 'Freyhaus', 'Eckhölzchen', 'Bern Burgdorf', 'selwald', 'Bötzingeu', 'Aeußern', 'Brigdelen', 'Emme Lützelflüh', 'Gupersmhle', 'Orvin', 'Zihlbrücke', 'Buchcggberges Kypbcrg', 'Hohbalm', 'Sträub', 'Oberlndern', 'Küblisbad', 'Hasel Tha', 'Jura 141teoti6i', 'Weißbach', 'Lehier', 'Alp Susten', 'Rtihof', 'ZollikofenMünchenbuchseestraße', 'Weinstegen', 'Stockhorus', 'Duchholz', 'Eiger Mörigen', 'Rieder', 'Moosegg Höfe', 'Todtenackers', 'Safnern Orpnnd', 'Tuffelen', 'Axalp', 'Snmiswald Trachselwald', 'Hiltbrunnen', 'haslethal', 'Gsnhorn', 'Thale Man', '- Hinter-Birchbhl', 'Spitalacker', 'Schlosse Landshut', 'Sattelegg', 'Schermenwald', 'Dungel 7089  Nothhorn 7031 der Dauben', 'Gole', 'Kvburg-Habsburg', 'GoldbachFarbschachenstraße', 'Vorder Hof', 'Goldenmattgasse', 'Ahorne Buchen', 'Aaruser', 'Th.', 'Heuberge Hundsrück', 'Nef Bern', 'Grast brg', 'Uevtw', 'Hindelbank Großmann', '- moos', 'Dießbach Bürcn', 'Rümlisberg Hof', 'Engelalp Frutigen', 'Germern', 'Ile', 'Ortsch', 'Zbinden', 'Erlenbach N', 'Thalbodens', 'Drfchen', 'Gallenstock', 'Haus Vgl', 'Thierachern Bodenzingen', 'Otmarsiugen', 'OberBüren', 'Adelboden Lauenenthal', 'St tumbuok', 'Auf Spitze', 'Münster', 'Lauenen Berg', 'Banmoos', 'Affoltern MooS', 'Langenegg Blattenstein', 'Borste', 'Waldhügel Ns', 'Furkc', 'Brgglindach', 'Weißenberghorn Die', 'Dttenberg', 'Laueneuhoru', 'Oossengx', 'Laugeustein', 'Küherhaus', 'Flühlen', 'Ortweid', 'Rüttele', 'Bantiger', 'Landwirth Alchistorf', 'Grndenhof', 'Riedbürg', 'Mährenhorn', 'Rahnflh', 'AußerLatterbach', 'Sondersiechen', 'Engelberg Unterwalden', 'Münnenbergs', 'Oent', 'Wattenwpl', 'Gmnmenen', 'Walther', 'Allemann', 'Muthes', 'Vierwaldstättersee', 'Bättwyl', 'Buxgän', 'Auer-Emdthal', 'Johannsenhaus', 'Ninderwald', 'Brenbach Bach', 'Hilterfingen Pfarrdorf', 'Bern Dießbach', 'Twann St PetersInsel', 'Kilchschwaud', 'Neugart', 'Ohmgeldbnreau', 'Wanchdorf', 'Wynigcr-Vcrtrag', 'Kirchenthurnen', 'Gadmenthal Unänwn', 'Seelibühl', 'Grn', 'PöschenriedBäuert', 'Kandergrund Gaffern', 'Libruims', '- dersteg', '- lhnrn', 'Hubberg-4tel', 'Jenny', 'Burgdorf Kap', 'Agassizhorn', 'Doris', 'Gemmi Seinen Namen', 'Metzgern', 'Fischcrgut', 'OberOesch', 'Diessenhof', 'Rthen', 'Chronikon', 'Frutigerstraße', 'Weiler Hof', 'Bielersees Fuß', 'Stutz Unt', 'Lanzcnen', 'Str Frei', 'St. Stephan', 'Helfers Jnterlaken', 'Blattenheid', 'Bangerter', 'Llulinon Fraubrunnen', 'HuSlimoos', 'Gerzensce', 'Falkenflub', 'Buchacker', 'Kenelthal', 'Gemsenfluh', 'Niesenkette', 'Häusergr', 'Mnch', 'Thun-Almeud', 'Ostern', 'Oberaar', 'Schwendi Roggen', 'Bestäti', 'Dörfch Stein', 'Schweiz Museum von Füßli', 'St Oberge', 'Jakoben', 'Sgesscr', 'Welschneuenburg', 'Rehhaag', 'Leuenberger', 'Tndengrat', 'Gelterfingen', 'UurKuilum', 'Kaufhaus', 'Bergdörfch', 'Grindelwald-Gletscher', 'urk stcnbach', 'Balmereck', '- schwendi', 'Berns Vgl Völligen', 'Aeschi St', 'Mannenberg Mannried Married Dorf', 'Negs', 'Lnotomviler', 'Aarmühle Wofern', 'Lauterbrunnen Grindelwald', 'Hasli Regsau', 'Miinchenbuchsee', 'Muristraße', 'Müllergasse', 'Ergsingen', 'Knlimeüo', 'St Hnbberg', 'Gurnigelberge', 'Kanderthalcs', 'Treiten', 'Alp Grindelwald', 'Schloß Bremgarten', 'Balmeck', 'Moosseedorfsee Dazu', 'Ltschithal', 'Könitzberg', 'Inorosse', 'KleinEmmenthal', 'Nenenegg', 'Bäuert', 'Bütschelbach', 'Thale Namens St', 'Dürrenroth Sam', 'Hau', 'Lngenbergstr', 'Gvhl', 'Langete Hans', 'Erlach Lehen', 'Tromelbach', 'Mannenbalm Hof', 'Netschbhl', 'Fitzer', 'Wetterhorn Oberberg', 'Thales Adelboden', 'Rothacher', 'Barschwand Berg', 'Arni Vorder', 'Egghölzli', 'Kastelenhubel', 'Morier', 'Pfarrd Ursenback', 'Matte', 'Lerg', 'Leutkirche', 'Ottichingen', '- - Alchistorf', 'Gem Hasleberg', 'Rutsch', 'Nicolai', 'Orpund Std', 'Barheg', 'Balm Frutigen', '- bad', 'Erlenfluh', 'Twingherr', 'Pfarrd er-Wichtrach', 'Schloß Aarwangen', 'St Ligerz', 'Knitzthal', 'Hubei', 'Alterthumsspnren', 'Achsitberges', 'losn', 'Münsingen Wichtrach', 'Tönn', 'Ober-Tiebach', 'Abcndbergs', 'Tnngel', 'Sternenberg.Das', 'Alchi', 'Bern Neuenburg', 'berg', 'Rtinrain', 'Aargau Emmenthal', 'Thälchens', 's.Oenz', 'Drig', 'Mhlcberg', '- Wynau', 'Dießbach Kiesen', 'Gümligen Welchen', 'Oberer', 'Lligen', 'Ebren', 'Friedensey', 'Wasserfluthen', 'Ouolm', 'AnßerLatterbach', 'Einiges  lollir', 'Stampach', 'Büetigen Affoltern', 'Herenfingen', '- tenbvrA', 'Röthenbach Röthenbach', 'Schorrenflnh', 'Wybach', 'Egrischwand Berg', 'Rabenthalwäldchen', 'UAanw', 'Seinen Namen', 'Backalp', 'Thierbcrg', 'Kehrsatzbach', 'Scheidbach', 'Thunersee Faulensee', 'Belp kirchgän', 'Barichti', 'Mnsingen', 'Rdispach', 'Stcffisbnrg', 'Mlineu', 'Pest', 'Ramsern Ramsern', 'Tiebach', 'Thierberges', 'GwattSpiezstraße', 'Schangnau Habkern', 'Haube', 'Lauterbrnnnenth', 'Schünenberg', 'Hagnek', 'Beriken', 'Friewyl', 'Elsigenalp', 'Lützel', 'Furggi', 'Zielibach', 'Glashütte', 'Ilooamw llsttereliinAon L0', 'Egg Hintereggli Höh', 'Steghorn', 'Herbligen Aeschlen Kurzenberg', 'Ochsenalp', 'Ochsen', 'NanflühVicrtel', 'Marpach', '- graben', 'Jmmerthal', 'Oswald', 'Sitten', 'Brndlisegg', 'Schulgem', 'Hilarii', 'Könizberges', 'Twingrecht', 'Bern Dümplitz', 'Grimmeustein', '- thurn', 'Sulglaucneu', 'Goldgld', 'Htte', 'Helgisried', 'Mohren', 'Nabenthal', 'Lötschberg', 'Pfarrd Münchenbuchsee', 'Urreelliims', 'Gcrzcnsee', 'Hclgisried', 'Habsburg-Lauffenburg', 'vgl', 'Kohofen', 'Spitallamm', 'Btigkofen', 'Ober-Hoblen', 'Frutigenbad', 'Ammertenb', 'Ober-Goldbach-B ezirk', 'Bleienbach Mann', 'Llmrtrouso', 'Enet', 'Flüßchen', 'Nydeckbrcke', 'Bern Gündlischwand', 'Charlottenbühl', 'Bttikou', '- wangen', 'Ltscherberg', 'Teutsch', 'Berner-Alpen', 'Mehringen', 'Laugnen', 'Vad', 'Marcellus', 'Bern Aarwangen', 'Erdharz', 'Jscl', 'Lombachthnrm', 'Neisiswyl', 'Hr', 'NdcrSwyl-Vicrtel', 'Steinhölzli', 'Badens', 'Guggisberg Schwarzenburg', 'Hitzig', 'Bern Vgl', 'Meiringen Vgl', 'Hchstetteu', 'Meli'}",8638
5711626,749881,"{'Neuengasse', 'Erguel', 'Schwarzcnberg', 'Untergassc', 'Ncucnstadt', 'Neueustadt', 'Leberberg', 'Kolmar', 'Pasquartthorthurmes', 'Twann', 'Brandenburg', 'Zihl', 'Alessandria', 'Pruntrut', 'Dijon', 'Oberaargau', 'Ergucl', 'Aarbcrg', 'Engelberg', 'Kornmarkt', 'Waterloo', 'Hcutte', 'Bozingcn', 'Petcrsinsel', 'Cormoret', 'Frankreichs', 'Ligcrz', 'Petersinsel', 'Bricnzcrsee', 'Fr', 'Huttwyl', 'Dcllsperg', 'Wien', 'Sesseliberg', 'Herzogcubuchsec', 'Italien', 'Herzogenbuchsee', 'Winterthur', 'Schmiedengasse', 'Bcllclay', 'Biet', 'Neuenbnrg', 'BielS', 'Solothurns', 'Erlach', 'Trautmannsdorf', 'Vcrneuil', 'Plentsch', 'Napoleons', 'Marburg', 'Neuenstadt', 'Tessin', 'Frankmont', 'Schafshausen', 'Neucnstadt', 'Frcibergc', 'Hanse', 'Freiburgs', 'Weimar', 'Neucnburg', 'Lissabon', 'Murtcn', 'Oberland', 'Rocail', 'Venedig', 'Brom', 'Ostscitc', 'Spechtberg', 'Uri', 'Bodcnsee', 'Jorat', 'Panncr', 'Pontarlicr', 'Eschenthal', 'Pictcrlen', 'Languedoc', 'Untergasse', 'Trient', 'Biberach', 'Waldan', 'Cornaux', 'Wiescn', 'Peterlingen', 'Bielmattcn', 'Montpellier', 'Jura', 'Kesselgraben', 'Madretsch', 'Nenenstadt', 'Vingclz', 'Stcrnenhimmcl', 'Meienried', 'Ostschweiz', 'Ncucnbnrg', 'Herzogenbnchsee', 'Orpund', 'Ncnhaus', 'Mittelland', 'Vinsler', 'Pasquartthor', 'Nidaumatten', 'Thnrgau', 'Reuchenettc', 'Farnsburg', 'Frankfurt', 'Leberberges', 'Spital', 'Nengnartier', 'Zofingen', 'Pontarlier', 'Kiel', 'Marchstcin', 'Muri', 'Europa', 'Meiringen', 'Dellsperg', 'Andlau', 'Magdeburg', 'Schweden', 'Fricdliswart', 'Cornol', 'Lyon', 'Schwarzenberg', 'Jlfingen', 'Eisengasse', 'Licgcrz', 'Lausanne', 'Schaffhauscn', 'Untcrgassc', 'Brod', 'Mattland', 'Mettfeld', 'Basilika', 'Bicl', 'Paris', 'schweiz', 'Baden', 'Ncuenstadt', 'Thurgau', 'Loosholz', 'Schwadernan', 'Mailand', 'Frciburg', 'Aalen', 'Gotthardbahn', 'Schmicdengassc', 'Reuchenette', 'Wiesengasse', 'Aargau', 'Lattrigcn', 'Magglingen', 'Prnntrut', 'Romont', 'Seeland', 'Rockhall', 'Meinis', 'Rhswit', 'Plcntsch', 'Scclandc', 'Savoyen', 'Sonccboz', 'Pasquart', 'Burgdorf', 'Bcllelay', 'Teffenberg', 'Frankreich', 'Ermattingen', 'Arlesheim', 'Alfermee', 'Oberrheins', 'Tcssenbcrg', 'Kanalgassc', 'Jttingcn', 'Egypten', 'Dellspcrg', 'Neucn', 'Nemnburg', 'Polen', 'Duggingen', 'Aarbergerfeld', 'Hochburgund', 'Tessenberg', 'Blvsch', 'Erguels', 'Bachqucllc', 'Svlothnrn', 'Aarberg', 'Langenthal', 'Lengnau', 'Bclfort', 'Rebberg', 'Oesterreich', 'Warschau', 'Ensisheim', 'Unterwalden', 'Vingelz', 'Rhein', 'Lamboing', 'Nieschang', 'Chauxdcfonds', 'Rheins', 'Jnnveentins', 'Tavannes', 'Pieterlen', 'Bonstetten', 'Nidaumattcn', 'Bippschal', 'Meyerthum', 'Tcssenbcrgs', 'Bielerhof', 'Arles', 'Wicsengasse', 'Murten', 'Baden Meyer', 'Bcrn', 'Prun', 'Freiburg', 'Frankenthal', 'Gottstatt', 'Dcllspcrg', 'Zihlwil', 'Landcrou', 'Ncuchenctte', 'Madrctsch', 'Mahlwaag', 'Orvin', 'Sonvillier', 'Haslilaud', 'Vingelzberg', 'Ronitsrribls', 'Lothringen', 'Pannerbezirk', 'Schweiz', 'Reuenstadt', 'Nods', 'Heidelberg', 'Studcn', 'Konstanz', 'Blutzhansen', 'Delsberg', 'Juravorstadt', 'Schauenburg', 'Burgund', 'Biclersee', 'Obergasse', 'Luzcrn', 'Holland', 'Luxemburg', 'Breisgau', 'Nenenburg', 'Nidaugassc', 'Utrecht', 'Leubringen', 'Vauffelin', 'Ccrnil', 'Pavia', 'Luzern', 'Stuttgart', 'Bell', 'Airolo', 'Kanalufcr', 'Pruntrnt', 'Biel', 'Ferrisre', 'Schwadernau', 'Genf', 'Schwyz', 'Martinique', 'Svnceboz', 'Solothnrn', 'Bcrnburg', 'Ohmgelb', 'Belgien', 'Dctlsperg', 'Waadtland', 'Landcron', 'Navarra', 'Pirmasens', 'Sombeval', 'Chauxdesonds', 'Salzrcgal', 'Biels', 'Jmerthal', 'Tilty', 'Nencnburg', 'Klostergasse', 'Basel', 'Colmar', 'Courtelary', 'Urkantonc', 'Lindau', 'Aarau', 'Zosingcn', 'Buren', 'Jersing', 'Diesse', 'Schmiedcngassc', 'Unlergasse', 'Vesoul', 'Bellelay', 'Bellmund', 'Ncncnstadt', 'Brugg', 'Dachsfeldcn', 'Tramelan', 'Turin', 'Amerika', 'Mctt', 'Schmicdengasse', 'Nidaumatte', 'Grenchen', 'Oberthor', 'Untcrgasse', 'Neapel', 'Pery', 'Brunnenplatz', 'Syrien', 'Dombresson', 'Kanalgasse', 'Jffertcn', 'Chillon', 'Waadt', 'Neuenburg', 'Jllfingcn', 'Rom', 'Prnntrnr', 'Maklingerwald', 'Schaffhausen', 'Tramclan', 'Genfersee', 'Gottstadt', 'Grandson', 'Pasqnart', 'Bern', 'Nantes', 'Martinslag', 'Mcicnried', 'England', 'Amsterdam', 'Schmicdcngasse', 'Aare', 'Solorhurn', 'Scclande', 'Beinwyl', 'Nidauthor', 'Fricnisberg', 'Solothurn', 'Ncuenburg', 'Pertuis', 'Ried', 'Landeron', 'Nidaugasse', 'Appenzell', 'Jlfin', 'Nidau', 'Meinisberg', 'Lombardei', 'Steinersberg', 'Glarus', 'Ligerz', 'Piemont', 'Sonceboz', 'Maggliugenberg', 'Magglingcn', 'Bnrgdorf', 'Thun', 'Deutschland', 'Boncourt', 'Gallien', 'Pikierten', 'Pasquarts', 'WalliS', 'Gestelcn', 'Leipzig', 'Wimmis', 'Wallis', 'Dresden'}",377,"{'Nidau Pappelbäume', 'Trinitatis', 'Rathsbeschluß', 'Bürgerrath', 'Leugeren', 'Bahnbofcs', 'Ohmgeldbezug', 'Großrathswahlcn', 'Fürstenhause', 'Recidivfalle', 'Weißenstein Magglingen', 'Comtö', 'Schwaderloch', 'Elsaß', 'Neuenburg Genf', 'Methodistenkapellc', 'Jnrabahn', 'Gem Parh', 'Lauterburg', 'Wcißgerberwalke', 'Vigan Frankreich', 'Bellelay Jllfingen', 'Gcmeindcrathcs', 'Reuchencttestraße', 'Fcldftücklein', 'Scrriörcs', 'Pruntrutischcn', 'Rheinfelden Biel', 'Zschokkc', 'AarbergerEbene', 'St Stephan', 'Fcncrcimcr', 'Kilchcuamtc', 'Wasen', 'Bisthums', 'Armengut', 'Bözingens', 'Heilmannschcs', 'Jorat Spitzberg', 'Bahnhofstraße', 'Biet von Bern', 'Fraumbad See', 'Jurabahn Dckrctlinie', 'Brügg', 'Ligniere', 'Osnabrück West', 'Pasquartthurmcs', 'Ankenwaagc', 'Scrriöre', 'Niöauthor', 'XUI', 'Militärlazarethe', 'Hofrath Wien', 'Sattlern Bözingen', 'Villeret', 'Kirchhof', 'Pieterlcn Jlfingcn', 'Bürgcrrathes', 'Knabenschul', 'Seckelamt', 'IlöMiimr', 'Büderich', 'Murtcn Bern', 'Aeußcrstc', 'Assiscnsaale', 'Biel Bern', 'Tessenberg Jlfingen', 'Rathhausc', 'Stimmzcddcl', 'Scckelamtsrechnung', 'Idickom', 'Münsingcn', 'Zürichsee', 'Gcmeindcspiläls', 'Krachbelz', 'Noth', 'Gemcindeprvtvkoll', 'Rathhaussaale', 'Zur Bestrei', 'PicrrcPcrtuis', 'Rathhaussaal', 'Bielersees', 'Pappel', 'Metersee', 'Kappel', 'Konolfingen', 'Mühlheim Vingelz', 'Todtenhofe', 'Von Worden', 'Nürnberg', 'Wirthshaus Seegarten', 'Schüpfhcim', 'Jurabahn', 'Weinlese See', 'Rcnchencttestraße', 'Stnrmwcrkzcug', '0o88oiis Corgemont', 'Gcmcindcrath', 'Weinzinse', 'Bürcn', 'Venner Göuffi', 'Berns Mahnung', 'Zürich', 'Belrichard', 'Uri Schwyz', 'Bürgcrgemcinde', 'Münchcnwyler', 'Rößli Bözingcn', 'PierrePertuiS', 'Abcrcgg', 'Rebgut Vingelz', 'Ausbaggcrung', 'Reuchcnettcstraße', 'Stadlthcil', 'Schloßbcrg', 'Gemeindrath', 'Kornamte', 'Regicrungsrathes', 'Dornach', 'Bürgcrgemeiude Biet', 'Brandvcr', 'Nods Häuser', 'Brünig', 'Condö', 'Hauptstraße', 'Böziugcn', 'Kellerschen Mühle', 'Heidelberg 1868 Mar', 'PierrcPcrtuis', 'Feuerspritzengcwölbe', 'Rosiushäuschen', 'Nothdnrft', 'Kistlcr', 'Vingelzberges', 'ScckelamtSrcchnung', 'Donvalet', 'Tüscherz', 'X6I', 'Mauth', 'Biel Dieser', 'Seckclmcistcr', 'Aros', 'Gemeindcrath', 'Kriminnlprozcdur', 'Bcrnstraße', 'Mcyerthum Biet', 'Brunnenstock', 'BiclBcrn', 'Grabenstraße', 'Sundgau', 'Vcnuer Neuhaus', 'Scheußen', 'Nathsbcschluß', 'Erguel Sonceboz', 'Fürstenschwur', 'Rathhaus', 'Haus Haus', 'Loosholzes', 'Donnerbühl', 'Großen Rathe', 'Bühl', 'Schweizergcbiet', 'Bern Frciburg', 'Rägiswald', 'Greuchen', 'St Petersinsel', 'Todtenhofes', 'Zihl Saarbäume', 'Schultheiß', 'SainUAnge', 'Spital Biet', 'Vilarsschcn', 'Gememdcrath', 'Mehcrthum bon Biet', 'Graubünden', 'Maas', 'Panncrrecht', 'Brühlscheuß', 'Madrctsch Schanzen', 'Rothhaus', 'Gemcinderath', 'Nidau Büren', 'Blösch', 'Uhrcnarbcitcrn', 'Schädelismatte', 'Sombeval Sonceboz', 'Seckelamte', 'Ucbcrschwcmmung', 'Stcuersammlung', 'Biel Fr', 'HotsI', 'Fürstenberg', 'Merlinqnelle', 'Malcfizgerichts', 'Hinteren Berg', 'Hüningen', 'Fürstenthnm Basel', 'Gasthof Brügg', 'Schloßbergcö', 'Räthe', 'Wirthshaus', 'Nonk', 'Bözingenstraßc', 'Pasqnartthor', 'Gencvcz', 'Schüdelismatte', 'Rüschli', 'Bisthums Basel', 'Gemeinderath', 'Fcnerglöcklcin', 'Zcitglockcnthurm', 'Römer', 'Trottoiranlagcn', 'Frciheitsbamncs', 'Reuchencttcstraßc', 'BielNcuenstadt', 'BielNidau', 'Bözingerstutz', 'Stein', 'NoireCombe', 'Aare Zihl', 'Berlincourthäuschen', 'Bcrtheilung', 'Nidau Frienisberg', 'BernLuzernbahn', 'Staad', 'Schloßbergs', 'Unterthor', 'Pfrund', 'Leubringenstraße', 'NidauBüzingm', 'Biel Solothurn', 'Juchartcn Wald', 'Dritttheile', 'Münsterthal', 'JmerBridel', 'Ohmgeld', 'Gemcinderathes', 'Oberthorthurmes', 'Frankfurt 100 Louisdor', 'panfcnthal', 'Rath Bern', 'Ruhr', 'Rcuchenettestraßc', 'Montreux', 'Kooists', 'Bahnhosstraße', 'XIU', 'Ablaßgrabcn', 'Panuergebict', 'Miasmas', 'Oberthor Unrerthor', 'St Inner Sonvillier', 'Kastanicnbäumcn', 'PierrePcrtuis', 'Püderich', 'Pfalz', 'Haus Zähringen', 'Mahlwaagwalde', 'Orpund Safncren', 'Geschwornen', 'St Schlnp', 'Maklingenwald', 'Ligerzgut', 'Thcatcrgcbände', 'Bürgcrrath', 'Mahlenwag', 'Ajoie', 'Salzvcrkanf', 'Alpen', 'Schncewettcr', 'Südwest', 'Große Rath', 'Forains', 'Rägiswaldes', 'Farcl', 'Bürgerrathes', 'Biel Mühlhauscn', 'Schloß Güinmcnen', 'Madl Kiel', 'Trier', 'Lonssil', 'Frohburg', 'Pcrrct', 'Vsssmblss', 'Römerquelle', 'Bözingcn', 'Nouvion', 'NidauTüschcrzberg', 'PierrePcrtuiS', 'Bözingen', 'Bern Freiburg', 'Mtcnsaminlung', 'HerzogenbuchsecBiel', 'Venner Neuhaus', 'Neuenstadt Fricnisbcrg', 'Lazareth', 'Saane', 'Rathsstelle', 'Rathssaale', 'Erguel Unter', 'Plagne', 'Gottesacker', 'Wirthshause', 'Venncr', 'Bielcrn', 'Werkhof Tuchlaube', 'Wittenbach', 'Gerlafingcn', 'Erguclcrn', 'Ibiäom', 'Särgans', 'Bleiche', 'Athem', 'Lautcrburg', 'Mühlheim', 'Franchc', 'Rottweil Schwaben', 'Schloßhof', 'Bisthum', 'BiclMadrctsch', 'Kurhaus von Macklingen', 'Gemeinderathe', 'UXXIII', 'MXVVIII', 'Lhronii', 'Rrmta', 'Roththurmmatte', 'Leubringcn', 'Schulgasse', 'Nideck', 'Münsingen', 'Tcllansatz', 'Bollgartens', 'Rcuchenettestraße', 'BielMagglingen', 'Nathhausc', 'Dießbach', 'Lüscherz', 'St Ulrichstag', 'St AndreasAbend', 'Rath Biet', 'Viehwährschasts', 'Venner Wyttenbach', 'Weißcnburg', 'Rathes von Bern', 'Bisthnm Lausanne', 'Basel Hclvetia', 'St Jmmerthalc', 'Schaltcnbrand', 'Pasquartstraße', 'Schweizerkantone', 'Kellcrschen Scheuer', 'Reutern', 'Gcmeinderath', 'Louisdor', 'Thier Twing', 'Erguel Nathsprotokoll', 'Schindermätteli', 'Jndiennefabrike', 'Sonceboz Rathsprotokoll', 'Brühl', 'Untcrgäßli', 'Pasquartthor Tschüris', 'Iwuorom', 'Pruntrut Dellsperg', 'Uebrigens', 'Herrenmühle', 'Seelande', 'Stadtcingangcs', 'Schcinkäufc', 'NeuQuartier', 'Reislausens', 'Müusterthal', 'Rathszimmcr', 'Nothfallstuben', 'Ercigniß', 'Nidau Juli', 'Bern Basel', 'Räthen', 'Ccntralbahn', 'Ucberall', 'Wirthe', 'Rathe', 'Knsnacht', 'Rössel', 'Pasquartpromenadc', 'GrenchenPietcrlen', 'Bern Solothurn', 'Scheusten', 'Mümpelgart', 'Lenzburg Wangen', 'Landhause', 'PierrePertuis', 'Rathsprotokoll', 'Landstraße', 'Große Verloosnng', 'Blösch Memorial', 'Unterthorthurm', 'Maad Mattland', 'PierrcPertuis', 'OdXXIII', 'Jurabahnnctzcs', 'Schützenhauses', 'Biet Vinsler', 'Meyers', 'Franenfeld', 'Rathsherren', 'Courte', 'Mahlenwaag', 'Scheußbettes', 'Hülfsvcrein', 'Schloß Nidau', 'Stern Jura', 'Großrathswahleu', 'HerzogenbuchseeBiet', 'Büttenberg', 'Büren', 'Würtemberg', 'Truppenausgcbotc', 'Ziegelhütte', 'St Jmer', 'Rheinbrücke', 'Bcrnergcbiet', 'Maircs Ganguillct', 'Thurm Ring', 'Ostwcstbahn', 'Dcnierö', 'Reichsboden Korn', 'Daiuss Halls', 'Obstbäumc', 'Biel Leubringen', 'Der Gemeinderath', 'Großrath', 'Rath', 'Amthause', 'St Domingo', 'Nidaustraße', 'Meinisberg Pieterlen Rotinund', 'St Jo', 'Altersjahrc', 'Stadtrath', 'Stämpsli', 'Mülhausen', 'St Biet', 'Preußen', 'Spitalbaucs', 'Gemcinderathcs', 'Bürgcrmeistcrstcllc', 'BielNeucnftadt', 'Bern Rath', 'Freischicßens', 'Ersparnißkasse', 'Stadtkirche', 'Basel St Gatten', 'Ostwest', 'Goldguldcn', 'Schenß', 'Probstci Münster', 'Stadthcbamme', 'Bürgergemeinde Biet', 'Mühlbrückc', 'Walkeplatz', 'Biet Lcubringen', 'Hofstatt Trühl', 'Rathsbotcn', 'Stadtkirchc', 'Rabat', 'Burgerknabenschule', 'Münchcnbuchsec', 'Bözingcrbodcn', 'Münster', 'Kriegsrath', 'Pietcrlcn Reiben', 'Jnravorstadt', 'Rathhause', 'Türkheim', 'Wannerhauscs', 'IXXXIV', 'Mestrcsat', 'lcmanischc Republik', 'Thurm Glocken', 'Iorat Spitzberg', 'Biel Langer', 'Jffcrten', 'Nidaustraßc', 'Straßburg', 'PicrrcPertuis', 'Seckelaintes', 'Hochwasscrs', 'Krone', 'Archiv OOXXVIII', 'Scheuer Brügg', 'Panncrrechts', 'Appellhof Kolmar', 'Scheuren', 'Maad Tanzmatten', 'Schloß Pruntrut', 'Luzern Bern', 'Meyer Biet', 'Kirchcngut', 'Bürgerraths', 'Einwohnergcmeindc', 'Rathhanse', 'Dachsclhofer', 'Wcrlwerbot', 'schenkungswcisc', 'Rheinarmcc', 'Rathhauscs', 'Lcvitcnröcke', 'Mönchenstein', 'Schildhaltcrn', 'Biel Frankreich', 'Museum Schwab', 'Orpund Meinisberg Büren', 'St JohannEvangelistcutag', 'Bern Wildcrmett', 'HcrzogenbuchseeViel', 'Wattenwhl', 'St Gallen', 'Reuchcucttestraße', 'Fluh', 'Brunnquelle', 'Mnorglo', 'Unrathe', 'Burgerrath', 'Papstthums', 'Jorat Spitzbcrg', 'Schädclismattgut', 'Biet Solothurn', 'Tsrritolrs', 'Nachtmahlweins', 'Seestraße', 'Teß', 'Bielersee', 'Polizcibußcn', 'Hangenden', 'Hcrrenmühle', 'Liövre', 'Doubs', 'Pappelallee', 'Grenchcn', 'Pintenschenkrcchte', 'Tuchlaube Herrenwage', 'Museum Schwab Mai Großrathswahlen', 'Brandkorps', 'Goldcnsels', 'Rathsaktcn', 'Mahlwagwald', 'Türkei', 'Hungersnoth', 'Pannerschwur', 'Krcuzbrunnens', 'Ferner', 'Brunnenrechtsgcbührcn Metzgergebührcn Markt', 'Großen Rathe, ELOC', 'Itziäom', 'Dachsfelden', 'Neuenburger Berge', 'Alpenklnbs', 'Boteutag', 'Zeughause', 'Aarwangen', 'Liguistcn', 'Saone', 'Fcsthütte', 'Papstthum', 'Lörrach', 'Ulan', 'OTIX', 'Uebcrall', 'Militairstcuergcsctz Biel', 'Schcuß', 'Haus Moll', 'Rathsprvtokoll', 'ChauxdefondsBicl', 'Türkenstcncr', 'Mülhansen', 'Schloßthurm', 'St Jmcr', 'Courtelary Utzlalnm', 'Biels Bern', 'Uhrenpcndel', 'MadretschBielStraße', 'Rondchätel', 'Jndienncfabrik', '6oxs', 'Lssrstairs', 'Pcstalozzi', 'Bielmatte', 'Plantsch', 'St Cyr', 'Rußland', 'Großen Rath'}",594,"{'Bouillon', 'Hcgau', 'Mlhausen', 'Diebach', 'Obcrgassc', 'Bttenberg', 'Hcuttc', 'Capua', 'Desbois', 'Pierre-Pertuis', 'Johann-Evangelistcutag', 'Saignelegier', 'Krn', 'St. Corgemont', 'Macklingen', 'Lcttrier', 'Muttach', 'Wehrmnncr', 'Osnabrck', 'Mnsterthal', 'Tramclau', 'Habsbnrg', 'Pari', 'Schlohof', 'Waadtlcmd', 'Begnon', 'Bicl-Bcrn', 'Biel-Ncuenstadt', 'Ergnel', 'Wcitnau', 'Sdwest', 'Bzingenstrac', 'Rmerftall', 'Haltingen', 'Nidaustrae', 'Brnig', 'Scegarten', 'Macaroni', 'Pasquartstrae', 'Reuchencttestrae', 'Reuchenctte', 'St. Urban', 'Reuchcnettcstrae', 'St. Stephan', 'Picterlen', 'Tramlingcn', 'Nthenbach', '- trut', 'Hintergasse', '- rcsius', 'Fricnisbcrg', 'Todtenhof', 'Berncrn', 'Siechenhans', 'Bcrnstrae', 'Scen', 'Brgg', 'Loos', 'Leu', 'Jlsingen', 'Rotinund', '- Pcrtuis', 'Grabenstrae', 'Noire-Combe', 'Schwenningen', 'Griiring', 'Elsa', 'Ostern', 'Grimscl', 'Taussteinc', 'Mettenfeld', 'Limadingen', 'Freibergen', 'Vivis', 'Tessen', 'Minne', 'Schleithcim', 'Burg', 'Falkcnbnrg', 'Bahnhosstrae', 'Graubndcn', 'Thurm', 'Uoksl', 'Meter See', 'Reiben', 'Quellgasse', 'Blchch', 'Rranelnss', 'See', 'Utlenhcim', 'Biel-Bcrn', 'Jmerthale', 'Pfi', '- quartthoreS', 'Jutzghubel', 'Mn', 'Rtti', 'Picmont', 'Prnn', 'Dardi', 'Gallen', 'Mcyrucs', 'Tscherz', 'Conti', 'Lanffcr', 'Neuenburger', 'Baldeustein', 'Paquart', 'See Aros', 'Cie', 'Gatten', 'Oekolompad', 'Bzingen', 'Lanci', 'Vigan', 'Pas quart', 'Wartcnsee', 'Habsburg', 'Baselstab', 'St. St.', 'Mnster', 'Tavel', '- mont Lengnau', '- heim', 'Muralt', 'Bzingerstutz', 'Lenzburg', 'Marseille', 'Ligerzhaus', 'Orkan', 'Weck', 'Zrichkrieg', 'Pmy', 'Psry', 'Picrrc-Pertuis', 'Witz', 'Champagne', 'Ncncnbnrg', 'Qucllgasse', 'Matt', 'Bons', 'Bauxtravers', 'Graffenried', 'Mhlhauscn', 'Biest', 'Bcrris', '- strae', 'Tesscnbcrg', 'Freibnrg', 'Hagncck', 'Musterthal', 'Besanyon', 'Buchholterberg', 'Dublonen', 'Obcrthor', 'Turcos', 'Tschris', 'Mett', 'Gerbern', 'Courtclary', 'Schmiedcngasse', 'Ostein', 'Mnchcnstcin', 'Mnzheim', 'Bzmgen', 'Ly', 'Katharinatag', 'Eselsbrcke', 'Chanxdcfonds', 'Bvzingcn', 'Widcw', 'Kalmar', 'Dehalb', 'Gens', 'Martinimarkt', 'Stettlcr', 'Trkheim', 'Meyer', 'Schcucn', 'Kassasaldo', 'Stephani', 'Pcrtuis', 'Trkenstcncr', 'Darob', 'Jlfingcn', 'Thellungberg', 'Ruchat', 'Bren', 'Rheinbrcke', 'Liguaz', 'Jllfingen', 'Solvthurn', 'Berncr', 'Pas', 'Solothurncrn', 'Lcubringen', '- zingen', 'Friedliwart', 'Bzingcrbodcn', 'Biel-Neucnftadt', 'Simeon', 'Rathhans', 'Trb', 'Rovara', 'Berlincourthuschen', 'Meycrthnm', '- true', 'Zbcr', 'Dec', 'Chcrucquc', 'Reinach-Obersteinbrunn', 'Mcngauds', 'Bernern', 'Trhl', 'Lscherz', 'Tschugg', 'Rcuchenettestrae', 'Nimcs', 'Uechtland', 'Pfingsten', 'Bellenz', 'Romang', 'Cressier', 'Zziwyl', '- berge', 'Steinersbcrg', 'Obcrgasse', 'Lichtenfels', 'Orbe', 'Tcsscnberg', 'Frienisberg', 'Mlhansen', 'Morcau', 'Schaucnburg', '- sterried', 'Korn', 'Diegelmann', 'Brodschaal', 'Scheu', 'weien Kreuz', 'Schlobcrg', 'Karls', 'Silinen', 'Berg', 'Cafo', 'Pieterlcn', 'Pierre-PcrtuiS', 'Bnden', 'Bippschaal', 'Frei', 'Bellinzona', 'St. Petersinsel', 'Lamlingcn', 'Kappcl', 'Neunion', 'Jmer-Bridel', 'Wartensec', 'Te', 'London', 'Schweizcrhall', 'Ramstciu', 'Tschanen', 'Reuchencttcstrac', 'Nancy', 'Eglisau', 'Safncren', 'Vallengin', 'Baldcnstcin', 'Chessan', 'Utzlalnm', 'Basserstorf', 'Most', 'Rousseau', 'Madretsch-Biel-Strae', 'Sphlbach', 'Ergncl', 'Marktgassc', 'Palermo', 'Wangen Aarwangen', 'Reaumur', 'Spitzbcrg', '- Biel', 'Sonrcboz', 'Dachselhoferberg', 'Mittlerberg', 'Mnchenstein', 'Seclandes', 'Grien', 'Untcrgli', 'Pfalzbaiern', 'Waldenser', '- burg', 'Markirch', 'Walker', 'Wiesen', 'Bubna', 'Wein', 'Graubnden', 'Ronca', 'Roggenbach', 'Friedliswart', 'B', 'Schlnp', 'St. Bern', 'Jmmcrthal', 'Doviat', 'Mnftcrthal', 'Nrnberg', 'Zschokke', 'Seegarten', 'Reinach', 'Twaun', 'Landstrae', 'Werkhof', 'Mnnstcrthal', 'Nov', 'Srgans', 'Donnerbhl', '-', 'Lafldcrswylbcrg', 'Elm', 'Rotmund', 'orrlro', 'Archiv', 'Renti', 'Madresch', 'Lam', 'Hindelbank', 'Wattcnwyl', 'Jucharten', 'Ungarn', 'Holzgcrlingcn', 'Mhl', 'Nidau-Bzingm', 'Vingclzbergwald', '- brcke', 'Tessenbcrg', 'Indira', 'Tcsscnbcrg', 'Freiburggraben', '- mauer', 'Renan', '- hans', 'Pierrc-Pcrtuis', 'Neveu', 'Dachselhoserberg', 'Bach', 'Augsspurgen', 'Ve', 'Bichmarkt', 'Bderich', 'Stcincrsberg', 'Cond', 'Straburg', 'Borromo', 'Bendicht', 'Ncucn', 'Tramlingen', 'Biellicux', 'Ober', 'Brnncliweg', 'Tvdtenhos', 'Hubel', 'Bielcrsec', 'Preuen', 'Mnstcrthal', 'Afernach', '- berg', 'St.', 'Mhlenbrcke', 'Rengger', 'Kanal', 'Batzen', 'Bicl-Neuenstadt', 'Wyttenbach', 'Ncuhaus', 'Toggcnburg', 'Janhagels', 'Bise', 'Rschlikon', 'Merlinquellc', 'Bziugcn', 'Varesc', 'Pfuno', 'St. Bernhardsberg', 'Bern-Luzernbahn', '- zingcn', 'Charivari', 'Bovct', 'Zrichsee', 'Lengnan', '- gassc', 'Pietcrlcn', 'Spitzberg', 'Jsolella', 'Waiden', 'Buch', 'Schpfhcim', 'Spiegelberg', 'Nivose', 'Mnsingen', 'Bzingens', 'Oktroy', 'Jmcrthalc', 'Lrrach', 'Ulrichs', 'Rschli', 'Gals', 'Pest', 'Rebberge', 'Nidau-Tschcrzberg', 'Lschcrz', 'Mhlbrcke', 'Delsbcrg', 'Merlim', 'Bingelz', 'Biel-Neucnstadt', 'Kloster.Bellelay', 'Frinvillier', 'Trll', 'Frstenberg', 'Ergucls', 'Frcibnrg', 'Hut', 'Obcrstettcn', 'Friedliswartcn', 'Corgemont', 'Grnenbach', 'Cori', 'Nemours', 'Marcon', 'Laupcrswyl', 'Martini', 'Wildcgg', 'Marktgasse', 'Bielscheu', 'Berns', 'Wels', 'Friedberg', 'St. Jmcr - thal', 'Nidan', 'Kantons', 'Vilmergen', 'Triangel', 'Benediktskirchc', 'St. Jmer', 'Unrerthor', 'Nidaustrac', 'Bcncdikt', 'Bergen', 'Lassaraz', 'Sonvillicr', 'Gislikon', 'Rosen', 'Neuhaus', 'Jmmcrthals', '- stadt', 'Untergaffe', 'Rheinfelden', 'Verdan', 'Splbach', 'Joratwalde', 'Worden', 'Simmenthal', 'Neu', 'Wildcrmett', '- gasse', 'Bvzingen', 'Stocket', '- Livrc', 'Stockmars', 'St. Inner', 'Bellelah', 'Zrich', 'Dom', 'Nionnn', 'Ilfingen', 'Schwader', '- quart', '- see', 'Mnsterthales', 'Schwab', 'Sowie', 'Viel', 'Bisen', 'Wrtemberg', 'Emmenthal', 'Blsch', 'Rothcnbach', 'Schinznach', 'Schtzcngasse', 'Berngcbiet', 'Dcnier', 'Wattenwyl', 'Ruland', 'Langnau', 'Biel-Nidau', 'Blamont', '- thurn', 'Elba', 'Lystrae', 'Bieler', 'Berlin', 'Itziom', 'Nmcrstall', 'Mnchcnbuchsec', 'Eggiwyl', 'Wysard', 'Rcuchenettestrac', 'Ncucnburg', 'Bmplitz', 'Ncucnstadtcr', 'dlppenzcll', 'Schtzcngassc', 'Hningen', 'St. Martin', 'Pic', 'Obergli', 'Zofingcn', 'Picrrc', 'Ramstein', 'Pierrc-Pertuis', '- lingerberg', 'Nicca-Bridel', 'Bzingeu', 'Renncdorf', 'Bttikon', 'Jrstenschmaus', 'Hinterberg', 'Scrrircs', 'Stmpfli', 'Ringplatz', 'Rgiswald', 'Neubau', 'Twing', 'Kiurg', 'Wildcrmctt', 'Buwhler', 'Rastadt', 'Trkei', 'Morel', 'Zuber', 'Aveuches', 'St. Jakob', 'Kanton, ', 'Buwyl', 'Mnsingcn', 'Stockmar', 'Brcn', 'Solo', 'Mlinen', 'Chauxdefonds', '- thalcs', 'Mengaud', 'Meinisbcrg', 'Ries', 'Warten', 'Bich', 'Kanton', 'Rcnchencttestrae', 'Rmerstall', 'Merlin', 'Nerrica', 'Havrc', 'Mel', 'Bzingcn', 'Marchstein', 'Franken', 'Cagliostro', 'Hohenems', 'Solothuru', 'Brhlscheu', 'Grring', 'Lorcnzentag', 'Urban', '- bresson', 'Sachsen', 'St. Domingo', 'Grobchstcttcn', 'Chauxdefonds-Bicl', 'Vau', 'Baldenstein', 'Leubringenstrae', 'Granfeldcn', 'Grenchen-Pietcrlen', 'Wildermett', 'Nudlau', 'Freienburg', 'Hringe', 'Lasagne', 'Neuenstadtcr', 'West', 'Mmpelgart', 'Dalmaticn', 'Unterwaldcn', 'Cantate', 'Stsa', 'Mhlbrckc', 'Bicl-Madrctsch', 'Gevf', 'Rmer', 'Ochs', 'Schdelismatte', 'Aeschen', 'pari', 'Weicnburg', 'St. Gallen', 'Nidangassc', 'Rmerthal', 'Hclvetia', 'Obergassc', 'Pasquarlthor'}",612,"{'Hcgau', 'Ohmgeldbezug', 'Capua', 'Elsaß', 'Vigan Frankreich', 'Bellelay Jllfingen', 'Waadtlcmd', 'Fcldftücklein', 'Sdwest', 'Scrriörcs', 'Rheinfelden Biel', 'Zschokkc', 'Macaroni', 'Pasquartstrae', 'Bisthums', 'St. Urban', 'Bözingens', 'Reuchcnettcstrae', 'Biet von Bern', 'Picterlen', 'Brügg', '- trut', 'Ligniere', 'Osnabrück West', 'Ankenwaagc', 'Niöauthor', 'Pieterlcn Jlfingcn', 'Leu', 'Bürgcrrathes', 'Grabenstrae', 'Noire-Combe', 'Griiring', 'IlöMiimr', 'Elsa', 'Murtcn Bern', 'Tessenberg Jlfingen', 'Stimmzcddcl', 'Scckelamtsrechnung', 'Vivis', 'Münsingcn', 'Graubndcn', 'Quellgasse', 'Gemcindeprvtvkoll', 'Rathhaussaale', 'Blchch', 'PicrrcPcrtuis', 'Rranelnss', 'Pappel', 'Mühlheim Vingelz', 'Jmerthale', 'Von Worden', '- quartthoreS', 'Mn', 'Jurabahn', 'Bürcn', 'Uri Schwyz', 'Pas quart', 'Wartcnsee', 'Gemeindrath', 'St. St.', 'Mnster', 'Bürgcrgemeiude Biet', 'Dornach', '- heim', 'Nods Häuser', 'Hauptstraße', 'Heidelberg 1868 Mar', 'Feuerspritzengcwölbe', 'Picrrc-Pertuis', 'Qucllgasse', 'Matt', 'Donvalet', 'X6I', 'Biel Dieser', 'Tesscnbcrg', 'Musterthal', 'Sundgau', 'Erguel Sonceboz', 'Fürstenschwur', 'Donnerbühl', 'Großen Rathe', 'Gerbern', 'Rägiswald', 'Greuchen', 'Mnchcnstcin', 'Schultheiß', 'Bzmgen', 'SainUAnge', 'Vilarsschcn', 'Spital Biet', 'Gememdcrath', 'Rothhaus', 'Stephani', 'Schädelismatte', 'Seckelamte', 'Ucbcrschwcmmung', 'Ruchat', 'Liguaz', 'Solvthurn', 'Berncr', 'Gasthof Brügg', 'Fürstenthnm Basel', 'Räthe', 'Wirthshaus', 'Nonk', 'Bözingenstraßc', '- zingen', 'Friedliwart', 'Pasqnartthor', 'Gencvcz', 'Schüdelismatte', 'Zcitglockcnthurm', 'Römer', 'Meycrthnm', 'Bözingerstutz', '- true', 'Dec', 'Reinach-Obersteinbrunn', 'Aare Zihl', 'Bernern', 'Nidau Frienisberg', 'Cressier', 'Biel Solothurn', 'Lichtenfels', 'Tcsscnberg', 'Gemcinderathes', 'Frankfurt 100 Louisdor', 'panfcnthal', 'Mlhansen', 'Montreux', 'Scheu', 'weien Kreuz', 'Schlobcrg', 'Ablaßgrabcn', 'Pieterlcn', 'Bellinzona', 'Oberthor Unrerthor', 'Te', 'Ramstciu', 'Maklingenwald', 'Safncren', 'Vallengin', 'Bürgcrrath', 'Schncewettcr', 'Rousseau', 'Forains', 'Spitzbcrg', '- Biel', 'Seclandes', 'Biel Mühlhauscn', 'Waldenser', 'Frohburg', 'Pcrrct', 'Vsssmblss', 'Walker', 'Wiesen', 'NidauTüschcrzberg', 'PierrePcrtuiS', 'Rathsstelle', 'Srgans', '-', 'Gerlafingcn', 'Särgans', 'Hindelbank', 'Wattcnwyl', 'Franchc', 'Mhl', 'Rottweil Schwaben', 'Nidau-Bzingm', 'Tessenbcrg', 'Tcsscnbcrg', '- hans', 'Neveu', 'Schulgasse', 'Augsspurgen', 'Tcllansatz', 'Bollgartens', 'BielMagglingen', 'Straburg', 'Tramlingen', 'St AndreasAbend', 'Ober', 'Rath Biet', 'Viehwährschasts', 'Venner Wyttenbach', 'Brnncliweg', 'Weißcnburg', 'Bielcrsec', 'Preuen', 'Basel Hclvetia', 'St Jmmerthalc', 'Wyttenbach', 'Ncuhaus', 'Bise', 'Varesc', 'St. Bernhardsberg', 'Stadtcingangcs', 'NeuQuartier', 'Zrichsee', 'Rathszimmcr', '- gassc', 'Ercigniß', 'Räthen', 'Ucberall', 'Wirthe', 'Rössel', 'Schpfhcim', 'Landhause', 'Blösch Memorial', 'Rebberge', 'Unterthorthurm', 'Maad Mattland', 'Franenfeld', 'Rathsherren', 'Courte', 'Stern Jura', 'Wildcgg', 'Truppenausgcbotc', 'Wels', 'St Jmer', 'Rheinbrücke', 'Unrerthor', 'Bcrnergcbiet', 'Reichsboden Korn', 'Daiuss Halls', 'Rosen', 'Obstbäumc', 'Untergaffe', 'Verdan', 'Stocket', '- Livrc', 'Preußen', 'St. Inner', 'Gemcinderathcs', 'Zrich', 'Dom', 'Wrtemberg', 'Emmenthal', 'Berngcbiet', 'Bürgergemeinde Biet', 'Biet Lcubringen', 'Bieler', 'Kriegsrath', 'Nmcrstall', 'Ncucnburg', 'Bmplitz', 'Ncucnstadtcr', 'lcmanischc Republik', 'Seckelaintes', 'Scheuren', 'Schloß Pruntrut', 'Luzern Bern', 'Obergli', 'Bürgerraths', 'Zofingcn', 'schenkungswcisc', 'Jrstenschmaus', 'Biel Frankreich', 'Brunnquelle', 'Buwyl', 'Brcn', 'Solo', 'Papstthums', 'Mlinen', 'Tsrritolrs', 'Hangenden', 'Doubs', 'Pappelallee', 'Pintenschenkrcchte', 'Merlin', 'Havrc', 'Großen Rathe, ELOC', 'Brunnenrechtsgcbührcn Metzgergebührcn Markt', 'Mel', 'Bzingcn', 'Marchstein', 'Cagliostro', 'Solothuru', 'Neuenburger Berge', 'Brhlscheu', 'Lorcnzentag', 'Urban', 'Grobchstcttcn', 'Saone', 'Papstthum', 'OTIX', 'Lasagne', 'West', 'Gevf', 'St. Gallen', 'Bielmatte', 'Obergassc', 'Mlhausen', 'Bahnbofcs', 'Recidivfalle', 'Weißenstein Magglingen', 'St. Corgemont', 'Jnrabahn', 'Methodistenkapellc', 'Muttach', 'Osnabrck', 'Mnsterthal', 'Gem Parh', 'Habsbnrg', 'Reuchencttestraße', 'Biel-Ncuenstadt', 'Haltingen', 'Brnig', 'Alpenklnbs', 'Kilchcuamtc', 'Reuchenctte', 'Heilmannschcs', 'Fraumbad See', 'Jurabahn Dckrctlinie', 'Hintergasse', '- rcsius', 'XUI', 'Hofrath Wien', 'Sattlern Bözingen', 'Villeret', 'Knabenschul', 'Jlsingen', '- Pcrtuis', 'Assiscnsaale', 'Grimscl', 'Mettenfeld', 'Tessen', 'Schleithcim', 'Burg', 'Ringplatz', 'Krachbelz', 'Uoksl', 'Reiben', 'Zur Bestrei', 'Rathhaussaal', 'Metersee', 'Biel-Bcrn', 'Konolfingen', 'Nürnberg', 'Wirthshaus Seegarten', 'Schüpfhcim', 'Weinlese See', 'Rcnchencttestraße', 'Picmont', '0o88oiis Corgemont', 'Dardi', 'Gallen', 'Weinzinse', 'Tscherz', 'Conti', 'Neuenburger', 'See Aros', 'Bürgcrgemcinde', 'Cie', 'Gatten', 'Oekolompad', 'Münchcnwyler', 'Rößli Bözingcn', 'PierrePertuiS', 'Lanci', 'Regicrungsrathes', '- mont Lengnau', 'Bzingerstutz', 'Marseille', 'Ligerzhaus', 'Böziugcn', 'Zrichkrieg', 'Psry', 'Vingelzberges', 'Witz', 'ScckelamtSrcchnung', 'Bons', 'Mauth', 'Bauxtravers', 'Graffenried', 'Mhlhauscn', 'Seckclmcistcr', 'Kriminnlprozcdur', 'Mcyerthum Biet', 'Hagncck', 'Vcnuer Neuhaus', 'Scheußen', 'Rathhaus', 'Haus Haus', 'Bühl', 'Bern Frciburg', 'St Petersinsel', 'Mnzheim', 'Eselsbrcke', 'Bvzingcn', 'Kalmar', 'Gens', 'Martinimarkt', 'Stettlcr', 'Meyer', 'Graubünden', 'Kassasaldo', 'Madrctsch Schanzen', 'Sombeval Sonceboz', 'Jlfingcn', 'Fürstenberg', 'Rheinbrcke', 'Malcfizgerichts', 'Jllfingen', 'Solothurncrn', 'Bisthums Basel', 'Biel-Neucnftadt', 'Gemeinderath', 'Trb', 'Fcnerglöcklcin', 'Trottoiranlagcn', 'Trhl', 'Rcuchenettestrae', 'Nimcs', 'Bcrtheilung', 'BernLuzernbahn', 'Uechtland', 'Unterthor', 'Zziwyl', 'Leubringenstraße', 'Orbe', 'Dritttheile', 'Frienisberg', 'Oberthorthurmes', '- sterried', 'Schaucnburg', 'Rath Bern', 'Ruhr', 'Pierre-PcrtuiS', 'St Inner Sonvillier', 'St. Petersinsel', 'Lamlingcn', 'Kastanicnbäumcn', 'Jmer-Bridel', 'Schweizcrhall', 'London', 'Tschanen', 'PierrePcrtuis', 'Haus Zähringen', 'Eglisau', 'Ligerzgut', 'Thcatcrgcbände', 'Alpen', 'Basserstorf', 'Südwest', 'Madretsch-Biel-Strae', 'Wangen Aarwangen', 'Dachselhoferberg', '- burg', 'Markirch', 'Römerquelle', 'Wein', 'Graubnden', 'B', 'Jmmcrthal', 'Schlnp', 'HerzogenbuchsecBiel', 'Neuenstadt Fricnisbcrg', 'Saane', 'Zschokke', 'Erguel Unter', 'Seegarten', 'Plagne', 'Twaun', 'Landstrae', 'Werkhof', 'Venncr', 'Nov', 'orrlro', 'Ibiäom', 'Lautcrburg', 'Ungarn', 'Schloßhof', 'Kurhaus von Macklingen', 'Freiburggraben', '- mauer', 'Renan', 'Leubringcn', 'Bichmarkt', 'Rcuchenettestraße', 'Stcincrsberg', 'Cond', 'Ncucn', 'Hubel', 'Mnstcrthal', 'Afernach', 'Batzen', 'Bicl-Neuenstadt', 'Pfuno', 'Schindermätteli', '- zingcn', 'Charivari', 'Iwuorom', 'Seelande', 'Pietcrlcn', 'Waiden', 'Rathe', 'GrenchenPietcrlen', 'Buch', 'Bzingens', 'Landstraße', 'Große Verloosnng', 'Gals', 'Biel-Neucnstadt', 'Kloster.Bellelay', 'OdXXIII', 'Frinvillier', 'Jurabahnnctzcs', 'Frstenberg', 'Hut', 'Mahlenwaag', 'Schloß Nidau', 'Cori', 'Laupcrswyl', 'Großrathswahleu', 'Marktgasse', 'Bielscheu', 'Friedberg', 'St. Jmer', 'Sonvillicr', 'Großrath', 'Rath', 'Meinisberg Pieterlen Rotinund', 'St Jo', 'Mülhausen', 'St Biet', 'Bürgcrmeistcrstcllc', 'Ilfingen', 'BielNeucnftadt', 'Bern Rath', 'Schwader', 'Freischicßens', 'Mnsterthales', 'Sowie', 'Blsch', 'Ostwest', 'Goldguldcn', 'Schenß', 'Schtzcngasse', 'Ruland', 'Rathsbotcn', 'Berlin', 'Bözingcrbodcn', 'Eggiwyl', 'Wysard', 'dlppenzcll', 'Iorat Spitzberg', 'Biel Langer', 'PicrrcPertuis', 'Appellhof Kolmar', 'Einwohnergcmeindc', 'Ramstein', 'Nicca-Bridel', 'Bttikon', 'Rheinarmcc', 'Hinterberg', 'Rathhauscs', 'Stmpfli', 'Mönchenstein', 'Buwhler', 'Orpund Meinisberg Büren', 'HcrzogenbuchseeViel', 'Rastadt', 'Morel', 'St Gallen', 'Zuber', 'Aveuches', 'St. Jakob', 'Burgerrath', 'Jorat Spitzbcrg', 'Liövre', 'Ries', 'Grenchcn', 'Warten', 'Museum Schwab Mai Großrathswahlen', 'Rcnchencttestrae', 'Goldcnsels', 'Franken', 'Grring', 'St. Domingo', 'Fcsthütte', 'Vau', 'Leubringenstrae', 'Lörrach', 'Wildermett', 'Uebcrall', 'Haus Moll', 'Rathsprvtokoll', 'Stsa', 'Mhlbrckc', 'Rondchätel', 'Jndienncfabrik', 'Aeschen', '6oxs', 'Rußland', 'Hclvetia', 'Pasquarlthor', 'Nidau Pappelbäume', 'Bouillon', 'Diebach', 'Obcrgassc', 'Leugeren', 'Großrathswahlcn', 'Fürstenhause', 'Desbois', 'Pierre-Pertuis', 'Johann-Evangelistcutag', 'Saignelegier', 'Neuenburg Genf', 'Macklingen', 'Lcttrier', 'Tramclau', 'Wcißgerberwalke', 'Gcmeindcrathcs', 'Begnon', 'Bicl-Bcrn', 'Bzingenstrac', 'Rmerftall', 'Pruntrutischcn', 'Tramlingcn', 'Nthenbach', 'Pasquartthurmcs', 'Militärlazarethe', 'Siechenhans', 'Bcrnstrae', 'Scen', 'Brgg', 'Kirchhof', 'Loos', 'Schwenningen', 'Aeußcrstc', 'Taussteinc', 'Zürichsee', 'Falkcnbnrg', 'Thurm', 'Noth', 'Meter See', 'Bielersees', 'Utlenhcim', 'Todtenhofe', 'Jutzghubel', 'Gcmcindcrath', 'Prnn', 'Lanffcr', 'Berns Mahnung', 'Baldeustein', 'Paquart', 'Belrichard', 'Bzingen', 'Abcrcgg', 'Rebgut Vingelz', 'Ausbaggcrung', 'Reuchcnettcstraße', 'Lenzburg', 'Brandvcr', 'Brünig', 'Condö', 'Orkan', 'Weck', 'PierrcPcrtuis', 'Champagne', 'Ncncnbnrg', 'Aros', 'Gemeindcrath', 'Bcrnstraße', 'Bcrris', 'Brunnenstock', 'Freibnrg', 'Grabenstraße', 'Turcos', 'Loosholzes', 'Mett', 'Courtclary', 'Schmiedcngasse', 'Ly', 'Katharinatag', 'Widcw', 'Mehcrthum bon Biet', 'Trkheim', 'Brühlscheuß', 'Gemcinderath', 'Blösch', 'Uhrcnarbcitcrn', 'Stcuersammlung', 'Thellungberg', 'Bren', 'Hinteren Berg', 'Schloßbergcö', 'Lcubringen', 'Rüschli', 'Simeon', 'Berlincourthuschen', 'Frciheitsbamncs', 'Reuchencttcstraßc', 'BielNcuenstadt', 'Chcrucquc', 'Mcngauds', 'Berlincourthäuschen', 'Lscherz', 'Schloßbergs', 'Romang', 'Münsterthal', 'Ohmgeld', 'Morcau', 'Korn', 'Rcuchenettestraßc', 'Diegelmann', 'Kooists', 'Karls', 'Silinen', 'Berg', 'Cafo', 'Bnden', 'Panuergebict', 'Bippschaal', 'Püderich', 'Geschwornen', 'Baldcnstcin', 'Chessan', 'Utzlalnm', 'Salzvcrkanf', 'Most', 'Große Rath', 'Rägiswaldes', 'Farcl', 'Reaumur', 'Mittlerberg', 'Untcrgli', 'Schloß Güinmcnen', 'Pfalzbaiern', 'Lonssil', 'Nouvion', 'Ronca', 'Bern Freiburg', 'St. Bern', 'Doviat', 'Mnftcrthal', 'Nrnberg', 'Lazareth', 'Gottesacker', 'Mnnstcrthal', 'Bielcrn', 'Werkhof Tuchlaube', 'Wittenbach', 'Elm', 'Rotmund', 'Erguclcrn', 'Renti', 'Bleiche', 'Athem', 'Jucharten', 'Holzgcrlingcn', 'Bisthum', 'Vingclzbergwald', 'Gemeinderathe', 'Indira', 'Lhronii', 'Dachselhoserberg', 'Roththurmmatte', 'Nideck', 'Münsingen', 'Bderich', 'Lüscherz', 'St Ulrichstag', 'Rathes von Bern', '- berg', 'Mhlenbrcke', 'Pasquartstraße', 'Schweizerkantone', 'Louisdor', 'Thier Twing', 'Jndiennefabrike', 'Bern-Luzernbahn', 'Untcrgäßli', 'Herrenmühle', 'Bovct', 'Lengnan', 'Reislausens', 'Müusterthal', 'Knsnacht', 'Pasquartpromenadc', 'Bern Solothurn', 'Scheusten', 'Mümpelgart', 'Spiegelberg', 'Nivose', 'Lenzburg Wangen', 'Lrrach', 'Rathsprotokoll', 'Rschli', 'Nidau-Tschcrzberg', 'Lschcrz', 'Delsbcrg', 'Merlim', 'Bingelz', 'Trll', 'Biet Vinsler', 'Corgemont', 'Hülfsvcrein', 'Marcon', 'Büttenberg', 'Büren', 'Würtemberg', 'St. Jmcr - thal', 'Kantons', 'Benediktskirchc', 'Bcncdikt', 'Maircs Ganguillct', 'Lassaraz', 'Der Gemeinderath', 'Neuhaus', 'Amthause', '- stadt', 'Splbach', 'Altersjahrc', 'Joratwalde', 'Stadtrath', 'Worden', 'Spitalbaucs', 'Bellelah', '- quart', '- see', 'Schwab', 'Bisen', 'Schinznach', 'Probstci Münster', 'Dcnier', 'Wattenwyl', 'Mühlbrückc', 'Biel-Nidau', 'Blamont', 'Elba', 'Lystrae', 'Rabat', 'Burgerknabenschule', 'Münchcnbuchsec', 'Münster', 'Pietcrlcn Reiben', 'Rathhause', 'IXXXIV', 'Mestrcsat', 'Nidaustraßc', 'Hochwasscrs', 'Archiv OOXXVIII', 'Maad Tanzmatten', 'Meyer Biet', 'Picrrc', 'Bzingeu', 'Lcvitcnröcke', 'Schildhaltcrn', 'Rgiswald', 'Twing', 'Kiurg', 'Wildcrmctt', 'Bern Wildcrmett', 'Wattenwhl', 'Kanton, ', 'Mnsingcn', 'Mnorglo', 'Unrathe', 'Stockmar', 'Schädclismattgut', 'Nachtmahlweins', 'Seestraße', 'Bielersee', 'Chauxdefonds', 'Polizcibußcn', 'Meinisbcrg', 'Tuchlaube Herrenwage', 'Brandkorps', 'Türkei', 'Hungersnoth', 'Krcuzbrunnens', 'Ferner', 'Boteutag', 'Zeughause', 'Sachsen', 'Granfeldcn', 'Grenchen-Pietcrlen', 'Ulan', 'Freienburg', 'Hringe', 'Neuenstadtcr', 'Mmpelgart', 'Dalmaticn', 'Unterwaldcn', 'Cantate', 'ChauxdefondsBicl', 'Bicl-Madrctsch', 'Mülhansen', 'Schloßthurm', 'St Jmcr', 'Uhrenpcndel', 'Ochs', 'Schdelismatte', 'Lssrstairs', 'Nidangassc', 'Rmerthal', 'Großen Rath', 'Trinitatis', 'Rathsbeschluß', 'Bürgerrath', 'Bttenberg', 'Hcuttc', 'Comtö', 'Schwaderloch', 'Krn', 'Wehrmnncr', 'Lauterburg', 'Pari', 'Schlohof', 'Ergnel', 'Wcitnau', 'Scegarten', 'Nidaustrae', 'Reuchencttestrae', 'AarbergerEbene', 'St Stephan', 'Fcncrcimcr', 'Armengut', 'Wasen', 'Bahnhofstraße', 'Jorat Spitzberg', 'St. Stephan', 'Fricnisbcrg', 'Todtenhof', 'Scrriöre', 'Berncrn', 'Rotinund', 'Seckelamt', 'Büderich', 'Ostern', 'Biel Bern', 'Rathhausc', 'Idickom', 'Limadingen', 'Freibergen', 'Gcmeindcspiläls', 'Minne', 'Bahnhosstrae', 'See', 'Kappel', 'Pfi', 'Rtti', 'Stnrmwcrkzcug', 'Mcyrucs', 'Venner Göuffi', 'Zürich', 'Vigan', 'Habsburg', 'Baselstab', 'Stadlthcil', 'Schloßbcrg', 'Kornamte', 'Tavel', 'Muralt', 'Pmy', 'Kellerschen Mühle', 'Rosiushäuschen', 'Nothdnrft', 'Kistlcr', 'Tüscherz', 'Biest', '- strae', 'BiclBcrn', 'Besanyon', 'Buchholterberg', 'Dublonen', 'Nathsbcschluß', 'Obcrthor', 'Tschris', 'Schweizergcbiet', 'Ostein', 'Todtenhofes', 'Zihl Saarbäume', 'Chanxdcfonds', 'Dehalb', 'Maas', 'Schcucn', 'Panncrrecht', 'Pcrtuis', 'Nidau Büren', 'Trkenstcncr', 'Biel Fr', 'Darob', 'HotsI', 'Merlinqnelle', 'Pas', 'Hüningen', 'Bzingcrbodcn', 'Rathhans', 'Rovara', 'BielNidau', 'Zbcr', 'Stein', 'NoireCombe', 'Tschugg', 'Staad', 'Pfingsten', 'Bellenz', 'Pfrund', '- berge', 'NidauBüzingm', 'Steinersbcrg', 'Obcrgasse', 'Juchartcn Wald', 'JmerBridel', 'Brodschaal', 'Bahnhosstraße', 'XIU', 'Miasmas', 'Frei', 'Kappcl', 'Neunion', 'Wartensec', 'Reuchencttcstrac', 'Pfalz', 'Nancy', 'Orpund Safncren', 'Mahlwaagwalde', 'St Schlnp', 'Mahlenwag', 'Ajoie', 'Sphlbach', 'Ergncl', 'Marktgassc', 'Palermo', 'Sonrcboz', 'Mnchenstein', 'Bürgerrathes', 'Grien', 'Madl Kiel', 'Trier', 'Bubna', 'Bözingcn', 'Bözingen', 'Roggenbach', 'Friedliswart', 'Mtcnsaminlung', 'Venner Neuhaus', 'Rathssaale', 'Reinach', 'Wirthshause', 'Donnerbhl', 'Lafldcrswylbcrg', 'Archiv', 'Madresch', 'Lam', 'Mühlheim', 'BiclMadrctsch', '- brcke', 'UXXIII', 'MXVVIII', 'Pierrc-Pcrtuis', 'Rrmta', 'Bach', 'Ve', 'Nathhausc', 'Dießbach', 'Borromo', 'Bendicht', 'Biellicux', 'Tvdtenhos', 'Bisthnm Lausanne', 'St.', 'Schaltcnbrand', 'Rengger', 'Kanal', 'Kellcrschen Scheuer', 'Reutern', 'Gcmeinderath', 'Janhagels', 'Toggcnburg', 'Rschlikon', 'Merlinquellc', 'Bziugcn', 'Erguel Nathsprotokoll', 'Sonceboz Rathsprotokoll', 'Brühl', 'Pasquartthor Tschüris', 'Pruntrut Dellsperg', 'Uebrigens', 'Schcinkäufc', 'Nothfallstuben', 'Spitzberg', 'Nidau Juli', 'Bern Basel', 'Jsolella', 'Ccntralbahn', 'Mnsingen', 'Oktroy', 'Jmcrthalc', 'PierrePertuis', 'Ulrichs', 'Pest', 'Mhlbrcke', 'PierrcPertuis', 'Schützenhauses', 'Ergucls', 'Frcibnrg', 'Obcrstettcn', 'Friedliswartcn', 'Meyers', 'Scheußbettes', 'Grnenbach', 'Nemours', 'HerzogenbuchseeBiet', 'Martini', 'Berns', 'Ziegelhütte', 'Nidan', 'Vilmergen', 'Triangel', 'Nidaustrac', 'Bergen', 'Thurm Ring', 'Ostwcstbahn', 'Gislikon', 'Dcnierö', 'Biel Leubringen', 'Jmmcrthals', 'St Domingo', 'Rheinfelden', 'Nidaustraße', 'Stämpsli', 'Simmenthal', 'Neu', 'Wildcrmett', '- gasse', 'Bvzingen', 'Stockmars', 'Nionnn', 'Ersparnißkasse', 'Stadtkirche', 'Basel St Gatten', 'Viel', 'Rothcnbach', 'Stadthcbamme', 'Langnau', 'Walkeplatz', '- thurn', 'Hofstatt Trühl', 'Stadtkirchc', 'Itziom', 'Jnravorstadt', 'Mnchcnbuchsec', 'Türkheim', 'Wannerhauscs', 'Rcuchenettestrac', 'Schtzcngassc', 'Thurm Glocken', 'Jffcrten', 'Hningen', 'St. Martin', 'Straßburg', 'Krone', 'Scheuer Brügg', 'Panncrrechts', 'Pic', 'Kirchcngut', 'Rathhanse', 'Dachsclhofer', 'Wcrlwerbot', 'Pierrc-Pertuis', '- lingerberg', 'Renncdorf', 'Scrrircs', 'Museum Schwab', 'Neubau', 'St JohannEvangelistcutag', 'Trkei', 'Reuchcucttestraße', 'Fluh', 'Biet Solothurn', 'Teß', '- thalcs', 'Mengaud', 'Hcrrenmühle', 'Bich', 'Kanton', 'Rathsaktcn', 'Rmerstall', 'Mahlwagwald', 'Nerrica', 'Pannerschwur', 'Itziäom', 'Dachsfelden', 'Hohenems', '- bresson', 'Aarwangen', 'Liguistcn', 'Chauxdefonds-Bicl', 'Baldenstein', 'Nudlau', 'Militairstcuergcsctz Biel', 'Schcuß', 'Türkenstcncr', 'Rmer', 'Courtelary Utzlalnm', 'Biels Bern', 'MadretschBielStraße', 'pari', 'Weicnburg', 'Pcstalozzi', 'Plantsch', 'St Cyr'}",1206
5709367,77387,"{'Abweg', 'Twann', 'Madiswyl', 'Bollodingen', 'Sulz', 'Interlaken', 'Nesslern', 'Zihl', 'Kander', 'Saignelegier', 'Nydau', 'Bundkofen', 'Courchapoix', 'Pruntrut', 'Grellingen', 'Trinistein', 'Mervelier', 'Kastenstrasse', 'Fahy', 'Koppigen', 'Diessenhof', 'Kalkofen', 'Konolfingcn', 'Nessenthal', 'Schwarzenburg', 'Lohnstorf', 'Montine', 'Horben', 'Cormoret', 'Henzissch', 'Kirchberg', 'Schwanden', 'Lyssach', 'Reutigen', 'Wasen', 'Gampelen', 'Delcmont', 'Huttwyl', 'Kernenried', 'Entlibuch', 'aulensee', 'Herzogenbuchsee', 'Boltigen', 'Saulcy', 'Villeret', 'BSleyenbaeli', 'Kirchhof', 'Thungschneit', 'Bellefontaine', 'Eriswyl', 'Stundenstein', 'Fiiglisthal', 'Erlach', 'Sagiweidli', 'Englisberg', 'Lyssa', 'Uttigen', 'Mriegstetten', 'Gyclisdorf', 'Beruh', 'Colonne', 'Tellenburg', 'Neuenstadt', 'Roggwyl', 'Grandgourt', 'Appigen', 'Mosenried', 'Kallnach', 'Schwarz', 'Griesbach', 'Ilasle', 'Herzo', 'Konolfingen', 'Gelterfingen', 'Mur', 'Trcuglibach', 'Steinalp', 'Bolligen', 'Oberland', 'Montmelon', 'Krauchlhalstrasse', 'Murlen', 'Reichenbach', 'Simmentlml', 'Beurne', 'Biglen', 'Liegerz', 'Holzach', 'Hilter', 'Scheunenberg', 'Wandt', 'Murgenlhal', 'Roche', 'Scliwarzenburg', 'Worb', 'Pontenet', 'Wirtkskaus', 'Rocb', 'BSthcnbaeh', 'Ilindelbank', 'Wyler', 'Heu11e', 'Rangiere', 'Wirthsliaus', 'Viehmarkt', 'Spiez', 'France', 'Grellingcn', 'Jura', 'Grindelwald', 'Thunstetten', 'Kappelen', 'Aesch', 'Dicsbach', 'Sutz', 'Lindach', 'Meykirch', 'Schnottwyl', 'Wiedlisbacli', 'Krattigen', 'Xihlbriick', 'Str', 'Duftweidli', 'Kuef', 'Horbengut', 'lliggis', 'Krauchthal', 'Treiteron', 'Mumenthal', 'Schupbach', 'Merligenslrasse', 'Basseconrt', 'Sandrain', 'Bure', 'Caqucrelle', 'Schwendi', 'Oberlandstrasse', 'Vend', 'Stalden', 'DISTANzjj', 'Hochstetten', 'Muri', 'Schivarzenburg', 'Meiringen', 'Wydenhof', 'Gerzensee', 'Smniswald', 'Eybacb', 'Murgenthal', 'Utzenstorf', 'Battendorf', 'Sigriswyl', 'Griengrube', 'Bassccourt', 'Eggenschwand', 'Belmund', 'Ilirs', 'Utzcnstorf', 'Hofstetten', 'Habkerngask', 'TeufTelen', 'Amlsmarche', 'Pontius', 'Grimsel', 'Buix', 'Stampfibach', 'Wirthshaus', 'Fraubrunnen', 'Aintsmarche', 'Jennsdorf', 'Ilof', 'Kirchdorf', 'Goldiwyl', 'Scheidw', 'llocbe', 'Thorberg', 'Bellevue', 'Attiswyl', 'Allmendingen', 'Berlincourt', 'Chetelaz', 'Hopflauinen', 'Cantonsgrenze', 'Zimmerwald', 'Lanierbrunn', 'Hiinibachstrasse', 'Oiesbaeh', 'Angenstein', 'Diemliqen', 'Krenzslrusse', 'Saanen', 'Frieswyl', 'Buchegg', 'Thunstrasse', 'Lomback', 'Reuchenette', 'Aargau', 'Romont', 'Zolingen', 'Ivra', 'Schulhaus', 'Hasle', 'Hettiswyl', 'Neuenegg', 'Brelincourt', 'Sandweid', 'Oberl', 'Weissgerbe', 'Stuhlegg', 'Sursee', 'GolJiwyl', 'Caquerelle', 'Burgdorf', 'Sefligen', 'Kurzenei', 'Frankreich', 'Chavannes', 'Brislach', 'Grindel', 'Durheim', 'Wangenried', 'Rottmund', 'Laupenstr', 'Hausenbach', 'Bassecourt', 'Tessenberg', 'Lugenbaeh', 'Aarberg', 'Belp', 'Sfeiiencgg', 'Erlacb', 'Neuveville', 'Langenthal', 'Lengnau', 'Scholis', 'Lies', 'Coeuve', 'Courrendlin', 'Brienz', 'Isen', 'Tlinn', 'Habkeru', 'Gerolfingen', 'Vingelz', 'Bleienbach', 'Unterwalden', 'Scheidegg', 'Murlcn', 'Murgentbai', 'Scheidew', 'Siselen', 'Lauenen', 'Tavannes', 'Pieterlen', 'Dubois', 'Oberwyl', 'Riedburg', 'Grze', 'Leuzigen', 'Brienzersee', 'Lauter', 'Messlsaws', 'Hoch', 'Ueberlrag', 'Roggwylslrasse', 'Diesbacb', 'Grafenseheuren', 'Kupferschmid', 'Thiergartenbach', 'Courtavon', 'Murten', 'Mirckel', 'Bleyenbach', 'Enllibnch', 'Mcinisberg', 'Corban', 'Zollhaus', 'Eschlenslrasse', 'Freiburg', 'Wichlrach', 'Hindelbank', 'Grellin', 'esc', 'WiUadingen', 'Gentelbach', 'Beurnevaisin', 'Biestiegen', 'Limpach', 'Pantins', 'Seeberg', 'alleray', 'Diesbach', 'Develier', 'Kerier', 'Ober', 'Habkern', 'Erlenbach', 'Neuensladt', 'Wynau', 'Courtemaicbe', 'Laupen', 'Wegscheide', 'HLangentlial', 'Kreuzgasse', 'Gasth', 'ISurgdorf', 'Lauterbrunnen', 'Wangenstrasse', 'Schalunen', 'Spreitlauibachsteg', 'Schwarzenegg', 'Jasbach', 'jRudisholz', 'Lugenbach', 'Bettenbausen', 'Wirthshausslutz', 'Wiedlisbach', 'Vauffelin', 'Reconvilier', 'Stadtbez', 'Busswyl', 'Chevenez', 'Luzern', 'Anitsmarche', 'Sumiswald', 'Melchnau', 'Hermiswyl', 'Simmeuthalslrasse', 'Worben', 'Biel', 'Hochstrasse', 'Frauchwyl', 'Krailig', 'Kaltenherberg', 'Tschangnau', 'Recolaine', 'Johannsen', 'Slefjisburg', 'Sumis', 'Bargen', 'Goldbach', 'Courroux', 'Rohrbach', 'Ber', 'Lauterb', 'Wollhausen', 'Corgemont', 'Oeschberg', 'Kiesen', 'Eschi', 'Bethlehem', 'Herzogen', 'Courgenay', 'Gsteiq', 'Hof', 'Feutersv', 'Thurnen', 'Eschholzmatt', 'Sorvilier', 'Wegsch', 'Aar', 'Oberbalm', 'Uetendorf', 'Scherli', 'Courchavon', 'Utzenstorfstrasse', 'Porrentruy', 'Sombeval', 'Ablantschen', 'Oehle', 'Vendlincourt', 'Amsoldingen', 'Hochs', 'Krauchllial', 'Zii', 'Mclchuau', 'Basel', 'Neuhaus', 'Damvanl', 'Simmenthal', 'Scheideweg', 'Sornbeval', 'Perrefitte', 'Amtsmarche', 'Monture', 'Oberburg', 'Diesse', 'Gsteig', 'Hirchlindach', 'Bellelay', 'Bcourt', 'Courtetelle', 'Gut', 'Tramelan', 'Beru', 'Braix', 'ISreitenhaeh', 'Iseltwald', 'Zell', 'Kanderbriicfce', 'Madretseh', 'Sandweidli', 'Lochbachweg', 'Langnau', 'Ursanne', 'Oertlibach', 'Clavaleyres', 'Jasb', 'Lotzwyl', 'Glovelier', 'Rizenbach', 'Oberhofen', 'Eschlen', 'Frutigen', 'Stettlen', 'Weissenburg', 'Kreuzstrasse', 'Moutier', 'Rossemaison', 'Steffisburg', 'Braise', 'Kienholz', 'Schupfen', 'Neuenburg', 'Freiburgstrasse', 'Riedtwyl', 'Schaffhausen', 'Noirmont', 'Urten', 'Egglwyl', 'Schlossweg', 'Seedorf', 'Guggersbach', 'Nieder', 'Kirefie', 'Langen', 'Biber', 'Gottstadt', 'Bern', 'Wyssenaustr', 'Rogg', 'Aeschi', 'Kapf', 'Wangen', 'Beatenberg', 'Aeschau', 'Walperswylstrasse', 'Rothenbach', 'Riggisberg', 'Murtenholzes', 'Schachen', 'Frunhrunnen', 'Lyss', 'Aarwan', 'Illitzenbach', 'Aare', 'Krauclitkal', 'Adelboden', 'Langenthalstrasse', 'Guggisberg', 'Monsmier', 'Brem', 'Jegenstorf', 'Evilard', 'Solothurn', 'Baggwyl', 'Gr', 'Almendingen', 'Vernies', 'Vicques', 'lUetendorf', 'Walperswyl', 'Fuss', 'Faliy', 'Nidau', 'Meinisberg', 'Zelgbachbriicke', 'Gutenbur', 'Kirchbergslrasse', 'Belpbrneke', 'Traclwelwald', 'Aarwangen', 'Manuwyl', 'Ramsey', 'Pichoux', 'Scftigen', 'Sonceboz', 'Thun', 'So', 'Montsevelier', 'Boncourt', 'Milte', 'Lyssachstr', 'Iluhli', 'Henzis', 'Sornethal', 'Cour', 'Sornetan', 'Wendlinsdorf', 'Gessenay', 'Wimmis', 'Slundenstein', 'Wallis', 'Aarbergerstrasse', 'Montruesselin'}",505,"{'Zililbrück', 'Lüzel', 'Monts eveli Lütscbenthal Monument Fraubrunnen Lüttelsdorf', 'Sclnv Fnss St STRASSEN III CLASSE St', 'Worb Wengi', 'Saanen Wegsch Dorf', 'Bern Wort', 'Neuenegg Bern', 'Burgdorf YVaisenh', 'Bassecourt Bürglen', 'Waitrigen Bezirk', 'Wylerbrücke', 'Bern Fraubrunnen', 'Röthenbach', 'Lüzelflüh', 'Matten Wirthshaus', 'Aarwangeu Lozwyl Bteyen', 'Zürcherstr', 'Sumiswald Murgenthal', 'Burgdorf Laupen', 'VonSchwaræeiihurg Strasse', 'Pieterlen Leugnern Biiren', 'Dürrenroth', 'Pont Vaux', 'Uebertrag', 'ReichenbachBad', 'Heid Gasthaus', 'IschwFuss St STRASSEN CLASSE St ScliwFuss ITosa ESurgdorf Murgeratltal Fortsetzung', 'Courte mautruy', 'Ober Lindach', 'Delé', 'Gliitsch Zwieselberq', 'Delémont Aarwangen', 'Nidau Bourg', 'Kappelen Brandis', 'McIcIihsmü', 'Meinisberg Mitte Dorfes', 'Saanen Wegscheide', 'Biel Wengi', 'Kirchberg Kirchlindach', 'Langenthal Lüwenwirthshaus', 'Marche Gsleig', 'LangenthalBad', 'St SckwFuss Unterseen', 'Falkenberg Montfaucon', 'Vauffelin Wengi', 'Douanne', 'Gais Zihlbrück', 'Konolßngen', 'Moutier Safnern', 'St Stephan', 'Huttwyl Grenze', 'Luzern flüh', 'Fra wyl Grafenscheuren Frauenkappelen', 'St Schw Fuss', 'Hämelbachbrücklein Grenze', 'Brügg', 'Furrcn Oberbasle Grindelwald', 'Bad Pussweg', 'Erlach Lüsclierz', 'Bux vide Buix', 'St Min St Min', 'Riedbach Förstli Jochlishaus', 'Grellinçen', 'Bollodingen Einmündung Kastenstr Dorfstrasse', 'Büzberg', 'Saulcy Glütscb', 'Delémonl', 'Zollbrück Wirthshaus', 'Belpbrücke', 'Spiez Postablage', 'St 3VT Schw Fuss Von Sasuitii Wegseli Dorf', 'Delémont Affoltern', 'Langenthal Löwenwirthshaus', 'Bützberg', 'Bois Noir', 'neue Zollbrück', 'Konolfingen Signait', 'Schmiedigen BRothmund', 'hausen Bollodingen', 'Gstad Brücke', 'Bärenwirthshaus', 'Mühledorf', 'Dürrenroth Saage', 'Tkorigen Wirtkskaus', 'Scbtiottwyl Radelfingen', 'Ligerz Eschholzmatt Luz', 'Tavannes CaquerellQ über Fuet Bellclay Saulcy', 'Büderich', 'IlasleBrücke', 'Belp Siechenhaus', 'IBasrgdffii Isis ILaugumi', 'Langenthalstr Ziircherstr', 'Spiez Feuerspritzenhüsi', 'Wengi Dorfbrunn Kreuzg', 'Lignez', 'Milte der Thiillbrücke', 'Riedstätt', 'Meinisberg Lüscherz', 'Alchistorf Ursanne', 'Gümmenen', 'Saanen Wegscb Dorf', 'Burgdorf Waisenhaus', 'Moulin Pichoux', 'Barenwirthshaus', 'Brünnen', 'Bernb Siech haus Ende Stadtbez', 'St Braix', 'Franches Muntagnes', 'Courrendlin Dittingen', 'Stettlen Huttwyl Grenze', 'Thun Aliment', 'Feuerspritzenhüsi 4armigen Wegweiser', 'Lenkbrücklein', 'HünigenBezirk', 'Thim 10633 Von Bern', 'Kapf Wegscheide', 'Bern Alach', 'Scbüpfen Kröschenbrunn Cant', 'Bern liisBilicrn Grenze', 'Gemmipass Cantonsgr', 'Biel Krämerhüs', 'Pieterlen Lengnau', 'Langen tliai Bären', 'Wirthskaus', 'St von Grenze', 'Rizenbacb Fenis', 'Landeron Neuenbur', 'Schw Fuss St', 'juchHü Steckholz', 'Grünenbrücke', 'Hospital auf der Grimsel', 'Senglerbachbrücke', 'Ct', 'Oberönz Cantonsgr', 'Hindelbank Kirche', 'Mauer Mühle', 'Saanen Gross Hochstetten', 'St ScliwFuss', 'Bourrignon Breislach', 'NiederScherli', 'Diesbach Lüwenwirthshaus', 'Frutigen Scheideweg', 'Neubrück', 'Pöschenried', 'Wengi Menzlingen', 'Grünenberg', 'Brünig', 'Bern Unter', 'Glovelier Scheideweg', 'Steffisburg Neuhaus', 'Huttwyl Städtchen', 'BubeneyBrücke', 'Kaufhaus CI', 'Aare Amtsmarchc', 'Aarw', 'Nods Pont Thiéle', 'NiederEicbi', 'Schalunen othach', 'Burgdorf Mühledorf', 'Schloss Wimmis', 'Gonten Wirthshaus', 'Tüscherz', 'Krös chenb runn Grenze', 'Aarmühle', 'Adelboden Classe', 'Haslebrücke', 'Aarberg Pumpfel', 'Brünig Gr', 'Les Rangiers', 'Mühlebachbrücke', 'Solothurn Porrentruy', 'Gsteig Lauenen', 'St SchwFuss Von Bern', 'Langnau steinernes Brücklein', 'Krämerhüsi', 'Scliw Fuss St STRASSEN III CLASSE St Scli', 'Thun Wegsch aufd', 'Saulcy St Niki', 'aauen Fortsetzung', 'Von Bern', 'Süllbacb', 'Unterfuhren Mühle', 'Büetigen', 'St Beaten', 'Oberried Wirthsh Postabl', 'Krosclienbrunnen Brücke', 'Duggingen Cornol', 'Kirchlindach Pfarrhaus', 'Kastenslrasse', 'Str IC1', 'ISrünig Grenze', 'Milte Zollbrück', 'Seflü', 'Burgdorf Rüschegg', 'Enge WirthschbOberwyl', 'Kiesen Laupen Schiffbrücke', 'Schaffhausen Wirthshaus', 'Glovelier St Niklaus', 'Nieder Sinimenthal', 'Trachselwald Huttwyl', 'Grimsel Susten', 'Heid NiederWangen', 'Bühl', 'Rizenbach Murgen thal', 'Courgenay III', 'Einmün', 'Bern Saanen Grenze', 'Hühnli', 'Cilütschbach', 'Chevenez Laufon', 'Spiez Schloss Mervelier', 'Fraubrunnen Burgdorf', 'Wyssenaubrücke', 'dKirchbergUtzen', 'Oberwyl Simmenlhal berg', 'RosenlauiBad', 'Schachenbausbrücke', 'Albligen Schonried', 'Signau RahnflühBezirk', 'GwattSpiezstrasse', 'Latlerbach Wegscheide', 'St liirchberg', 'Brünigen', 'Scbüpfen', 'München', 'Spitalbögelisbrücklein', 'Yon Bern', 'St Johannsen Cantonsgr', 'neue Brücke', 'Cornol Dürr', 'Diesbach Bassecourt', 'dobZulgbr', 'Saage Courcbapoix', 'Langenthal Hunziken', 'Langenthal Koiliitrückc', 'Biglen Gasth', 'Bellelay Stocken', 'Weissenburg stein Brücke', 'Breuleux', 'Gümligen', 'Kaltenherberg SanetschPass', 'Emmenbr', 'Sausbachbrücke', 'üthi', 'Zweisim', 'Ausmün', 'Belp Moutier Thier', 'Amtsr Kernen', 'Aarberg Sursee', 'Hutlwyl Saulcy', 'Kernenried St', 'Sand Scheideweg', 'Scheidew Pielerlen Lengnau Büren', 'Bollodingen Bern', 'Bärcnwirthshs', 'Chiètrès', 'KleinWab', 'Brislach Busswyl', 'Glovelier Affoltern', 'Saignelégier Souboz', 'Aarberg Riggisberg', 'Tschangnau Rüthenbach', 'Thun Soubey', 'Bellelay Brienzersee', 'Thun Isis Snterlalkeii', 'Neubrücke', 'Worb Huttwyl', 'Wingreis Wimmis', 'Pelé mont', 'Wirlhsh', 'Thun Wegscheide', 'Courtaron France', 'Undervelier Obersteckholz', 'Saule Ilokwyl', 'Grelling Delémont', 'Bätter', 'Amtsmarcke zwiseken Uurqdorf Wangen', 'Les Breuleux', 'Saanen Gsteig', 'Goldbach Dorf', 'Büren Strasse', 'Stadtthor', 'Mühleberg Lyssach', 'St Urban Luzern', 'Stundensl', 'Kurried', 'Bellelay Thierachern', 'Latterbach steinerne Brücke', 'Koppigenbrücke', 'Rüderswyl Kirche', 'Bern Buren', 'Limp', 'Scherzlisbrücke', 'Mühlenen', 'Büren Kriechenvryl Leuzigen Aarbergu Lyss', 'SchwI uss St STRASSEN III CLASSE St Scliwïuss Von Nusnisnald sarcla IIhKivjI', 'Interlaken Kollbr', 'Scliüpfheim Kirche', 'WonliangenfbalbisMelcIsnan', 'Kröschenbrunnen', 'Interlaken Oberhasle', 'Saancn Rüderswyl Schüppach', 'Krà', 'Alle Gsteig', 'Bellelay Soul Sulz jSoyhières', 'Bützberg Arch', 'Wasen Abweg', 'Abläntschen', 'Zäzibach', 'Bönigenbrücke', 'Stv Boche St ISraix', 'Frutigen Ins', 'Boltigen Pic', 'Zäziwyl Kronenwirthshans', 'LangenthalIlutlwylslrasse', 'Delémont Delsberg', 'Trachselwald Signait', 'Burgdorf Luwenbourg', 'Brückl', 'Büren zum Hof', 'Langenthal Münchenbuchsee', 'SchwIuss St STRASSEN III CLASSE St ScliwFuss Vom Interlakcn', 'St STRASSFN CLASSE St SchwFuss Tissu Hrüseheiiliniiiineit', 'Thun Lauithor', 'Steck bolz Pinte', 'Zimmerwald Krauchthal', 'Bärenwirthshs', 'Les Rangier', 'Marchgräbli Ende LangnauBezirk', 'Nid Stadt', 'Cortébert', 'Lüwenwirtksh', 'Grimsel Suslen', 'Murten Hern Menenegg Grenae', 'Frutigen Pfeffingen', 'Iliedtwyl Wirtkskaus', 'Courcelon Südern', 'Walkringen Bärenwirthshs', 'Diesbach NiederSch fiRüthenbach', 'Schw Fuss St STRASSEN CLASSE St SchwFuss Von Burgdorf', 'Münsing', 'Wangen Aarwangen', 'Eicbi', 'Nidau grosse Zililbrücke Anfang', 'Hornbach Wirthshaus', 'Worblenbrücke', 'Mühlebrückleiu', 'storfstrasse', 'Schmittenbachbrücke', 'Diemtigen', 'Schw Fuss St STRASSEN CLASSE St SchwFuss Ton ILangentba ISnttwyï Grenze', 'Bütz', 'Gonten Abweg', 'Milte Amtsrn', 'Lyss Bern', 'Fass St STRASSEN CLASSE St Scli Fass Von lidan Isis Itiîren', 'Bern GemmilPass', 'Büzberg Courgenay', 'SRüeggisberg', 'Interlaken Büren', 'Bern St Beatenberg', 'Worb Batzenbrücke', 'Blankenburg Schlossbr', 'Schüpfen', 'Scliw Fuss St STRASSEN CLASSE St SehwFuss Vom IMelnisberg lias IPIeterlesa', 'Bözingen', 'Büren Surbelen', 'Saanen Eschert', 'Kaltenherberg Wirthshaus', 'Bressancourt Wier', 'Wimmisbrücke', 'ISoyhières', 'Ilünigershaus', 'Scbüppach', 'St Urban Cantonsgrenze', 'Reutigen Stocken Relp Kapf', 'Sand Wirthshaus Rogg', 'Flühliberg', 'Biel Murgenthal', 'St Beatenberg', 'Thierachern Schoren', 'Solothurn Von Büxingcn', 'Kaslenstrasse', 'Bonfol Oberwyl', '1er Strasse', 'SchwFuss St STRASSEN', 'Wallis Scheidw', 'Movelier Lyss', 'Kirchberg Gaslhof', 'Miécourt', 'Ferrière', 'Zürclierstrasse', 'Calruis', 'Brünig Grenze', 'Kohlbrücklein', 'Einmünd', 'Schwarzenegg Rö', 'Tbun Rüegsbach', 'Schleiwien Ilettiswylbezirk', 'Scheidweg nacb Fuet', 'lotzwyl', ' Ringoldingen Rüxau llüegsau', 'Allmendingen Wirtkshaus', 'Eggiwvl', 'Simmenthl', 'Lengnau Meinisberg', 'Brünig Wachthaus', 'Zäziwyl Krouenwirthshaus', 'Uetendorf Glütschbachbrück', 'Laulenbad Moosbachbrücklein', 'Bern Ins Burgdorf', 'Amtsmarche Trachselwald Wangen RothBezirk', 'PillonPass berg', 'Bärenwirths', 'Les Bois', 'Schlossbrücke', 'Nieder Scherli Scbeidew Oberbalm', 'MariahilfFreiburg Men ISern SSoneonrl', 'Frutigen Rüeggisberg', 'Emmenbrücke', 'St Ursanne', 'Oben Längenmattstutz', 'Ltizelllühbrücke', 'Oberland Mittelland', 'Schw Fuss STRASSEN III CLASSE St Schw Fuss Finmünd Strasse', 'St JolBSMBSBsesB', 'Porrentruy Frankr', 'Rüderswyl', 'Ilolzach Wirlhshaus', 'St Schw Fuss Ton llurgeitihal CJrenæe', 'St ßeatenberg Kirche', 'Hofstetten Pinte', 'Schwanden Schüpfen', 'Kanderbrücke', 'Vingelz Nieder', 'Kiesen Grandval Granfelden', 'Bern Abweg Lyssach', 'Freimettigcn', 'Dürrmühle', 'Könitz Lauterbrunnen', 'St SchwFuss', 'Porrentruy St Ursanne', 'Aerlenbachbrücke', 'Amlsmarche Konolfmgen', 'Dorf Reich', 'Ziegelbrücke', 'Niederried Dorfbrunnen', 'Löwenwirlhshaus', 'Amtsmarcbe', 'Gümligen Classe', 'Schwendi Dorfbrunnen', 'LiesiergrMiible', 'ieilerSclierli', 'Hindelbank Leubringen', 'Saignelégier Büetigen', 'Sä', 'Rothachbrücke', 'Langenthal Mervelier Messen', 'Langenthal Habkern', 'Brücke', 'Maurerhüsi', 'Delémont', 'Rüscbenz', 'Gündlischwand Br', 'Boltigen Dorfbrücke', 'Melchnan Büzberg', 'Walkringen St Imier', 'Büzberg Langenthal', 'Freimettigen Gastbof', 'Büren von Bern', 'Golbrücklein', 'Glovelier Dürrbach', 'Bothbrücke', 'Thun Bernthor', 'LangenthalAarwangenstrasse', 'Zulgbrücke', 'Langenthal Ansmünd Kasten', 'Sand Scheidweg', 'Sir St Braix Cl', 'Spiez Schloss Spiezwyler', 'Ion Bern', 'Mühlen', 'Wirthsbaus', 'NiederLind', 'Sumiswald Kirche', 'Pieterlen Bern Büren', 'Soyhières Delémont', 'Garstatt Zollbrücke', 'Wimmis Stade Ibach', 'St Scliw Fuss SSeiii Isis', 'Meiringen WildenmannGslh', 'Alienlüften', 'Hof lAmpach', 'Belp Séprais OberStocken', 'Lauterbrunnen Kirche', 'Kirchberg Weissenbach', 'Alchenflüh Ausmündungind Zürcherstr', 'mühlcnstutz Grien', 'Mau rer beim Ramseyweg', 'Amtsm Thun Simmenthal', 'Saanen Koppigen', 'thalstrasse', 'Büren', 'St STRASSEN CLASSE St Schw Fass Vom Bern', 'Porrentruy Isis', 'Gwatt Pinie', 'Erlach St Johannsen', 'Kirchdorf Bethlehem Saageweidli', 'leiignati Grenze', 'Rebeu', 'Sumiswald Hasle', 'Langenthal Büzbergstrasse', 'Berne AbbrcviatioHs', 'ThunAllment', 'St Johannsen', 'wylBezirk herwärts der Kaltenherberg', 'Bözigen', 'Saignelégier III', 'OberStocken', 'MitteZollbr', 'Solothurn Ton', 'Burgistein', 'Vinelz Goldbacb Ferenbalm', 'Wis Iis Sckwarzenburg Wislisaubrücke Rig', 'Béni', 'Papiermühle', 'Schüpfcn', 'Cantonsgrenxe', 'Sand ScheidewuFraubrunn', 'Wirtbshaus', 'Aarberg Aeschi', 'Diesbach Löwenwirtbshaus', 'Ilerrenschwanden Brunnen', 'Oberhofen Porrentruy', 'NiederLindach', 'Saanen Muri', 'Tliieraeliern', 'OberWicht', 'Nidau Murihölzlein', 'Pferdmund', 'Ile', 'Aaruu Postbaus', 'Belp Siechenh', 'Ziircherslrasse', 'Mängistorf', 'Bad Vanel Grenze', 'Alclienflüh', 'Maurerhäusli', 'Villeret Oberbipp', 'ILotæwyl', 'SchiippachB', 'Lüscherz Langenthal', 'HünigersHaus', 'Solothurn Bern', 'Frankreich Pfefferhausen', 'Gerolüugen', 'Müntschemier', 'Soulce Sollendorf', 'Durheiin', 'Moulin Liesberg', 'ettenhausen Kastenstrasse', 'Leissigen Bad', 'Scheidew Matten Moosbühlhuber', 'Ringgenb Wiiihshaus', 'Langentbl', 'Lenk Pfarrhaus', 'Rüegsau Bätterkinden', 'Unter see Kaufhaus', 'Matten alte Strasse', 'Brünig beim Sclrwan', 'Schloss Spiez', 'Ion Classe', 'Glovclier Safnern', 'Luzern Langenthal', 'Wal erswyl', 'Schüpfheim', 'Lüfterngräbli LauperswvlViertel', 'GreilTenbachbrücklein', 'Fritzenberg Höhe', 'LiesbergMühle', 'Engelberg Joch', 'Habkern Pichoux, ELOC', 'Courroux Wimmisbrücke dSimme aViques', 'Reconvilier Schachen', 'Cantons Bern', 'Zollbrück Elühlenstaldcn', 'Interlaken Casino', 'Dürrenast', 'Bubeneibrücke', 'Biel Montavon', 'Walkringen Bärenwirthshaus', 'Münster', 'Saignelégier', 'Ton Kern', 'Balzenbrücke', 'Mont melon St Ursanne Courgenay', 'VonBern bis Ladenwand EndeStadtbez', 'Pruntrut Classe', 'Tschingelbrücke', 'CI', 'Oberönz', 'Burgdorf Brücke', 'Zell Gasthof', 'Zürcherstrasse', 'Meriïcin', 'Zell Luz', 'Lengnau Biizingen', 'Lenk Thüll', 'Spiez Dorfbrunnen', 'Rüti', 'Mötsckwyl Pinte', 'Cheveuey Glütsch', '¥', 'Zollbrück', 'Anitsmarcbe', 'Aeschi Sulz', 'DISTANZ St St eurnev', 'Scliw Fuss St STRASSEN III CLASSE St SchwFuss Yon Int Itou', 'Long eau', 'Tromsaagebrücklein Kircbgemeindgrenze Saunen Lauenen Schlüsslihubel', 'Hilterfingen Dorfbachbrücke', 'Tittingen Toffen wyler Traehselwald Ramsei', 'Rahnflüh', 'Orvin Rebeuvelier', 'Grimsel Culminationspunkt', 'Bleien bac', 'ErlachNidauStrasse', 'Aarwangen Wangen', 'Breitenbach Solothurn', 'Hof Hasle', 'Gadmen Steinibach', 'Thun Fortsetzung', 'Thun Saage', 'SchwFuss St STRASSEN III CRASSE St Schw Fass Von Zweisiminen Isis', 'Oeybriicke Marche', 'Grindelwald Bären wirlhshaus', 'Hausen Tschäppel', 'Fruligen', 'Bois Schwanden', 'Soyhières', 'Spiez wyler Wirthshaus', 'Brünig Trubschachen', 'Gelterfingen Gerzensee', 'Zürich Sihlbrücke', 'Scliw Fuss St STRASSEN CLASSE St Schw Fuss Von SSerss ISifsern', 'Fritzenb ergIIöhe', 'Langenthal Seedorf', 'Dorfbrücke', 'Krauchthal Mühle', 'Malleray Murgenthal', 'Spiez Postablage Wegscheide', 'SchwFuss St STRASSEN CLASSE St Scliw Fttss', 'Saanen grosses Landhaus', 'Scliw Fuss St STRASSEN CLASSE St SchwFuss', 'St Urban', 'Rahnflüh Mitte Dorfes', 'Bern CI', 'Scbüpfen TTägertschi', 'St VBern', 'Burgdorf Wangen', 'Arch', 'Rabnflüh', 'Bezir ksInge', 'Aescbi Porrentruy', 'Hasle Wirthshaus Schaffhausen', 'Müncheubuch', 'Riedtwyl Wirthsbaus', 'SaanenMüser', 'Belp Altorf', 'Griudelwald Ober Steckbolz Burg', 'Konolflngen Signait', 'Lengnau ISolothurn', 'OberLin', 'Les Rangiers Rebelsch Oppligen Rapperswyl Scbüpfen Orpund', 'Fliihlenslalden Brücke', 'Nidauu Büren', 'Belp Scbwendi', 'Bassecourt Stetten', 'Burgdorf Joux Herrn', 'Grindelwald Saignelègier', 'Alchenflüh', 'Saulcy Aarberg', 'Fruligslr', 'St Ursänne', 'Flühlenstaldens', 'Belp W', 'Reichenbach Mühle', 'Langenthal Säriswyl Rohrbach', 'Schwarzenbrunnenbrücke', 'Belp Siechenhaus Scheideweg', 'Miinsingen LüwenWirthsh Ober Wich track Wirthsh', 'Courtavon France', 'St Min', 'Érlenbach Dorfbrücke', 'Kandersteg Wirthshaus', 'Lengnau Langenthalbad', 'Bettenhausen Oberönz', 'St Niki', 'Laupen Wirtlishaus', 'Spital Frutigen', 'Thörishaus Flainalt', 'Wirlhshaus', 'Stettlen Worb', 'Gwattbrücke', 'Burgdorf Tliun', 'Les Rangiers Strasse', 'Linden Wirthshaus', 'Lamboing Lim', 'Von Mur', 'Mühlebrückl', 'Wartenbergbrücke', 'Münsing Murten', 'Sinnebrücke', 'St Braix Les Serrains ontfaucon', 'Rüthi', 'Gadmen Porrentruy', 'Utzenstorf Zollhaus', 'OOS Illipp', 'Kaslenslrasse', 'Interlaken Zoll', 'Schwarzenberg Noirm', 'Waiseaih', 'Bätterkinden', 'Adelboden Brislach', 'Wink Brückl', 'Lyss thalstrasse'}",727,"{'', 'Rams', 'Wlesllisbach', 'Canlonsgrenze', 'Lan', 'Dorfbrunnen', 'ontfaucon', 'St. Sch', 'Schppachbrcke', 'ezwyl', 'Kronnbrcke', 'Thalgut', 'Sclipfheim', 'Joch', 'Fuel', 'bolz', 'Handegg', 'Tmbscbaclien', 'Engelberg', 'SSern', 'Gaslh', 'Daniphreux', 'riswyl', 'Reggisberg', 'Pielerlen', 'Wiedlisb', 'lidan', 'St. Urban', 'Che', 'Latlerbach', 'Ilfisbrcke', 'Wydenmatt-Scheune', 'Kwiselaeaa', 'lAmpach', 'erswyl', 'Ibach', 'Delmonl', 'Wolfe', 'Hbeli', 'Hutlwyl', '- zenburg', 'Soiicelio', 'Brien', 'IMelnisberg', 'Nieder-Lind', 'Thim', 'enenstadt', '- Mngistorf', 'Bigeltbal', 'Bettenhsn', 'Westenback', 'Qfiiill', 'Mattenbrcke', 'Sand', 'Grafenried', 'gPieterlen', 'SckwFuss', 'SehwFuss', 'Gmdhs', 'liSUBgUaU', 'Gwatt-Spiezstrasse', 'Teuffeien', 'Langenthal-Ilutlwylslrasse', 'vide pag', 'Bubeneibrcke', 'Flhlenstalden', 'Pry', 'Long', 'Usargdorff', 'Wvssachengraben', 'zelflh', 'Wald', 'Pass', 'Lwenwirlhshaus', 'Hermrigen', '- selwald', 'Raupen', 'Wingreis', 'i.Rolhbezirk', 'Slollodingeu', 'Oberbipp', 'aRuchmhle', 'Meikirch', 'Messen', 'St. St.', 'Mnster', 'Pfefferhausen', 'Safnern', 'Krschenbrunnen', 'Riedbach', 'Sasuitii', 'Gel', 'Bucliholter', 'St. St. Aarau', 'Bnigen', 'Scbattenbalb', 'Linden', 'Madretsch', 'Kevenach', 'Murgen', 'Rosengartenbrcklein', 'Hern', 'thf', 'Wyss', 'Enggistein', 'Neuen egg', 'Meyenbachbrcklein', 'lmont', 'eatenberg', 'torf', 'Courtaron', 'Krosclienbrunnen', 'Kutlitz', 'Fritzenberg', 'Lappigen', 'Ins', 'Reicbenbacb', 'ISaargdoirf', 'Rangiers', 'Walpers', 'Mhlebrckleiu', 'Mhleberg', 'Griudelwald', 'Lanpen', '^', 'Rahnflh-Bezirk', 'Geiendorf', 'Wangenstrsslein', 'Scbeidw', 'ESurgdorf', 'Reidenbacli', 'JolBSMBSBsesB', 'Interlaben', 'Wulperswyl', '- mhle', 'Brnigen', 'Rosengriengrubc', 'ISoyhires', 'elz', 'St. Min', 'zin', 'Ilasle-Brcke', 'appel', 'Glovclier', 'Gasei', 'DiesBaeh', 'MBB', 'Nieder-Wangen', 'Port', 'Lwenwirthshaus', 'Magglingen', 'VonBern', 'Pie ter', 'Susten-Pass', 'Souboz', 'Eing', 'ehBurg', '- ach', 'Fus', 'Lwenwirtksh', 'Mnrgentlial', 'Schmittenbachbrcke', '- gsslein', 'Brandis', 'Glzibrunnen', 'Thier', 'Ber.rc', 'Cl. Landstr', 'Obernz', 'Gltscb', 'ololhurn', 'Steckholz', 'Rmligen', 'Piquerez', 'Ltizelflhbrcke', 'Stadttlior', 'Aeschi.bis', 'Guttannen', 'Orlschwaben', 'Krmerhs', 'Drrbach', 'Bourg', 'Langenthal-Aarwangenstrasse', 'St. IJrban', 'Siech', 'Ciliourg', 'Flhlenstaldens', 'Zwingen', 'Tltiin', 'Saunen', 'Joux', 'Finstermoosstutz-Anfang', 'venez', '- jVechigen', 'Kisninerwald', 'Lenkbrcklein', 'Wirthsch.b.Oberwyl', 'Watt', 'Zzibach', 'thenbach', 'Wildeneibad', 'Pussweg', 'Luterbrunnen', '-', 'Bettenkausen', 'sch wan', 'Kirchen-u.Mhle', 'Min', 'Granfelden', 'lnkwyl', 'Rosenlaui-Bad', 'Zrcherstrasse', 'Linde', 'gisberg', 'Bressancourt', 'Mhl', 'Scbwendi', 'TTgertschi', 'Mhlen', 'STRASSFN', 'Lugnez', 'Zoll', 'Emmenbrcke', 'Altorf', 'Mnts', 'Klein-Wab', 'vide', 'Laufen', 'Lauithor', 'Gwattbrcke', 'dach', 'Aarb', 'Siechenhaus', 'Kweisimnien', 'Dorfbrcke', '- mensehuaml', 'Noir', 'Spiezwyler', 'Aarmhle', 'Enggistein-Bad', 'Montagnes', 'a.d.Kreuzg', 'Poslahlage', 'Hrrenroth', 'Saanen-Mser', 'Relp', 'Soul', 'Sdern', 'Drrenast', 'uzigen', 'iVingras', 'Gndlischwand', 'Schwur', 'ndelbank', 'Leubringen', 'Has', 'Glockenthal', 'Gondiswyl', 'les', 'CiboniTg', 'brg', 'Gliitsch', 'Seltenbachbrcke', 'Poldern', 'enb', 'Fussweg', 'Track', 's-Wab', 'chp', 'Tissu', 'Wirthsh', 'Ansmnd', 'Falirw', 'Senglerbachbrcke', 'SiEBSEBBeUlB', 'Traufbrcke', 'Konolngen', 'Tbun', 'Courte', 'Weg', 'Scbeidew', 'Aarwangenxi', 'Scliwuss', 'Charmoille', 'Itou', 'GloTclier', 'Uettligen', 'Mhlenen', 'Murihlzli', 'Zihlbr', 'W', 'Radelfin', 'Utzigen', 'Stoefceaa', 'Schonried', 'Goumois', '- Pferdmund', 'Steffislsurg', 'Englisb', 'Bothbrcke', 'Aarbergu', 'Ams', 'Chitrs', 'Montignez', 'Einimind', 'cke', 'Zrich', 'Stub', 'Delniont', 'St. Braix', 'Emmenthal', 'Fia', '- Scheunenberg', 'Neuenbur', 'Lfterngrbli', 'IschwFuss', 'Rtschelenthor', 'Gresaze', 'Franches', 'Xrcherstr', 'Cant', 'd.ob.Zulgbr', 'Neuhans', 'ISoelse', '- hausen', 'Aescbi', 'Menenegg', 'Kniz', 'Brcklein', 'Rchenez', 'Ablntscben', 'pag', 'Grund', 'Wyssachengraben', 'Ferrire', 'Bubendorf', 'Sriswyl', '- thal', '- storfstrasse', 'Wegweiser', 'SReggisberg', 'Bienne', 'Twerenb', 'UMliSW', 'track', 'Rebeuvelier', 'Hnigen-Bezirk', 'd.IIeustrickbad', 'Del', 'Oltigen', 'Bettenhausen', 'Mnchenbuchsee', 'd.Simme', 'Grnenbrcke', 'Miirgenthal', 'Utzenstorfstras.se', 'Dito', 'fiRthenbach', 'Birai', 'Landeron', 'Murgeratltal', 'zwisch', 'Neueneg', 'Saancn', 'Trub', 'Pfeffingen', 'IVogtsburg', 'Saum', 'DISTANZ', 'Pschenried', 'Grosse', 'Fritzenb', 'Urban', 'Wiggern', 'BisrnnMe', 'Aehera', 'Ciltschbach', 'Schplen', 'Zubibacb', 'Schwi', 'Weissenbach', 'Ortscbwaben', 'Gais', 'Soubey', 'Bief', 'Fass', 'Zoll brck', 'Brcke', 'Biaufond', 'Grandval', 'Ablntschenbach', 'Grbenbrcke', 'Ober-Wicht', 'Fritzengraben', 'Pont', 'Frstli', 'Wyl', 'Uurqdorf', 'Lzelflh', 'Mattenbrunnen', 'Gurnigelbad', 'Bourrignon', 'Wich', 'Villars', 'jNiederried', 'Huttwylstrasse', 'Rena', 'Cant.', 'Brgelbacli', 'liirchberg', 'rau', 'Imboden', 'Brnig', 'Ker', 'aup', 'ers', 'Reich', 'Schulbachbrcke', '- mont', 'Steghaldenstutz', 'Plen', 'Weidbach', 'Ecken', 'Koppigenbrcke', 'Bol', 'Tracht', 'St. Imier', 'Wylerbrcke', 'Bellclay', 'Koiliitrckc', 'Scimiswyl', 'changnau', 'Gr.', 'Wacht', 'Maurerhusli', 'Kreuz', 'Schpfen', 'Rxau', 'Oeybrcklcin', 'Siis', 'Mnchenwyler', 'Unter seen', 'bint', 'Atlelboden', 'Burg', 'Interlak.cn', 'ald', 'Ringgenb', 'Wegmhle', 'Melchnan', 'Blumenslein', 'Schwarzwasserbrcke', 'Simme', 'Sonceb', 'Sifcassra', 'Meichnau', 'Dorfbachbrcke', 'en-B', 'Tscherz', 'IPIeterlesa', 'ltargdorf', 'Aeschleu', 'Zolliko', 'Knitz', 'Laulenbad', 'bacli', 'gMontfaucon', 'Wal', 'Soy', 'Ourrmhle', 'mont', 'Einni.ind.Slr.n.Thurnen', 'Scliw', 'Frutigstr', 'Rielerbrcke', 'Lzel', 'Courrend', 'lCrmine', 'Schoren', 'Schlossbrcke', 'Bonfol', 'Steinibach', 'Herbligen', 'TTSnt', 'Stocken', 'Curried', 'Lngenmattstutz', 'Iliedtwyl', 'Bicki', 'Sausbachbrcke', 'Tkierackern', 'Zweiliitschenen-Brcke', 'sarcla', 'Thun-Allment', 'Prgelz', 'Reichenbach-Bad', 'Brunnen', 'Surs', 'nViques', 'Kriischenbrunnen', 'Niederbipp', 'Langnau-Bezirk', 'v.Adelboden', 'Neubrcke', 'Nieder-Scherli', 'Drrenroth', '- Porrentruy', 'Pleigne', 'Rlurgentltal', 'Bleien', 'Falkenberg', 'Lungern', 'HSiirgdoif', 'Gurbr', 'Wirthsb', 'Cantonsgr', 'idau', 'Mhlethor', 'igelt', 'Cornol', 'Yide', 'Nieder-Eicbi', 'Gysenstein', 'di', 'Mntschemier', 'aViques', 'Ilandhuttbrcklein', 'Fussw', 'Gmmligen', 'Ursenbach', 'Oben', 'Ijanderon', 'Br.', 'Gwatt', 'erhsi', 'Kngelibrcklein', 'Obrons', 'Saul', 'Saurnstrasse', 'Mtsckwyl', 'Hmelbachbrcklein', 'Kriechenvryl', 'tha', 'Habkernbrcke', 'Cbarmoille', 'Lader', 'S.a', 'Burgdorfstrasse', 'gVingelz', 'Morschwyler', 'rag', 'Pinte', 'St. Beatenberg', 'Gasthof', 'Classe', 'Beimund', 'Zziwyl', 'Epauvillers', 'Cib', 'Zollh', 'Lauibachbrcklein', 'Aintsmarcke', 'Scbppach', 'rub', '- Lindach', 'Reinisch', 'Niederried', 'Fontenois', 'Thor', 'Grnenberg', 'Damschreux', 'Schiippach-B', '- lein', 'leiignati', 'Rthi', 'Pinie', 'Deisswyl', 'Errata', 'Gurzelen', 'Duggingen', 'Sensebrcke', 'Gltsch', 'Lim', 'Aarkergerstrasse', 'Akw', 'Koncourf', 'Liesiergr-Miible', 'Ltscbenthal', 'Wollbausen', 'Thrishaus', 'Hausen', 'Postbaus', 'Albligen', 'Riiedcrswyl', 'Kroschenbrunnen', 'Schwar', 'Vielimarkt', 'Jochlishaus', 'lotkurn', 'Srf', 'Karrweg', 'Grnen', 'Vhieraebern', 'Latterbach', 'stein', 'ssach', 'Siggernbrcke', 'Kirche', 'Bez', 'Gltsehbachbrckl', 'Brglen', 'Bmont', 'Kutlliz', 'Erl', '- gen', 'Grcb', 'Brckl', 'Scheiclew.naeh', 'Pillon-Pass berg', 'Gonten', 'Delmont', 'Sinimenthal', 'Tramm', 'Renan', 'Selzach', 'Dorfbackbrckl', 'Sc', 'Bernthor', 'Cts.', 'Stockachenbriicke', 'nisberg', 'Gzibrunne', 'Moosbhlhubel', 'lingen', 'Ruchmhle', 'Nods', 'Utzenstor', 'Hcr', 'Flainalt', 'Courcbapoix', 'lus', 'Zwieselberq', 'Delsberg', 'Crmine', 'Rderswyl', 'Nieder-Lindach', 'Dakienbrcke', 'renclicu', 'Moine', 'Gebstorf', 'mautruy', 'Langenthalstr', 'ileudiberg', 'Saignelgier', 'Batzenbrcke', 'Trul', 'rubschachen', 'Mont', 'Langeten', 'Buch', 'Grossbachbrcklein', 'Holen', 'Wier', 'Heiniberg', 'Wegseli', 'Lozwyl', 'd.Kirchberg-Utzen', 'Mitholz', 'Anitsmarcae', '- wald', 'Vou', 'rie', 'Erlach-Nidau-Strasse', 'Steck', 'R.Statlh', 'enst', 'Moosbhlhuber', '- bach', 'Wink', 'Gross-Affol', 'len', 'nbchli', 'Schw', 'Thurneu', '- Glovelier', 'Eibrcklein', 'Nidauu', 'Br', 'Sri', 'Movelier', 'Belpbrck', 'Kanderbrcke', '- Sumiswald', 'Keislenbrcke', 'Mutzwyler', '- Tschppel', 'Lutliern', 'Kern', 'iRinggenberg', 'Buren', 'Cibourg', 'Sanetsch-Pass', 'SSoneonrl', 'Kriegstetfen', 'rer', 'Btzberg', '- Rthenbach', 'Voit', 'SchwI', 'Mid', 'Scheidweg', 'Court', 'Susten-Pass-Hhe', 'S', 'Roth-Bezirk', 'Krailigen', 'Stundenslein', 'EndeStadtbez', 'Gemmi-lPass', 'Ilnigershaus', 'rcke', 'Wysslisaubrcke', 'ISolothurn', 'Zililbrck', 'Montfaucon', 'Fenis', 'Urweidbrcke', 'Eggiwyl', 'Lyssachstrasse', 'Heimenschwand', 'Krattiggraben', '- grbe', 'Wartenbergbrcke', 'Freiburggebiet', 'hieherd.Ilolhachenbr', 'Soulce', 'Tlmn', 'uhea', 'Bur Waisenh', 'Genevez', 'v.pag', 'Cappelen', 'arberg', 'ols', 'Shmnen', 'Gentelbrcke', 'Suaulswald', 'Gmmelien', 'Nieder-Sto', 'Biizingen', 'Frauenkappelen', 'Rhynbrcke', 'Mncheubuch', 'ohlern', 'thal', 'Unterseen', 'egistorf Luz', 'Wacbtbaus', 'ourg', 'Kreuzslr', 'Scli', 'Kohlbrcklein', 'Scherzlisbrcke', 'Montscvelier', 'Kirchen', 'Ton', 'Walkringen', 'Saumweg', 'VValperswvl', 'Brix', 'ahy', '- Simmenthl', 'Amtsm', 'euerspritzenbuscben', 'Mots', 'Cautonsgrenze', 'IIeil', 'Brggelbach', 'ber', 'Matten', 'Marche', 'Schiipfen', 'teffisburg', 'Ulzenslorfstrasse', 'Hettiswjb', 'Seftigen', 'Bhl', 'ttiggr', 'Pic rien', 'Bnig', 'Envelier', 'Nieder-Sch', 'Biiren', 'Schl', 'Faulensce', 'Mieschdorf', 'Betten', 'Krouenwirthshaus', 'Sclul', 'Tliun', 'liisBilicrn', 'Lwenbourgj', 'V.Bern', '- Bollodingen', 'Itiren', 'Suignelgier', 'esche nbach', 'brunnen', 'beiNeuenegg', 'Mnchen', 'zenburg', 'Gerolugen', 'Mnsing', 'Toffen', 'Ijangenthal', 'lodin', 'alm', 'Schiffbrcke', 'Siechenh', 'Miinsingen', 'lauter', 'Gireiaze', 'Bois', 'Golbrcklein', 'Zollbrck', 'Rennendorf', 'Brgg', 'Radelfingen', '- Arch', 'Crmiue', 'St. Niklaus', 'Bette', 'Schlossbr', '- denbacb', '- Bern', 'ISrnig', 'Bickigen', 'Gumiswyl', 'Mette', 'Grenae', '.d.Gumpbacb', 'Mauer', 'Gross', 'St. St. Lignez', 'Mariahilf-Freiburg', 'Traehselwald', 'Rothbrcke', 'Aeschslen', 'Steg', 'Ober-Stocken', 'wand', 'Wis', 'Gemini-Pass', 'Eschert', 'Bsenbachbriicke', 'Trubschachen', 'Sollendorf', 'Sd', 'Giimiuenen', 'Frutig', 'St. Ursnne', 'Habkerngsslein', 'Soyhires', 'Aon', 'Bzingen', 'Thsin', 'Garstatt', 'M-einisberg', 'aiml', 'Bnstenstr', 'Allment', 'R', 'Bzbergstrasse', '- wyl-Bezirk', 'Slundenslein', 'XBelnaont', 'mhlcnstutz', 'TtT', 'llurgeitihal', 'ettenhausen', 'eschberg', 'Ramsei', 'Niki', 'Alchenflh', 'Kirchgem', 'Obersteckholz', 'Langenthl', 'Wirtlishaus', 'vsain', 'enbacb', 'Gisteig', 'Gsleig', 'Fliihlenslalden', 'lia', 'Orpund', 'Hnigers-Haus', 'ScliwFuss', 'rggelb', 'Interlukenn', 'Delle', 'Reichenstein', 'Herzngenbuchsee', 'RthenBach', 'Guggisb', 'Rnder', 'Riggisber', 'Schlipfen', 'Mett', 'ohIhausen', 'IVecolaine', 'St.Stephan', 'Zihlbrck', 'Schpfcn', 'Courckavon', 'Bogen', 'Kirchlin', 'Monuard', 'nvilier', 'Drren', 'Goldbacb', 'ozigen', 'Bren', 'Beaten', 'Mreaixstrasse', 'Schpfheim', 'uss', 'wyler', 'Vbalgut', 'Brenwirthshaus', 'avannes', 'Schulbaus', 'Bnigenbrcke', 'v.Mhlethurnen', 'Neuchtel', 'Burgdorfb.Lzelflh', 'Lscherz', 'Ifriinig', '- lier', 'Hhnli', 'Surbelen', 'Illipp', 'Ilulligenbrcklein', 'Haslebrcke', 'Riedsttt', 'Signau', 'Bernb', 'Ilokwyl', 'Muriaux', 'Oeybachbrcklein', 'Luz', 'Monte', 'Berg', 'Elhlenstaldcn', 'Gschneit', 'Ltizelllhbrcke', 'Schrz', 'Bteyen', 'Serrains', 'Leissigen', 'Cuve', 'Drr', 'Scbpfen', 'Furrenbrcke', 'Ladenwand', 'Simmengrabenbrcke', 'Kalzenlochbrcklein', 'bb', 'gOeschberg', 'Ulervelier', 'Rizenbacb', 'Drstetten', 'Bibern', 'Zoll bau', 'Lamboing', 'eau', 'Fuet', 'Knigen', 'Luwenbourg', 'St. ils', 'Abw.n', 'Schppach', 'Mhlebachbrcke', 'Kop', 'Sllbacb', 'llegsau', 'Stephanxi', 'Krcherstr', 'AlBIigen', 'Orvin', 'Sch', 'IPoblern', 'Aarmiihle', '- schwanden', 'Guttenburg-B', '- Schaffhausen', 'Gastbof', 'buchsee', 'Gemmi-Pass', 'Bderich', 'Sehw', 'Wimmisbrcke', 'Leugnern', 'Mervlier', 'Breislach', 'Aarufer', 'ieenbiirg', 'Fttss', 'Wanzwyl', 'Kreuzg', 'inzenri', 'Les', 'brck', '- berg', '.Mnchenbs', 'Wiedlisbacb', 'Ziircherstr', 'Einmnd', 'Salgnelgier', 'Faulensee', 'Eris', 'Gemeindhaus', '- Ion Classe', 'SchwFuss', 'pag pag', 'Neuenburger-Grenze', 'Finmnd', 'etendorf', 'Via', 'Wegscb', 'Gltschbachbrck', 'Oberhasle', 'Moosgasse', 'Thanbrcklein', 'Langen tliai', 'Chatilion', 'Miinsigen', '- slrasse', 'entier', 'Viehniarkt', 'Wynige', 'Hofwyl', 'BaUmoos', 'Aliment', 'Grand', 'gdorf', 'Courteniaulruy', 'Oberried', 'Dur', 'Lsclierz', 'Kirchlindach', 'Wydengssli', 'jSolothurn', 'Moclistr', '- dng', 'liimlach', 'angnau', 'Schlsslihubel', 'Wicht', 'Ilerrenschwanden', 'Micourt', 'Rig', 'St. St. Kapp', 'Bis', 'Schdw', 'ISnttwy', 'Lau', 'Rangier', 'YVaisenh', 'Gemmi', 'Scbtiottwyl', 'Briinig', 'Nessenthalbrcklein', 'att-Spiezstrasse', 'Wildenmann-Gslh', 'Affoltern', 'Sefl', '- Kurried', 'DiesBach', 'Ainlsmarcbe', 'Ilolzach', 'Gr.b', 'Pel', 'Ilterichsboden', 'Vinelz', 'CJrene', 'Lauperswvl-Viertel', 'Matzenried', 'Oesehseite', 'Kreuzweg', 'Worblenbrcke', 'Neubrck', 'SSerss', 'Abw', 'Damvant', 'Wattenwyl', 'slalden', 'Moosbachbrcklein', 'Pery', 'ILes', 'Langentbl.', 'Betigen', 'Gmligen', 'Wyssenaubrcke', 'Herren', 'Aarbergu.Bren', 'Rabnflh', 'Sand Scheidew.u.Fraubrunn', 'Murgentlial', 'Siblbrcke', 'oblen', 'ach', 'Beitenhausen', 'Mtili', 'Betschwyl', 'Sir', 'Frutigen-Simmen', 'Lauperswyl', 'VonSchwareiihurg', 'neuenburgisch', 'Goldhach', 'Eindorfstrasse', 'Kirchgem.', 'Wachthaus', 'a.d.Mblenenstutz', 'Kr', '- lin', 'Gstad', '- Oberwyl', 'Blejenbacb', 'Simmenlhal', 'l.otzwyl', 'Bzberg', 'Mallnach', 'Rahnflh', 'Thal', 'Worblenbrcklein', 'Kirchgemeindgrenze', 'Winkeln', 'Hundsschipfe', 'Grafenbhlstutz', 'Schloss', 'Mastenstr', 'Ins holterberg', 'Lamlingen', 'Ringoldingen', 'Kastenstr', 'Zrcherstr', 'etc', 'Ried', 'Strasse', 'Casino', '- annenfluhstrasse', 'Naignelcgier', 'Dorfstrasse', 'Malleray', 'Thiillbrcke', 'ISern', '- strasse', 'Ortschwaben', 'Aerlenbachbrcke', 'Hub', 'Thll', 'Aegerstein', 'Kirchenthurnen', 'illolirmoos', 'wyl', 'Aarwangeu', 'Ilabkern', 'Pumpfel', 'Mhlebrckl', 'ieiler-Sclierli', 'St. Johannsen', 'Grn', 'Rubigen', 'Tromsaagebrcklein', 'ILangentba', 'Langenthal-Bad', 'iMittholz', 'Buchs', 'Amsoldingenn', 'Kernenriedsirasse', 'sch', 'Laufon', 'Lnzern', 'Nieder-S cken', 'Zrclierstrasse', 'Susten', 'Buchillon', 'Tschingelbrcke', 'flh', 'Kehrsatz', 'Murt', 'Rth', 'St. Stephan', 'AbSnt', '- vide', 'Spissibachbrcklein', 'Wiiihshaus', 'Sinnebrcke', 'Konolflngen', 'Thnn', 'Rscbenz', 'Uosa', 'Cortbert', 'ISaarselorffj', 'Ferenbalm', 'Uhnitz', 'Lavier', 'BRothmund', 'ITosa', 'gcw', 'Undervelier', 'Lttelsdorf', 'Glorelier', 'Diesbaeh', 'Zulgbrcke', 'lis', 'Brnnen', 'see', 'Thierachern', 'Rfenacht', 'Suslen', 'Sclrwan', 'Iiondrich', 'Sck', 'Rthenbach', 'St. linier', 'oldin', 'Krschenbrunn', 'Regsbach', 'Kronenwirthshans', 'Wylstrasse', 'Innerschwand', 'steinernes', 'Lwen', 'Oberbasle', 'Mlchi', 'Langenthalbad', 'Marchgrbli', 'Men', 'GreilTenbachbrcklein', 'orren', 'Sprais', 'Grindelwld', 'Ilaslebrck', 'court', '- Brienz', 'Gadmen', 'Oeybriicke', 'Rothachbrcke', 'Teuhriick', 'Haulistahl', 'Mittelland', 'SchwIuss', 'Simmenlhal berg', 'Frutigstrasse', 'Postabl', 'Distanz', 'Entlebuch', 'Pichoux, ', 'Spital', 'Stetten', 'Mittamberg', 'Vechigen', 'Lindenlkalbchlcin', 'Alclienflh', 'CLASSE', 'Mosen', 'Zollbr', 'Wld', 'lluppelsried', 'Courcelon', 'Schwarzenberg', 'buebsee', 'b.Beurnevaisin', 'Btz', 'iLauenen', 'Noirm', 'Stettlcn', 'runn', 'GrindelwaM', 'Sieebenlmns', 'CRASSE', 'Schleiwien', 'rutig', 'Trachselwald', 'Sannen', 'Boll', 'Tittingen', 'Bleyenback', 'euffelen', 'Moos', 'M.ericin', 'Wislisaubrcke', 'Monument', '- Courchavon', 'Ilettiswylbezirk', 'Ramseyweg', 'ttikofen', 'Mau', 'rlenbach', 'St. Gstad', 'Oberon', 'Lohns', 'Altane', 'ijSchwarzenegg', 'Schwarzenbrunnenbrcke', 'Gaslhof', 'sTwann', 'Boche', 'Meirin', 'Emberg', 'Saselstr.', 'Ilchstetten', 'Grellinen', 'Sckwarzenburg', '- Grelling Delmont', 'Kerzers', 'Kapp', 'Kaufdorf', 'Zollbrcke', 'Moulin', 'TSSll', 'Buclisee', 'Iis', 'Kruiligen', 'Gmmenen', 'Ober-Lin dach', 'Seeufer', 'Liesberg-Mhle', 'Krs', 'Grien', 'Schaffis', 'Gib', 'ela', '.Burgdrf', 'McIcIihsm', 'erg-IIhe', 'Frntigen', 'Lwen-Wirthsh', 'Maurerhsi', 'Ile sau', 'ziwyl', 'Aarmiilile', 'berg', 'Lenk', 'Nusnisnald', 'Mhle', '\\\\', 'Blumenstein', 'Waitrigen', 'STRASSEN', 'Belpbrcke', 'Sihlbrcke', 'a', 'Brgelbach', 'Kreuzbolz', '- brcke', 'St. Niki', 'Saage', 'BVilars', 'Cheveuey', 'Gheveney', 'Hunziken', 'Kurzenberg', 'Hilterfingen', 'Oesch', 'Murihlzlein', '- landstrassc', 'Mhledorf', 'bac', 'Niclaus', 'lnapacl', 'Enge', 'St.', 'Fra', 'Konolfmgen', 'Steckbolz', 'ISciwFuss', 'GeUerlingen', 'Hei', 'Tschppel', 'Ufis', 'Menzlingen', 'Monts', 'Teulfelen', 'Rapperswyl', 'Mnsingen', 'Ihurnen', 'Sense', 'Stun', 'Freimettigen', 'Schwadernau', 'Tkorigen', 'Dorfbrunn', 'Einmn', 'Sclipfenstrasse', 'Betllacli', 'Snterlalkeii', 'Regsau', 'Bni', 'cken', 'Alchistorf', 'Heimenschw', 'Ofaerlaaad', 'Rschegg', 'SZziwyl', 'Krmerhsi', 'Nidan', 'Perles', 'Schmiedigen', '- tigen', 'Weidbacb', 'Reckenthal', 'Brienzwyler', 'Saule', 'Emibois', 'Courtelary', 'Herzogenbuchsec', 'Murlenstrasse', 'Neu', 'Mhle-Thur', 'Reco', 'jSoyhires', 'Herzogenbucbs', 'Signait', 'Balzenbrcke', 'Baselstrasse', 'Stade', 'Delemont', 'Schachenbausbrcke', 'cnbourg', 'ISraix', 'Breitenbach', 'Montmnil', 'Hulfiiyl', 'Thile', '0esch', 'Reudlenbrcklein', 'Innert-Kirchet', 'Ocschlsers', 'Bressaneourt', 'Bubeney-Brcke', 'Brenwirths', 'Rebelsch', 'ackern', 'Drrmhle', 'Wirtkshaus', 'b.Burgdorf', 'St. St. Niederbipp', 'Int', 'Kandersteg', 'Schloss-Eingang', 'Macolin', 'bas', 'Montavon', 'ehern', '- Ob.', 'Sas', 'Itutgenlhal', 'Miirgentha', 'Ct.', 'Hirsern', 'Forst', 'Hrseheiiliniiiineit', 'Btter', 'Kerzerz', 'Kircbgemeindgrenze', 'Hornbach', 'othach', 'Heimiswyl', 'Nieder-Stocken', 'Blankenburg', 'Bad', 'SelawFuss', 'eveli', 'Schwandenbach', 'De', 'CaquerellQ', 'Vanel', 'Lattigen', 'St. St. jSchwarzenburg', 'Kirchschwand', 'ILotwyl', 'Schwai', 'STRASSEX', 'Lern', '- Thoren', 'ingreis', 'Canton', 'Trachseltvuld', 'chenb', 'Waisenbs', 'Stckern', 'Ligerz', 'Bxingcn', 'Ablntschen', 'melon', '- anont', 'Wengi', '- gen-Strasse', 'Interlah.cn', 'ern', '|', 'Goldswyl', 'Vaux', 'SSeiii', 'Stublegg', 'Flhliberg', 'Wynigen', 'Aaruu', 'a.Tlmnersee', 'Rterichsboden', 'Rti'}",1514,"{'', 'Rams', 'Wlesllisbach', 'Neuenegg Bern', 'Bassecourt Bürglen', 'ezwyl', 'Kronnbrcke', 'Joch', 'Heid Gasthaus', 'bolz', 'Gaslh', 'Nidau Bourg', 'Kirchberg Kirchlindach', 'Reggisberg', 'Falkenberg Montfaucon', 'Che', 'Wydenmatt-Scheune', 'lAmpach', 'St 3VT Schw Fuss Von Sasuitii Wegseli Dorf', 'Langenthal Löwenwirthshaus', 'Bois Noir', 'erswyl', 'Gstad Brücke', 'Wolfe', 'Hutlwyl', 'Bernb Siech haus Ende Stadtbez', 'enenstadt', 'Bettenhsn', 'Westenback', 'Mattenbrcke', 'SckwFuss', 'Bern liisBilicrn Grenze', 'Gmdhs', 'Gwatt-Spiezstrasse', 'Langenthal-Ilutlwylslrasse', 'Pieterlen Lengnau', 'Bubeneibrcke', 'Flhlenstalden', 'St von Grenze', 'Rizenbacb Fenis', 'Schw Fuss St', 'Hindelbank Kirche', 'aRuchmhle', 'Meikirch', 'Messen', 'Frutigen Scheideweg', 'Safnern', 'Wengi Menzlingen', 'Krschenbrunnen', 'Riedbach', 'Gel', 'Kaufhaus CI', 'Nods Pont Thiéle', 'Bucliholter', 'St. St. Aarau', 'Scbattenbalb', 'Schalunen othach', 'Madretsch', 'Kevenach', 'Brünig Gr', 'Hern', 'aauen Fortsetzung', 'Wyss', 'Enggistein', 'Neuen egg', 'eatenberg', 'Kiesen Laupen Schiffbrücke', 'Glovelier St Niklaus', 'Courtaron', 'Lappigen', 'Ins', 'ISaargdoirf', 'Walpers', 'Mhleberg', 'Griudelwald', 'Geiendorf', 'Schachenbausbrücke', 'Scbüpfen', 'JolBSMBSBsesB', 'Saage Courcbapoix', 'Interlaben', 'Biglen Gasth', 'Wulperswyl', 'üthi', 'Rosengriengrubc', 'ISoyhires', 'zin', 'Ilasle-Brcke', 'Glovclier', 'Saule Ilokwyl', 'Nieder-Wangen', 'Lwenwirthshaus', 'Magglingen', 'Pie ter', 'ehBurg', '- ach', 'Zäzibach', 'Bönigenbrücke', 'Lwenwirtksh', 'Brandis', 'Thier', 'Büren zum Hof', 'Thun Lauithor', 'Obernz', 'ololhurn', 'Steckholz', 'Rmligen', 'Stadttlior', 'Frutigen Pfeffingen', 'Aeschi.bis', 'Guttannen', 'Orlschwaben', 'Drrbach', 'Bourg', 'Hornbach Wirthshaus', 'Nidau grosse Zililbrücke Anfang', 'Mühlebrückleiu', 'Langenthal-Aarwangenstrasse', 'Schmittenbachbrücke', 'Diemtigen', 'Flhlenstaldens', 'Milte Amtsrn', 'Zwingen', 'Tltiin', 'Saunen', 'Finstermoosstutz-Anfang', 'venez', 'Kisninerwald', 'Zzibach', 'Reutigen Stocken Relp Kapf', 'thenbach', 'Wildeneibad', '-', 'Bettenkausen', 'sch wan', 'Kirchen-u.Mhle', 'SchwFuss St STRASSEN', 'Zrcherstrasse', 'Bressancourt', 'Mhl', 'TTgertschi', 'STRASSFN', 'Uetendorf Glütschbachbrück', 'Mnts', 'vide', 'MariahilfFreiburg Men ISern SSoneonrl', 'Gwattbrcke', 'Siechenhaus', 'Kweisimnien', 'Aarmhle', 'St Schw Fuss Ton llurgeitihal CJrenæe', 'Enggistein-Bad', 'Montagnes', 'Relp', 'Soul', 'Porrentruy St Ursanne', 'Schwur', 'Gümligen Classe', 'ndelbank', 'Leubringen', 'Sä', 'Gondiswyl', 'brg', 'Boltigen Dorfbrücke', 'Gliitsch', 'Poldern', 'enb', 'Fussweg', 'Spiez Schloss Spiezwyler', 'Ion Bern', 'Tissu', 'Wirthsh', 'Pieterlen Bern Büren', 'Senglerbachbrcke', 'Alienlüften', 'Traufbrcke', 'Tbun', 'Weg', 'Scbeidew', 'Aarwangenxi', 'Charmoille', 'GloTclier', 'Erlach St Johannsen', 'Rebeu', 'Uettligen', 'Langenthal Büzbergstrasse', 'Mhlenen', 'Murihlzli', 'ThunAllment', 'wylBezirk herwärts der Kaltenherberg', 'Zihlbr', 'Vinelz Goldbacb Ferenbalm', 'Wis Iis Sckwarzenburg Wislisaubrücke Rig', 'Diesbach Löwenwirtbshaus', 'OberWicht', 'Bothbrcke', 'Aaruu Postbaus', 'Montignez', 'Einimind', 'Alclienflüh', 'Stub', 'Gerolüugen', 'Fia', 'Matten alte Strasse', 'Neuenbur', 'Lfterngrbli', 'IschwFuss', 'Franches', 'Xrcherstr', 'Cant', 'Neuhans', 'ISoelse', 'Cantons Bern', 'Bubeneibrücke', 'Biel Montavon', '- hausen', 'Aescbi', 'Balzenbrücke', 'Pruntrut Classe', 'Brcklein', 'Ablntscben', 'Lenk Thüll', 'Grund', 'Zollbrück', 'Anitsmarcbe', 'Tromsaagebrücklein Kircbgemeindgrenze Saunen Lauenen Schlüsslihubel', 'Sriswyl', '- thal', '- storfstrasse', 'Wegweiser', 'SReggisberg', 'Bienne', 'track', 'Fruligen', 'Krauchthal Mühle', 'd.IIeustrickbad', 'Del', 'Rahnflüh Mitte Dorfes', 'Bettenhausen', 'Mnchenbuchsee', 'd.Simme', 'Grnenbrcke', 'Riedtwyl Wirthsbaus', 'Dito', 'fiRthenbach', 'Birai', 'Landeron', 'zwisch', 'Saancn', 'Trub', 'IVogtsburg', 'Courtavon France', 'Ciltschbach', 'Schplen', 'Ortscbwaben', 'Gais', 'Utzenstorf Zollhaus', 'Bief', 'Schwarzenberg Noirm', 'Grandval', 'Ablntschenbach', 'Wyl', 'Matten Wirthshaus', 'Burgdorf Laupen', 'Gurnigelbad', 'VonSchwaræeiihurg Strasse', 'Pont Vaux', 'Uebertrag', 'IschwFuss St STRASSEN CLASSE St ScliwFuss ITosa ESurgdorf Murgeratltal Fortsetzung', 'Rena', 'Brgelbacli', 'Kappelen Brandis', 'Saanen Wegscheide', 'Imboden', 'Langenthal Lüwenwirthshaus', 'Marche Gsleig', 'aup', 'ers', 'Reich', 'Schulbachbrcke', '- mont', 'Plen', 'Weidbach', 'Zollbrück Wirthshaus', 'St. Imier', 'neue Zollbrück', 'Bellclay', 'Mühledorf', 'Koiliitrckc', 'Scbtiottwyl Radelfingen', 'changnau', 'Ligerz Eschholzmatt Luz', 'Gr.', 'Maurerhusli', 'Rxau', 'Lignez', 'Oeybrcklcin', 'Unter seen', 'bint', 'Atlelboden', 'Wegmhle', 'Schwarzwasserbrcke', 'Sifcassra', 'Meichnau', 'Biel Krämerhüs', 'ltargdorf', 'Zolliko', 'Oberönz Cantonsgr', 'NiederScherli', 'Ourrmhle', 'Grünenberg', 'Einni.ind.Slr.n.Thurnen', 'Scliw', 'Aarw', 'Rielerbrcke', 'Courrend', 'lCrmine', 'Burgdorf Mühledorf', 'Bonfol', 'Steinibach', 'Stocken', 'Curried', 'Lngenmattstutz', 'Bicki', 'sarcla', 'Kastenslrasse', 'Str IC1', 'Brunnen', 'Surs', 'Niederbipp', 'Langnau-Bezirk', 'v.Adelboden', 'Neubrcke', 'Drrenroth', '- Porrentruy', 'Pleigne', 'Falkenberg', 'Lungern', 'HSiirgdoif', 'Gurbr', 'Mhlethor', 'igelt', 'Fraubrunnen Burgdorf', 'Cornol', 'Yide', 'Gysenstein', 'di', 'RosenlauiBad', 'Mntschemier', 'Signau RahnflühBezirk', 'aViques', 'St Johannsen Cantonsgr', 'neue Brücke', 'Gmmligen', 'Br.', 'Saul', 'Saurnstrasse', 'Emmenbr', 'Aarberg Sursee', 'KleinWab', 'Lader', 'S.a', 'Tschangnau Rüthenbach', 'rag', 'Pinte', 'St. Beatenberg', 'Gasthof', 'Classe', 'Beimund', 'Zziwyl', 'Cib', 'Zollh', 'Aintsmarcke', 'Koppigenbrücke', 'Scbppach', 'Scherzlisbrücke', 'Mühlenen', 'Büren Kriechenvryl Leuzigen Aarbergu Lyss', 'Scliüpfheim Kirche', 'Saancn Rüderswyl Schüppach', 'rub', 'Alle Gsteig', 'Bellelay Soul Sulz jSoyhières', '- Lindach', 'Reinisch', 'Niederried', 'Zäziwyl Kronenwirthshans', 'Fontenois', 'Damschreux', 'Schiippach-B', '- lein', 'Errata', 'Marchgräbli Ende LangnauBezirk', 'Gltsch', 'Lim', 'Aarkergerstrasse', 'Diesbach NiederSch fiRüthenbach', 'Koncourf', 'Wangen Aarwangen', 'Liesiergr-Miible', 'Ltscbenthal', 'Wollbausen', 'Thrishaus', 'Hausen', 'Postbaus', 'Büzberg Courgenay', 'Riiedcrswyl', 'Jochlishaus', 'Srf', 'Kaltenherberg Wirthshaus', 'Karrweg', 'Grnen', 'Vhieraebern', 'stein', 'ssach', 'Kirche', 'Gltsehbachbrckl', 'Bmont', 'Ferrière', 'Kutlliz', 'Erl', 'Scheiclew.naeh', 'Pillon-Pass berg', 'Laulenbad Moosbachbrücklein', 'Dorfbackbrckl', 'Sc', 'Cts.', 'nisberg', 'Ltizelllühbrücke', 'lingen', 'St JolBSMBSBsesB', 'Hcr', 'lus', 'Zwieselberq', 'Crmine', 'Rderswyl', 'Nieder-Lindach', 'Könitz Lauterbrunnen', 'Gebstorf', 'Langenthalstr', 'Niederried Dorfbrunnen', 'Löwenwirlhshaus', 'Amtsmarcbe', 'Schwendi Dorfbrunnen', 'Mont', 'Langeten', 'Grossbachbrcklein', 'Wier', 'NiederLind', 'Garstatt Zollbrücke', 'Wimmis Stade Ibach', 'Mitholz', '- wald', 'Vou', 'rie', 'Amtsm Thun Simmenthal', 'Erlach-Nidau-Strasse', 'Steck', 'R.Statlh', '- bach', 'Wink', 'len', 'Thurneu', '- Glovelier', 'Eibrcklein', 'Bözigen', 'Br', 'Saignelégier III', 'Papiermühle', 'Schüpfcn', 'Kanderbrcke', 'Keislenbrcke', 'Mutzwyler', 'Lutliern', 'NiederLindach', 'Kern', 'iRinggenberg', 'Ziircherslrasse', 'Cibourg', 'Sanetsch-Pass', 'SchiippachB', 'Lüscherz Langenthal', 'HünigersHaus', 'rer', 'Btzberg', '- Rthenbach', 'Voit', 'Durheiin', 'Moulin Liesberg', 'SchwI', 'Mid', 'Court', 'Susten-Pass-Hhe', 'S', 'Glovclier Safnern', 'Roth-Bezirk', 'Krailigen', 'Stundenslein', 'Interlaken Casino', 'rcke', 'ISolothurn', 'Walkringen Bärenwirthshaus', 'Urweidbrcke', 'Eggiwyl', 'Lyssachstrasse', '- grbe', 'Wartenbergbrcke', 'Freiburggebiet', 'Oberönz', 'Mötsckwyl Pinte', 'uhea', 'Bur Waisenh', 'Genevez', 'Long eau', 'Cappelen', 'arberg', 'ols', 'Shmnen', 'Nieder-Sto', 'SchwFuss St STRASSEN III CRASSE St Schw Fass Von Zweisiminen Isis', 'Oeybriicke Marche', 'Frauenkappelen', 'ohlern', 'thal', 'Saanen grosses Landhaus', 'egistorf Luz', 'St Urban', 'Scherzlisbrcke', 'Montscvelier', 'Saulcy Aarberg', 'Walkringen', 'Flühlenstaldens', 'Saumweg', 'Brix', '- Simmenthl', 'Belp Siechenhaus Scheideweg', 'Amtsm', 'euerspritzenbuscben', 'Lengnau Langenthalbad', 'Brggelbach', 'Marche', 'Schiipfen', 'Ulzenslorfstrasse', 'Hettiswjb', 'ttiggr', 'Pic rien', 'Bnig', 'Faulensce', 'Engelberg Joch', 'Mieschdorf', 'liisBilicrn', 'Lwenbourgj', 'Worb Wengi', 'Saanen Wegsch Dorf', 'V.Bern', 'Itiren', 'Burgdorf YVaisenh', 'Wylerbrücke', 'Bern Fraubrunnen', 'Sumiswald Murgenthal', 'Pieterlen Leugnern Biiren', 'beiNeuenegg', 'zenburg', 'Gerolugen', 'Delémont Aarwangen', 'Mnsing', 'Toffen', 'St SckwFuss Unterseen', 'lodin', 'Moutier Safnern', 'Luzern flüh', 'Schiffbrcke', 'Siechenh', 'Furrcn Oberbasle Grindelwald', 'Miinsingen', 'Gireiaze', 'Bois', 'Grellinçen', 'Golbrcklein', 'Brgg', 'Crmiue', 'St. Niklaus', 'Dürrenroth Saage', '- denbacb', '- Bern', 'Spiez Feuerspritzenhüsi', 'Gumiswyl', 'Mette', 'Grenae', 'Gümmenen', 'Saanen Wegscb Dorf', 'Burgdorf Waisenhaus', 'Lenkbrücklein', 'Mariahilf-Freiburg', 'Kapf Wegscheide', 'Steg', 'Scbüpfen Kröschenbrunn Cant', 'wand', 'Gemmipass Cantonsgr', 'Trubschachen', 'Sd', 'Frutig', 'Soyhires', 'Aon', 'Thsin', 'Bourrignon Breislach', 'Garstatt', 'aiml', '- wyl-Bezirk', 'Slundenslein', 'mhlcnstutz', 'eschberg', 'Ramsei', 'Niki', 'Kirchgem', 'Obersteckholz', 'Wirtlishaus', 'Thun Wegsch aufd', 'Gsleig', 'Fliihlenslalden', 'Büetigen', 'St Beaten', 'lia', 'Orpund', 'Duggingen Cornol', 'Interlukenn', 'Delle', 'Herzngenbuchsee', 'RthenBach', 'Rnder', 'Burgdorf Rüschegg', 'Riggisber', 'ohIhausen', 'St.Stephan', 'Zihlbrck', 'Hühnli', 'Wyssenaubrücke', 'Courckavon', 'Bogen', 'Albligen Schonried', 'Kirchlin', 'Monuard', 'Goldbacb', 'ozigen', 'Bren', 'Weissenburg stein Brücke', 'Kaltenherberg SanetschPass', 'wyler', 'Zweisim', 'Vbalgut', 'Kernenried St', 'Sand Scheideweg', 'Brenwirthshaus', 'Chiètrès', 'Bnigenbrcke', 'v.Mhlethurnen', 'Neuchtel', 'Worb Huttwyl', 'Burgdorfb.Lzelflh', 'Lscherz', 'Ifriinig', 'Hhnli', 'Surbelen', 'Illipp', 'Ilulligenbrcklein', 'Mühleberg Lyssach', 'Haslebrcke', 'Bern Buren', 'Ilokwyl', 'Muriaux', 'Luz', 'Stv Boche St ISraix', 'Berg', 'Elhlenstaldcn', 'Gschneit', 'Brückl', 'SchwIuss St STRASSEN III CLASSE St ScliwFuss Vom Interlakcn', 'Steck bolz Pinte', 'Schrz', 'Bärenwirthshs', 'Bteyen', 'Leissigen', 'Cuve', 'Drr', 'Scbpfen', 'Furrenbrcke', 'Simmengrabenbrcke', 'Kalzenlochbrcklein', 'bb', 'Ulervelier', 'Bern GemmilPass', 'Drstetten', 'Bibern', 'Lamboing', 'eau', 'Interlaken Büren', 'Schüpfen', 'Büren Surbelen', 'Knigen', 'Saanen Eschert', 'ISoyhières', 'Abw.n', 'Schppach', 'Mhlebachbrcke', 'Kop', 'Bonfol Oberwyl', 'llegsau', '1er Strasse', 'Movelier Lyss', 'Kirchberg Gaslhof', 'Stephanxi', 'Calruis', ' Ringoldingen Rüxau llüegsau', 'Brünig Wachthaus', 'IPoblern', 'Aarmiihle', 'Guttenburg-B', '- Schaffhausen', 'Gastbof', 'Bderich', 'Wimmisbrcke', 'Mervlier', 'Fttss', 'inzenri', '- berg', 'Schwanden Schüpfen', '.Mnchenbs', 'Ziircherstr', 'Salgnelgier', '- Ion Classe', 'Dorf Reich', 'Neuenburger-Grenze', 'Wegscb', 'Gltschbachbrck', 'Moosgasse', 'Viehniarkt', 'Wynige', 'Walkringen St Imier', 'Büzberg Langenthal', 'Hofwyl', 'Golbrücklein', 'BaUmoos', 'Aliment', 'Courteniaulruy', 'Bothbrücke', 'Kirchlindach', 'jSolothurn', 'liimlach', 'Schlsslihubel', 'Lauterbrunnen Kirche', 'Ilerrenschwanden', 'Rig', 'St. St. Kapp', 'Schdw', 'Büren', 'Porrentruy Isis', 'Rangier', 'Cantonsgrenxe', 'Briinig', 'Nessenthalbrcklein', 'Ilerrenschwanden Brunnen', 'Oberhofen Porrentruy', 'Pferdmund', 'Ilterichsboden', 'Vinelz', 'Solothurn Bern', 'Frankreich Pfefferhausen', 'CJrene', 'Lauperswvl-Viertel', 'Matzenried', 'Ringgenb Wiiihshaus', 'Kreuzweg', 'Schloss Spiez', 'Abw', 'Wattenwyl', 'GreilTenbachbrücklein', 'Pery', 'Dürrenast', 'ILes', 'Gmligen', 'Saignelégier', 'Aarbergu.Bren', 'Ton Kern', 'VonBern bis Ladenwand EndeStadtbez', 'Sand Scheidew.u.Fraubrunn', 'Murgentlial', 'Siblbrcke', 'Tschingelbrücke', 'CI', 'Zürcherstrasse', 'ach', 'Zell Luz', 'Beitenhausen', 'Mtili', 'DISTANZ St St eurnev', 'Sir', 'Frutigen-Simmen', 'Lauperswyl', 'VonSchwareiihurg', 'Hilterfingen Dorfbachbrücke', 'Kirchgem.', 'Eindorfstrasse', 'Bleien bac', 'ErlachNidauStrasse', 'a.d.Mblenenstutz', 'Thun Fortsetzung', 'Fritzenb ergIIöhe', 'Dorfbrücke', 'Blejenbacb', 'Scliw Fuss St STRASSEN CLASSE St SchwFuss', 'Bzberg', 'Thal', 'Winkeln', 'Schloss', 'Burgdorf Wangen', 'Mastenstr', 'Ringoldingen', 'Kastenstr', 'Zrcherstr', 'etc', 'SaanenMüser', 'Griudelwald Ober Steckbolz Burg', 'Ried', '- annenfluhstrasse', 'Bassecourt Stetten', 'Burgdorf Joux Herrn', 'Grindelwald Saignelègier', 'Naignelcgier', 'St Ursänne', 'Reichenbach Mühle', 'Schwarzenbrunnenbrücke', 'ISern', '- strasse', 'St Min', 'Ortschwaben', 'Aerlenbachbrcke', 'Hub', 'Wirlhshaus', 'Thll', 'Linden Wirthshaus', 'Mühlebrückl', 'St Braix Les Serrains ontfaucon', 'Aarwangeu', 'Pumpfel', 'Mhlebrckl', 'St. Johannsen', 'Adelboden Brislach', 'Rubigen', 'Langenthal-Bad', 'iMittholz', 'Sclnv Fnss St STRASSEN III CLASSE St', 'Kernenriedsirasse', 'Laufon', 'Waitrigen Bezirk', 'Lnzern', 'Susten', 'Ober Lindach', 'Buchillon', 'Kehrsatz', 'Rth', 'AbSnt', '- vide', 'St Min St Min', 'Spissibachbrcklein', 'Spiez Postablage', 'Konolflngen', 'Rscbenz', 'Uosa', 'Cortbert', 'Tkorigen Wirtkskaus', 'Uhnitz', 'BRothmund', 'gcw', 'Diesbaeh', 'Brünnen', 'Brnnen', 'Feuerspritzenhüsi 4armigen Wegweiser', 'Bern Alach', 'St. linier', 'Krschenbrunn', 'Langen tliai Bären', 'Kronenwirthshans', 'Grünenbrücke', 'Hospital auf der Grimsel', 'Wylstrasse', 'Innerschwand', 'Mauer Mühle', 'steinernes', 'Lwen', 'Diesbach Lüwenwirthshaus', 'Mlchi', 'Neubrück', 'Langenthalbad', 'Bern Unter', 'GreilTenbachbrcklein', 'Aare Amtsmarchc', 'Sprais', 'Tüscherz', 'Gadmen', 'Aarberg Pumpfel', 'Solothurn Porrentruy', 'Gsteig Lauenen', 'Teuhriick', 'Krosclienbrunnen Brücke', 'Mittelland', 'SchwIuss', 'Frutigstrasse', 'Distanz', 'Heid NiederWangen', 'Pichoux, ', 'Spital', 'CLASSE', 'Zollbr', 'Wld', 'lluppelsried', 'Courcelon', 'buebsee', 'b.Beurnevaisin', 'iLauenen', 'Bellelay Stocken', 'rutig', 'Boll', 'Belp Moutier Thier', 'Bollodingen Bern', 'Tittingen', 'Bleyenback', 'euffelen', 'Brislach Busswyl', 'Moos', 'M.ericin', 'Wislisaubrcke', 'Courtaron France', 'Ramseyweg', 'Mau', 'Kurried', 'Rüderswyl Kirche', 'Oberon', 'Lohns', 'Altane', 'Interlaken Oberhasle', 'Schwarzenbrunnenbrcke', 'sTwann', 'Boltigen Pic', 'LangenthalIlutlwylslrasse', 'Meirin', 'Emberg', 'Saselstr.', 'Burgdorf Luwenbourg', 'Ilchstetten', 'Grellinen', 'Sckwarzenburg', '- Grelling Delmont', 'Kapp', 'Zollbrcke', 'Worblenbrücke', 'storfstrasse', 'Bütz', 'Grien', 'Gonten Abweg', 'Lyss Bern', 'Gib', 'ela', 'erg-IIhe', 'Blankenburg Schlossbr', 'Frntigen', 'Bözingen', 'Maurerhsi', 'Ile sau', 'Scbüppach', 'Flühliberg', 'Waitrigen', 'STRASSEN', 'Belpbrcke', 'Allmendingen Wirtkshaus', 'Eggiwvl', 'Simmenthl', 'Brgelbach', 'Kreuzbolz', 'Les Bois', 'Schlossbrücke', 'Saage', 'BVilars', 'Oben Längenmattstutz', 'Gheveney', 'Hunziken', 'Kurzenberg', 'Oberland Mittelland', 'Oesch', 'Murihlzlein', '- landstrassc', 'bac', 'St ßeatenberg Kirche', 'Enge', 'Fra', 'Kiesen Grandval Granfelden', 'Dürrmühle', 'Tschppel', 'Ufis', 'Menzlingen', 'ieilerSclierli', 'Langenthal Mervelier Messen', 'Monts', 'Freimettigen Gastbof', 'Sense', 'Stun', 'Freimettigen', 'Tkorigen', 'Langenthal Ansmünd Kasten', 'Dorfbrunn', 'Sir St Braix Cl', 'Bni', 'Belp Séprais OberStocken', 'Mau rer beim Ramseyweg', 'thalstrasse', 'Rschegg', 'Kirchdorf Bethlehem Saageweidli', 'Nidan', 'OberStocken', 'Weidbacb', 'Brienzwyler', 'Saule', 'Emibois', 'Saanen Muri', 'Murlenstrasse', 'Tliieraeliern', 'Neu', 'Mängistorf', 'Bad Vanel Grenze', 'Reco', 'Maurerhäusli', 'jSoyhires', 'Herzogenbucbs', 'Villeret Oberbipp', 'Balzenbrcke', 'Baselstrasse', 'Lenk Pfarrhaus', 'Stade', 'cnbourg', 'ISraix', 'Ion Classe', 'Hulfiiyl', 'Luzern Langenthal', 'Wal erswyl', 'Schüpfheim', '0esch', 'Ocschlsers', 'Bubeney-Brcke', 'Brenwirths', 'Rebelsch', 'Drrmhle', 'Meriïcin', 'Cheveuey Glütsch', '¥', 'Macolin', 'ehern', '- Ob.', 'Miirgentha', 'Ct.', 'Aarwangen Wangen', 'Hirsern', 'Forst', 'Kerzerz', 'Kircbgemeindgrenze', 'othach', 'Heimiswyl', 'Nieder-Stocken', 'Blankenburg', 'Bad', 'De', 'CaquerellQ', 'Vanel', 'Lattigen', 'Bezir ksInge', 'Müncheubuch', 'ILotwyl', 'STRASSEX', 'Belp Scbwendi', 'ingreis', 'Canton', 'Trachseltvuld', 'chenb', 'Ligerz', 'Miinsingen LüwenWirthsh Ober Wich track Wirthsh', 'Érlenbach Dorfbrücke', 'Kandersteg Wirthshaus', 'St Niki', 'Stettlen Worb', 'melon', '- anont', 'Wengi', 'Lamboing Lim', 'Von Mur', 'Interlah.cn', 'OOS Illipp', '|', 'Goldswyl', 'Stublegg', 'Wynigen', 'Aaruu', 'Canlonsgrenze', 'Lan', 'Dorfbrunnen', 'ontfaucon', 'Bern Wort', 'St. Sch', 'Schppachbrcke', 'Röthenbach', 'Dürrenroth', 'Thalgut', 'Sclipfheim', 'Fuel', 'Handegg', 'Tmbscbaclien', 'Engelberg', 'SSern', 'Daniphreux', 'McIcIihsmü', 'riswyl', 'Pielerlen', 'Gais Zihlbrück', 'Wiedlisb', 'lidan', 'St. Urban', 'Fra wyl Grafenscheuren Frauenkappelen', 'St Schw Fuss', 'Latlerbach', 'Brügg', 'Erlach Lüsclierz', 'Ilfisbrcke', 'Riedbach Förstli Jochlishaus', 'Kwiselaeaa', 'Ibach', 'Delmonl', 'Hbeli', '- zenburg', 'Soiicelio', 'Wengi Dorfbrunn Kreuzg', 'Brien', 'IMelnisberg', 'Nieder-Lind', 'St Braix', 'Thim', '- Mngistorf', 'Bigeltbal', 'Qfiiill', 'HünigenBezirk', 'Sand', 'Grafenried', 'gPieterlen', 'SehwFuss', 'liSUBgUaU', 'Teuffeien', 'vide pag', 'Pry', 'Long', 'Usargdorff', 'Wald', 'zelflh', 'Wvssachengraben', 'Pass', 'Lwenwirlhshaus', 'Hermrigen', 'juchHü Steckholz', '- selwald', 'Raupen', 'Wingreis', 'i.Rolhbezirk', 'Slollodingeu', 'Saanen Gross Hochstetten', 'Oberbipp', 'St. St.', 'Mnster', 'Pfefferhausen', 'Sasuitii', 'Glovelier Scheideweg', 'BubeneyBrücke', 'Bnigen', 'Linden', 'Les Rangiers', 'Murgen', 'Rosengartenbrcklein', 'thf', 'Kirchlindach Pfarrhaus', 'Meyenbachbrcklein', 'lmont', 'Schaffhausen Wirthshaus', 'torf', 'Krosclienbrunnen', 'Kutlitz', 'Fritzenberg', 'Courgenay III', 'Reicbenbacb', 'Rangiers', 'Mhlebrckleiu', 'Lanpen', '^', 'Rahnflh-Bezirk', 'Spiez Schloss Mervelier', 'Oberwyl Simmenlhal berg', 'Wangenstrsslein', 'Scbeidw', 'GwattSpiezstrasse', 'Brünigen', 'ESurgdorf', 'Reidenbacli', 'Spitalbögelisbrücklein', 'Diesbach Bassecourt', 'dobZulgbr', 'Breuleux', '- mhle', 'Hutlwyl Saulcy', 'Brnigen', 'elz', 'St. Min', 'appel', 'Aarberg Riggisberg', 'Gasei', 'Neubrücke', 'DiesBaeh', 'MBB', 'Undervelier Obersteckholz', 'Grelling Delémont', 'Bätter', 'Amtsmarcke zwiseken Uurqdorf Wangen', 'Stadtthor', 'Port', 'Stundensl', 'VonBern', 'Latterbach steinerne Brücke', 'Susten-Pass', 'Limp', 'Souboz', 'Kröschenbrunnen', 'Eing', 'Wasen Abweg', 'Fus', 'Mnrgentlial', 'Frutigen Ins', 'Schmittenbachbrcke', '- gsslein', 'Glzibrunnen', 'Ber.rc', 'Cl. Landstr', 'Gltscb', 'Zimmerwald Krauchthal', 'Piquerez', 'Ltizelflhbrcke', 'Krmerhs', 'St. IJrban', 'Siech', 'Ciliourg', 'SRüeggisberg', 'Joux', '- jVechigen', 'St Urban Cantonsgrenze', 'Lenkbrcklein', 'Wirthsch.b.Oberwyl', 'Watt', 'Pussweg', 'Luterbrunnen', 'Kaslenstrasse', 'Min', 'Granfelden', 'lnkwyl', 'Miécourt', 'Rosenlaui-Bad', 'Linde', 'gisberg', 'Scbwendi', 'Mhlen', 'Lugnez', 'Zäziwyl Krouenwirthshaus', 'Zoll', 'Emmenbrcke', 'Altorf', 'Klein-Wab', 'Laufen', 'Lauithor', 'dach', 'Aarb', 'Dorfbrcke', '- mensehuaml', 'Noir', 'Spiezwyler', 'Hofstetten Pinte', 'Kanderbrücke', 'a.d.Kreuzg', 'Poslahlage', 'Hrrenroth', 'Saanen-Mser', 'Sdern', 'Aerlenbachbrücke', 'Drrenast', 'uzigen', 'iVingras', 'Gndlischwand', 'LiesiergrMiible', 'Has', 'Glockenthal', 'Brücke', 'les', 'CiboniTg', 'Seltenbachbrcke', 'Zulgbrücke', 'Track', 's-Wab', 'chp', 'Ansmnd', 'Falirw', 'Meiringen WildenmannGslh', 'SiEBSEBBeUlB', 'Konolngen', 'Kirchberg Weissenbach', 'Courte', 'Scliwuss', 'Itou', 'St STRASSEN CLASSE St Schw Fass Vom Bern', 'Gwatt Pinie', 'leiignati Grenze', 'Sumiswald Hasle', 'Berne AbbrcviatioHs', 'W', 'Radelfin', 'Solothurn Ton', 'Utzigen', 'Stoefceaa', 'Aarberg Aeschi', 'Schonried', 'Goumois', '- Pferdmund', 'Steffislsurg', 'Englisb', 'Aarbergu', 'Ams', 'Chitrs', 'cke', 'Zrich', 'Delniont', 'St. Braix', 'ettenhausen Kastenstrasse', 'Leissigen Bad', 'Langentbl', 'Emmenthal', '- Scheunenberg', 'Brünig beim Sclrwan', 'Rtschelenthor', 'Gresaze', 'Lüfterngräbli LauperswvlViertel', 'd.ob.Zulgbr', 'Menenegg', 'Kniz', 'Rchenez', 'pag', 'Wyssachengraben', 'Ferrire', 'Bubendorf', 'Rahnflüh', 'Breitenbach Solothurn', 'Twerenb', 'Hof Hasle', 'Thun Saage', 'UMliSW', 'Rebeuvelier', 'Hnigen-Bezirk', 'Malleray Murgenthal', 'Spiez Postablage Wegscheide', 'SchwFuss St STRASSEN CLASSE St Scliw Fttss', 'Oltigen', 'Rabnflüh', 'Miirgenthal', 'Utzenstorfstras.se', 'Belp Altorf', 'OberLin', 'Murgeratltal', 'Les Rangiers Rebelsch Oppligen Rapperswyl Scbüpfen Orpund', 'Nidauu Büren', 'Neueneg', 'Pfeffingen', 'Saum', 'DISTANZ', 'Pschenried', 'Grosse', 'Fritzenb', 'Urban', 'Wiggern', 'BisrnnMe', 'Aehera', 'Gwattbrücke', 'Zubibacb', 'Schwi', 'Weissenbach', 'Wartenbergbrücke', 'Soubey', 'Sinnebrücke', 'Gadmen Porrentruy', 'Fass', 'Waiseaih', 'Zoll brck', 'Brcke', 'Biaufond', 'Lyss thalstrasse', 'Grbenbrcke', 'Ober-Wicht', 'Fritzengraben', 'Pont', 'Frstli', 'Uurqdorf', 'Lzelflh', 'Aarwangeu Lozwyl Bteyen', 'Mattenbrunnen', 'Bourrignon', 'Wich', 'Villars', 'ReichenbachBad', 'jNiederried', 'Huttwylstrasse', 'Cant.', 'Gliitsch Zwieselberq', 'liirchberg', 'rau', 'Brnig', 'Ker', 'Konolßngen', 'Bad Pussweg', 'Steghaldenstutz', 'Delémonl', 'Ecken', 'Koppigenbrcke', 'Bol', 'Tracht', 'Delémont Affoltern', 'Wylerbrcke', 'Schmiedigen BRothmund', 'Scimiswyl', 'Tavannes CaquerellQ über Fuet Bellclay Saulcy', 'Wacht', 'Kreuz', 'Schpfen', 'Siis', 'Meinisberg Lüscherz', 'Mnchenwyler', 'Burg', 'Interlak.cn', 'Franches Muntagnes', 'ald', 'Ringgenb', 'Melchnan', 'Blumenslein', 'Simme', 'Sonceb', 'Dorfbachbrcke', 'en-B', 'Tscherz', 'IPIeterlesa', 'Aeschleu', 'Senglerbachbrücke', 'Ct', 'Knitz', 'Laulenbad', 'bacli', 'gMontfaucon', 'Wal', 'Soy', 'mont', 'Huttwyl Städtchen', 'Frutigstr', 'NiederEicbi', 'Lzel', 'Gonten Wirthshaus', 'Schoren', 'Schlossbrcke', 'Krös chenb runn Grenze', 'Aarmühle', 'Herbligen', 'TTSnt', 'St SchwFuss Von Bern', 'Krämerhüsi', 'Süllbacb', 'Iliedtwyl', 'Sausbachbrcke', 'Tkierackern', 'Zweiliitschenen-Brcke', 'Thun-Allment', 'ISrünig Grenze', 'Prgelz', 'Reichenbach-Bad', 'Milte Zollbrück', 'nViques', 'Kriischenbrunnen', 'Nieder Sinimenthal', 'Nieder-Scherli', 'Rlurgentltal', 'Bühl', 'Bleien', 'Wirthsb', 'Cantonsgr', 'idau', 'Nieder-Eicbi', 'Ilandhuttbrcklein', 'Fussw', 'Cornol Dürr', 'Ursenbach', 'Oben', 'Ijanderon', 'Gwatt', 'erhsi', 'Kngelibrcklein', 'Obrons', 'Gümligen', 'Mtsckwyl', 'Hmelbachbrcklein', 'Kriechenvryl', 'tha', 'Habkernbrcke', 'Cbarmoille', 'Glovelier Affoltern', 'Burgdorfstrasse', 'Thun Soubey', 'Bellelay Brienzersee', 'gVingelz', 'Morschwyler', 'Wingreis Wimmis', 'Les Breuleux', 'Saanen Gsteig', 'Büren Strasse', 'Epauvillers', 'Lauibachbrcklein', 'WonliangenfbalbisMelcIsnan', 'Bützberg Arch', 'Thor', 'Grnenberg', 'Delémont Delsberg', 'Langenthal Münchenbuchsee', 'leiignati', 'Rthi', 'Pinie', 'Deisswyl', 'Les Rangier', 'Gurzelen', 'Nid Stadt', 'Duggingen', 'Sensebrcke', 'Grimsel Suslen', 'Akw', 'Eicbi', 'Albligen', 'Worb Batzenbrücke', 'Kroschenbrunnen', 'Schwar', 'Vielimarkt', 'lotkurn', 'Bressancourt Wier', 'Wimmisbrücke', 'Latterbach', 'Sand Wirthshaus Rogg', 'Biel Murgenthal', 'St Beatenberg', 'Thierachern Schoren', 'Siggernbrcke', 'Bez', 'Brglen', 'Zürclierstrasse', '- gen', 'Schleiwien Ilettiswylbezirk', 'Grcb', 'Brckl', 'Gonten', 'Bern Ins Burgdorf', 'Delmont', 'Sinimenthal', 'Tramm', 'Renan', 'Selzach', 'Bernthor', 'Frutigen Rüeggisberg', 'Emmenbrücke', 'Stockachenbriicke', 'St Ursanne', 'Gzibrunne', 'Moosbhlhubel', 'Ruchmhle', 'Nods', 'Rüderswyl', 'Utzenstor', 'Flainalt', 'Courcbapoix', 'Delsberg', 'Dakienbrcke', 'renclicu', 'Freimettigcn', 'Moine', 'mautruy', 'ileudiberg', 'Saignelgier', 'Ziegelbrücke', 'Batzenbrcke', 'Trul', 'rubschachen', 'Buch', 'Melchnan Büzberg', 'Thun Bernthor', 'Holen', 'Heiniberg', 'Sumiswald Kirche', 'Wegseli', 'Lozwyl', 'Soyhières Delémont', 'd.Kirchberg-Utzen', 'Anitsmarcae', 'enst', 'Moosbhlhuber', 'Gross-Affol', 'nbchli', 'Schw', 'Nidauu', 'Sri', 'Burgistein', 'Movelier', 'MitteZollbr', 'Béni', 'Belpbrck', '- Sumiswald', '- Tschppel', 'Buren', 'SSoneonrl', 'Kriegstetfen', 'Müntschemier', 'Soulce Sollendorf', 'Scheidew Matten Moosbühlhuber', 'Scheidweg', 'EndeStadtbez', 'Gemmi-lPass', 'Ilnigershaus', 'Courroux Wimmisbrücke dSimme aViques', 'Zollbrück Elühlenstaldcn', 'Wysslisaubrcke', 'Zililbrck', 'Montfaucon', 'Fenis', 'Heimenschwand', 'Krattiggraben', 'hieherd.Ilolhachenbr', 'Zell Gasthof', 'Soulce', 'Tlmn', 'Aeschi Sulz', 'v.pag', 'Gentelbrcke', 'Tittingen Toffen wyler Traehselwald Ramsei', 'Suaulswald', 'Gmmelien', 'Biizingen', 'Brünig Trubschachen', 'Gelterfingen Gerzensee', 'Rhynbrcke', 'Scliw Fuss St STRASSEN CLASSE St Schw Fuss Von SSerss ISifsern', 'Mncheubuch', 'Unterseen', 'Wacbtbaus', 'ourg', 'Kreuzslr', 'Scli', 'Hasle Wirthshaus Schaffhausen', 'Kohlbrcklein', 'Kirchen', 'Ton', 'VValperswvl', 'ahy', 'Mots', 'Cautonsgrenze', 'IIeil', 'ber', 'Matten', 'teffisburg', 'Les Rangiers Strasse', 'Seftigen', 'Bhl', 'Interlaken Zoll', 'Envelier', 'Nieder-Sch', 'Biiren', 'Bätterkinden', 'Schl', 'Zililbrück', 'Betten', 'Krouenwirthshaus', 'Sclul', 'Tliun', 'Monts eveli Lütscbenthal Monument Fraubrunnen Lüttelsdorf', '- Bollodingen', 'Suignelgier', 'esche nbach', 'brunnen', 'Mnchen', 'Courte mautruy', 'Delé', 'Meinisberg Mitte Dorfes', 'LangenthalBad', 'Ijangenthal', 'Vauffelin Wengi', 'Douanne', 'alm', 'Hämelbachbrücklein Grenze', 'lauter', 'Bux vide Buix', 'Bollodingen Einmündung Kastenstr Dorfstrasse', 'Saulcy Glütscb', 'Zollbrck', 'Rennendorf', 'Belpbrücke', 'Bützberg', 'Radelfingen', 'Konolfingen Signait', '- Arch', 'hausen Bollodingen', 'Bärenwirthshaus', 'Bette', 'Schlossbr', 'IlasleBrücke', 'Belp Siechenhaus', 'IBasrgdffii Isis ILaugumi', 'ISrnig', 'Bickigen', 'Milte der Thiillbrücke', 'Riedstätt', 'Alchistorf Ursanne', '.d.Gumpbacb', 'Mauer', 'Moulin Pichoux', 'Gross', 'St. St. Lignez', 'Thun Aliment', 'Traehselwald', 'Rothbrcke', 'Aeschslen', 'Ober-Stocken', 'Wis', 'Gemini-Pass', 'Eschert', 'Bsenbachbriicke', 'Wirthskaus', 'Sollendorf', 'Giimiuenen', 'St. Ursnne', 'Habkerngsslein', 'Bzingen', 'M-einisberg', 'Bnstenstr', 'Pöschenried', 'Allment', 'R', 'Brünig', 'Bzbergstrasse', 'Steffisburg Neuhaus', 'XBelnaont', 'TtT', 'llurgeitihal', 'ettenhausen', 'Alchenflh', 'Adelboden Classe', 'Haslebrücke', 'Langenthl', 'Mühlebachbrücke', 'vsain', 'enbacb', 'Gisteig', 'Langnau steinernes Brücklein', 'Scliw Fuss St STRASSEN III CLASSE St Scli', 'Saulcy St Niki', 'Unterfuhren Mühle', 'Hnigers-Haus', 'ScliwFuss', 'rggelb', 'Reichenstein', 'Guggisb', 'Schlipfen', 'Mett', 'Grimsel Susten', 'Rizenbach Murgen thal', 'IVecolaine', 'Schpfcn', 'Chevenez Laufon', 'St liirchberg', 'nvilier', 'München', 'Drren', 'Beaten', 'Mreaixstrasse', 'Langenthal Hunziken', 'Schpfheim', 'uss', 'Bärcnwirthshs', 'avannes', 'Schulbaus', 'Saignelégier Souboz', 'Thun Isis Snterlalkeii', 'Pelé mont', 'Wirlhsh', 'Thun Wegscheide', '- lier', 'Goldbach Dorf', 'Bellelay Thierachern', 'Riedsttt', 'Signau', 'Bernb', 'SchwI uss St STRASSEN III CLASSE St Scliwïuss Von Nusnisnald sarcla IIhKivjI', 'Interlaken Kollbr', 'Krà', 'Oeybachbrcklein', 'Monte', 'Trachselwald Signait', 'Ltizelllhbrcke', 'St STRASSFN CLASSE St SchwFuss Tissu Hrüseheiiliniiiineit', 'Serrains', 'Lüwenwirtksh', 'Murten Hern Menenegg Grenae', 'Courcelon Südern', 'Ladenwand', 'Walkringen Bärenwirthshs', 'Schw Fuss St STRASSEN CLASSE St SchwFuss Von Burgdorf', 'Münsing', 'gOeschberg', 'Fass St STRASSEN CLASSE St Scli Fass Von lidan Isis Itiîren', 'Rizenbacb', 'Zoll bau', 'Fuet', 'Luwenbourg', 'St. ils', 'Ilünigershaus', 'Sllbacb', 'Krcherstr', 'Brünig Grenze', 'Kohlbrücklein', 'Einmünd', 'Schwarzenegg Rö', 'AlBIigen', 'lotzwyl', 'Orvin', 'Sch', 'Amtsmarche Trachselwald Wangen RothBezirk', 'Bärenwirths', '- schwanden', 'buchsee', 'Gemmi-Pass', 'Sehw', 'Leugnern', 'Breislach', 'Aarufer', 'ieenbiirg', 'Porrentruy Frankr', 'Wanzwyl', 'Kreuzg', 'Les', 'brck', 'Vingelz Nieder', 'Wiedlisbacb', 'Einmnd', 'Bern Abweg Lyssach', 'Faulensee', 'Eris', 'Gemeindhaus', 'SchwFuss', 'pag pag', 'Amlsmarche Konolfmgen', 'Finmnd', 'etendorf', 'Via', 'Oberhasle', 'Thanbrcklein', 'Langen tliai', 'Chatilion', 'Maurerhüsi', 'Miinsigen', '- slrasse', 'entier', 'Grand', 'gdorf', 'Oberried', 'Dur', 'Sand Scheidweg', 'Lsclierz', 'Mühlen', 'Wydengssli', 'Moclistr', '- dng', 'angnau', 'St Scliw Fuss SSeiii Isis', 'Hof lAmpach', 'Wicht', 'Alchenflüh Ausmündungind Zürcherstr', 'Micourt', 'Bis', 'ISnttwy', 'Lau', 'YVaisenh', 'Gemmi', 'Scbtiottwyl', 'att-Spiezstrasse', 'Wildenmann-Gslh', 'Affoltern', 'Sefl', 'Nidau Murihölzlein', 'Ile', '- Kurried', 'DiesBach', 'Ainlsmarcbe', 'Ilolzach', 'Gr.b', 'Pel', 'Oesehseite', 'Worblenbrcke', 'Neubrck', 'Rüegsau Bätterkinden', 'SSerss', 'Damvant', 'slalden', 'Fritzenberg Höhe', 'Moosbachbrcklein', 'Langentbl.', 'Betigen', 'Münster', 'Wyssenaubrcke', 'Herren', 'Rabnflh', 'Mont melon St Ursanne Courgenay', 'oblen', 'Rüti', 'Betschwyl', 'neuenburgisch', 'Goldhach', 'Orvin Rebeuvelier', 'Wachthaus', 'Kr', 'Gadmen Steinibach', 'Grindelwald Bären wirlhshaus', '- lin', 'Gstad', '- Oberwyl', 'Spiez wyler Wirthshaus', 'Zürich Sihlbrücke', 'Simmenlhal', 'l.otzwyl', 'Mallnach', 'Rahnflh', 'Bern CI', 'Worblenbrcklein', 'Kirchgemeindgrenze', 'Hundsschipfe', 'Grafenbhlstutz', 'Ins holterberg', 'Lamlingen', 'Konolflngen Signait', 'Lengnau ISolothurn', 'Strasse', 'Casino', 'Fliihlenslalden Brücke', 'Belp W', 'Dorfstrasse', 'Malleray', 'Thiillbrcke', 'Bettenhausen Oberönz', 'Spital Frutigen', 'Thörishaus Flainalt', 'Aegerstein', 'Burgdorf Tliun', 'Kirchenthurnen', 'illolirmoos', 'wyl', 'Rüthi', 'Kaslenslrasse', 'Ilabkern', 'ieiler-Sclierli', 'Grn', 'Wink Brückl', 'Tromsaagebrcklein', 'ILangentba', 'Lüzel', 'Buchs', 'Amsoldingenn', 'sch', 'Lüzelflüh', 'Zürcherstr', 'Nieder-S cken', 'Zrclierstrasse', 'Tschingelbrcke', 'flh', 'Biel Wengi', 'St Stephan', 'Murt', 'Huttwyl Grenze', 'St. Stephan', 'Büzberg', 'Wiiihshaus', 'Sinnebrcke', 'Thnn', 'ISaarselorffj', 'Ferenbalm', 'Lavier', 'Büderich', 'Langenthalstr Ziircherstr', 'ITosa', 'Undervelier', 'Lttelsdorf', 'Glorelier', 'Barenwirthshaus', 'Zulgbrcke', 'lis', 'Courrendlin Dittingen', 'Stettlen Huttwyl Grenze', 'see', 'Thierachern', 'Rfenacht', 'Thim 10633 Von Bern', 'Suslen', 'Sclrwan', 'Iiondrich', 'Sck', 'Rthenbach', 'oldin', 'Regsbach', 'Landeron Neuenbur', 'St ScliwFuss', 'Oberbasle', 'Marchgrbli', 'Men', 'orren', 'Schloss Wimmis', 'Grindelwld', 'Ilaslebrck', 'court', '- Brienz', 'Oeybriicke', 'Rothachbrcke', 'Von Bern', 'Haulistahl', 'Oberried Wirthsh Postabl', 'Simmenlhal berg', 'Postabl', 'Seflü', 'Enge WirthschbOberwyl', 'Entlebuch', 'Trachselwald Huttwyl', 'Stetten', 'Mittamberg', 'Vechigen', 'Einmün', 'Bern Saanen Grenze', 'Cilütschbach', 'Lindenlkalbchlcin', 'Alclienflh', 'Mosen', 'dKirchbergUtzen', 'Schwarzenberg', 'Latlerbach Wegscheide', 'Btz', 'Yon Bern', 'Noirm', 'Stettlcn', 'runn', 'GrindelwaM', 'Langenthal Koiliitrückc', 'Sieebenlmns', 'CRASSE', 'Schleiwien', 'Sausbachbrücke', 'Trachselwald', 'Sannen', 'Ausmün', 'Amtsr Kernen', 'Scheidew Pielerlen Lengnau Büren', 'Monument', '- Courchavon', 'Ilettiswylbezirk', 'ttikofen', 'St Urban Luzern', 'rlenbach', 'St. Gstad', 'ijSchwarzenegg', 'Abläntschen', 'Gaslhof', 'Boche', 'Kerzers', 'Kaufdorf', 'Moulin', 'TSSll', 'Cortébert', 'Buclisee', 'Iis', 'Iliedtwyl Wirtkskaus', 'Kruiligen', 'Gmmenen', 'Ober-Lin dach', 'Seeufer', 'Liesberg-Mhle', 'Schw Fuss St STRASSEN CLASSE St SchwFuss Ton ILangentba ISnttwyï Grenze', 'Krs', 'Schaffis', '.Burgdrf', 'McIcIihsm', 'Bern St Beatenberg', 'Scliw Fuss St STRASSEN CLASSE St SehwFuss Vom IMelnisberg lias IPIeterlesa', 'Lwen-Wirthsh', 'ziwyl', 'Aarmiilile', 'berg', 'Lenk', 'Nusnisnald', 'Mhle', 'Solothurn Von Büxingcn', '\\\\', 'Blumenstein', 'Wallis Scheidw', 'Sihlbrcke', 'a', 'Tbun Rüegsbach', 'Scheidweg nacb Fuet', 'Lengnau Meinisberg', 'PillonPass berg', '- brcke', 'St. Niki', 'Nieder Scherli Scbeidew Oberbalm', 'Cheveuey', 'Hilterfingen', 'Schw Fuss STRASSEN III CLASSE St Schw Fuss Finmünd Strasse', 'Mhledorf', 'Ilolzach Wirlhshaus', 'Niclaus', 'lnapacl', 'St.', 'Konolfmgen', 'Steckbolz', 'ISciwFuss', 'St SchwFuss', 'GeUerlingen', 'Hei', 'Hindelbank Leubringen', 'Saignelégier Büetigen', 'Rothachbrücke', 'Langenthal Habkern', 'Teulfelen', 'Rapperswyl', 'Delémont', 'Rüscbenz', 'Gündlischwand Br', 'Mnsingen', 'Büren von Bern', 'Ihurnen', 'Glovelier Dürrbach', 'Schwadernau', 'LangenthalAarwangenstrasse', 'Einmn', 'Wirthsbaus', 'Sclipfenstrasse', 'Betllacli', 'Snterlalkeii', 'Regsau', 'cken', 'Alchistorf', 'mühlcnstutz Grien', 'Heimenschw', 'Saanen Koppigen', 'Ofaerlaaad', 'SZziwyl', 'Krmerhsi', 'St Johannsen', 'Perles', 'Schmiedigen', '- tigen', 'Sand ScheidewuFraubrunn', 'Reckenthal', 'Wirtbshaus', 'Courtelary', 'Herzogenbuchsec', 'Belp Siechenh', 'Mhle-Thur', 'ILotæwyl', 'Signait', 'Delemont', 'Schachenbausbrcke', 'Unter see Kaufhaus', 'Breitenbach', 'Montmnil', 'LiesbergMühle', 'Habkern Pichoux, ELOC', 'Thile', 'Reconvilier Schachen', 'Reudlenbrcklein', 'Innert-Kirchet', 'Bressaneourt', 'ackern', 'Wirtkshaus', 'Burgdorf Brücke', 'b.Burgdorf', 'Lengnau Biizingen', 'St. St. Niederbipp', 'Int', 'Spiez Dorfbrunnen', 'Kandersteg', 'Scliw Fuss St STRASSEN III CLASSE St SchwFuss Yon Int Itou', 'Schloss-Eingang', 'bas', 'Montavon', 'Grimsel Culminationspunkt', 'Sas', 'Itutgenlhal', 'Hrseheiiliniiiineit', 'Hausen Tschäppel', 'Bois Schwanden', 'Btter', 'Soyhières', 'Hornbach', 'Langenthal Seedorf', 'SelawFuss', 'eveli', 'Schwandenbach', 'Scbüpfen TTägertschi', 'St VBern', 'St. St. jSchwarzenburg', 'Arch', 'Kirchschwand', 'Aescbi Porrentruy', 'Schwai', 'Lern', '- Thoren', 'Alchenflüh', 'Fruligslr', 'Langenthal Säriswyl Rohrbach', 'Waisenbs', 'Stckern', 'Bxingcn', 'Ablntschen', 'Laupen Wirtlishaus', '- gen-Strasse', 'Münsing Murten', 'ern', 'Vaux', 'SSeiii', 'Flhliberg', 'a.Tlmnersee', 'Rterichsboden', 'Rti'}",2241
10826352,36755,"{'Thunersee', 'Elfenau', 'Aare', 'Thun', 'Konol', 'Bern', 'Belp', 'Thunersees'}",8,"{'Bern, SLOC', 'Großen Rathe', 'Grundeigenthum', 'Münsingen', 'Hahlen', 'Großen Rath', 'Rath', 'Wasserstraße'}",8,"{'- see', 'Mnsingen', 'Vaeia', 'Franken', 'Kanton', 'Bernfucn', 'Schtzenfahr', 'Seelhofen', 'Grbe', 'Bern, ', '- fingen', 'Thuner'}",12,"{'Bern, SLOC', 'Hahlen', 'Kanton', 'Bernfucn', 'Rath', 'Bern, ', 'Thuner', '- see', 'Großen Rathe', 'Grundeigenthum', 'Münsingen', 'Mnsingen', 'Franken', 'Großen Rath', 'Schtzenfahr', 'Seelhofen', 'Wasserstraße', 'Grbe', '- fingen', 'Vaeia'}",20
17996385,8390,{'Bern'},1,"{'Canton Bern', 'Nothdurft', 'Solothurn', 'Nothdurft, SLOC', 'Republik Bern'}",5,"{'Solothurn, '}",1,"{'Canton Bern', 'Nothdurft', 'Solothurn, ', 'Solothurn', 'Republik Bern', 'Nothdurft, SLOC'}",6
10733431,11019,{'Bern'},1,"{'Neuenburg, SLOC'}",1,"{'Kanton', 'Neuenburg, ', 'Nils'}",3,"{'Neuenburg, SLOC', 'Neuenburg, ', 'Kanton', 'Nils'}",4
15213334,225934,"{'Leubringen', 'Schweiz', 'Signau', 'Oberhasle', 'Steffisburg', 'Mitteland', 'Aarwangen', 'Trachselwald', 'Interlaken', 'Aarberg', 'Langenthal', 'Niedersimmental', 'Sonceboz', 'Sumiswald', 'Simmental', 'Solothurn', 'Pruntrut', 'Burgdorf', 'Thurgau', 'Niederried', 'Laupen', 'Epsach', 'Oberaargau', 'Thun', 'Traclisel', 'Biel', 'Jura', 'Erlach', 'Genf', 'Delsberg', 'Lamboing', 'Schwarzenburg', 'Kanton', 'Basel', 'Born', 'Bern', 'Neuenstadt', 'Tavannes', 'Courtelary', 'Nidau', 'Wangen', 'Freibergen', 'Roggwil', 'Pontenet', 'Frutigen', 'Seeland'}",46,"{'Goldschach', 'Bolligen Delsberg', 'Sittengerichtes', 'Port Löwenburg Grellingen', 'Berne Par Frossard', 'Konolfingen', 'Gonzenbacti', 'Berne, SLOC', 'Armemvesens', 'Büren', 'Sorvilier', 'Emmental', 'Fraubrunnen', 'Schaffhausen', 'Allmend', 'Bühl', 'Oberaargaus', 'Tramelandessous', 'Merzliycn Nidau', 'Heimatgc', 'Kanton Born', 'Bern Rätzer', 'Ursanne Epiquerez', 'Berne Redige', 'Bern Stiimpfli', 'Arineu', 'Vingelz Arch Büren', 'Vlleber', 'Sri', 'Bern Wyss', 'Seftigen', 'OberSimmental', 'Bern Chr', 'Zürich', 'Thun Wanyen', 'Republik Bern', 'Benin', 'Berne Pour Direetion lInterieur Blteseh', 'Bremgarten', 'Davon', 'Saanen', 'Burgdorf Langenthal', 'Diessbach Lengnau', 'dorBurgor', 'Jeder Gemeindsbezirk', 'Münster', 'Biet Bözingen', 'Bern Konolflngen', 'Hessen', 'Meinisberg Pieterlen Reiben', 'Neuenbürg', 'Bern Stämpfli'}",52,"{'Plagne', 'Zrich', 'Wanyen', '-', '-|-', 'Pflanzland', 'Court', 'Blsch', 'Grellingen', 'Neuenbrg', 'Orell', 'Orvin', 'Comp', 'Langnau', 'Cortebert', 'Gobat', 'Ursanne', 'Cormoret', 'Ausser-Rhoden', 'felsberg', 'Pery', 'Weingart', 'Jalirzelmt', 'Bren', 'Born Wyss', 'Alleinann', 'Xeuen.stadt', 'Fssli', 'ivillier', 'Merzliycn', 'Epiquerez', 'Haller', 'LaHeutte', 'Bern Haller', 'Tellen', '- velier', 'Trachsehvald', 'Biet', 'Hornung', 'Bernern', 'Stmpfli', 'Chtillon', 'Reiben', 'Dorn', 'Vergl', 'Ober-Simmental', 'Cliatelanat', 'Langlois', 'Diessbach', 'Luzern', 'rosp', 'Gallen', 'Rtzer', 'Stiimpfli', 'etc', 'Wald', 'Miecourt', 'St-Iniier', 'Meinisberg', 'Bzingen', 'Bernische', 'Ssetz', 'Lwenburg', 'Vieh', 'Nieder-Simmental', 'Mnster', 'Under', 'Wachsel', 'Corgemont', 'Total', 'Kiesen', '- wald', 'Belp', 'Bevilard', 'Lengnau', 'Kantons', 'GrandvaljMalleray.Per', 'Ludwigsburg', 'Vingelz', 'Zollikofer', 'Sehwarzenburg', 'Obersimmental', 'Bhl', 'Xidau', 'Bern, ', 'Pieterlen', 'Leipzig', 'Wyss', 'Lierow'}",89,"{'Plagne', 'Bolligen Delsberg', 'Port Löwenburg Grellingen', 'Berne Par Frossard', 'Zrich', 'Wanyen', '-', '-|-', 'Pflanzland', 'Bühl', 'Merzliycn Nidau', 'Court', 'Blsch', 'Grellingen', 'Bern Rätzer', 'Neuenbrg', 'Orell', 'Orvin', 'Vingelz Arch Büren', 'Comp', 'Thun Wanyen', 'Langnau', 'Cortebert', 'Republik Bern', 'Gobat', 'Ursanne', 'Cormoret', 'Benin', 'Ausser-Rhoden', 'felsberg', 'Pery', 'Davon', 'Jeder Gemeindsbezirk', 'Weingart', 'Münster', 'Bern Konolflngen', 'Jalirzelmt', 'Bren', 'Born Wyss', 'Alleinann', 'Gonzenbacti', 'Xeuen.stadt', 'Fssli', 'ivillier', 'Merzliycn', 'Epiquerez', 'Haller', 'LaHeutte', 'Fraubrunnen', 'Bern Haller', 'Tellen', 'Schaffhausen', '- velier', 'Trachsehvald', 'Heimatgc', 'Biet', 'Bern Stiimpfli', 'Hornung', 'Bernern', 'Berne Pour Direetion lInterieur Blteseh', 'Stmpfli', 'Saanen', 'dorBurgor', 'Chtillon', 'Biet Bözingen', 'Reiben', 'Hessen', 'Dorn', 'Goldschach', 'Vergl', 'Konolfingen', 'Ober-Simmental', 'Cliatelanat', 'Langlois', 'Diessbach', 'Emmental', 'Luzern', 'Allmend', 'Kanton Born', 'rosp', 'Gallen', 'Rtzer', 'Arineu', 'Stiimpfli', 'etc', 'Wald', 'Vlleber', 'Bern Wyss', 'Zürich', 'Miecourt', 'St-Iniier', 'Meinisberg', 'Bzingen', 'Bremgarten', 'Bernische', 'Burgdorf Langenthal', 'Ssetz', 'Lwenburg', 'Vieh', 'Nieder-Simmental', 'Mnster', 'Under', 'Wachsel', 'Corgemont', 'Total', 'Kiesen', '- wald', 'Sittengerichtes', 'Berne, SLOC', 'Armemvesens', 'Bevilard', 'Belp', 'Büren', 'Sorvilier', 'Lengnau', 'Oberaargaus', 'Tramelandessous', 'Kantons', 'Ursanne Epiquerez', 'Berne Redige', 'GrandvaljMalleray.Per', 'Ludwigsburg', 'Vingelz', 'Zollikofer', 'Sehwarzenburg', 'Sri', 'Obersimmental', 'Bhl', 'Seftigen', 'Xidau', 'OberSimmental', 'Bern Chr', 'Bern, ', 'Pieterlen', 'Diessbach Lengnau', 'Leipzig', 'Wyss', 'Meinisberg Pieterlen Reiben', 'Neuenbürg', 'Bern Stämpfli', 'Lierow'}",141
22598462,9640,"{'Erlach', 'Morgenthal', 'Bielersee', 'Bern', 'Aarberg'}",5,"{'Bern, SLOC', 'Großen Rathe', 'Aare', 'Aarberg Nidau', 'Mooses Obermoos', 'Mooses Uutermoos', 'Seelandes', 'Büren'}",8,"{'Nidau', '- see', 'Mooses', 'Uutermoos', '- burger', 'Msern', 'Obermoos', 'Bren', 'Bieler', 'Bern, '}",10,"{'Aare', 'Büren', '- see', 'Großen Rathe', 'Uutermoos', 'Bern, SLOC', 'Mooses', '- burger', 'Mooses Obermoos', 'Msern', 'Obermoos', 'Bieler', 'Bern, ', 'Nidau', 'Aarberg Nidau', 'Mooses Uutermoos', 'Seelandes', 'Bren'}",18
7646616,51164,"{'Zeughansgasse', 'Aarethal', 'Ostschweiz', 'Basel', 'Bern', 'Marktgasse'}",6,"{'Fr', 'Peseux', 'Israel', 'CasinoSaale', 'Zürich', 'WattenwylWild', 'Waisenhausgarten', 'Waisenhansplatze', 'Judengasse', 'Burgerspital', 'Schnlhans, SLOC', 'Haus Biet'}",12,"{'Schaffhausen', 'Boos', 'Aarau', 'Wintcrthnr', 'Zrich', 'Lerber', 'Bhme', 'Gallen', 'Huber', 'Bern, ', 'Plainpied'}",11,"{'Fr', 'Boos', 'Peseux', 'CasinoSaale', 'Zrich', 'Wintcrthnr', 'Bhme', 'Lerber', 'Zürich', 'WattenwylWild', 'Judengasse', 'Burgerspital', 'Huber', 'Bern, ', 'Schnlhans, SLOC', 'Schaffhausen', 'Israel', 'Aarau', 'Waisenhausgarten', 'Waisenhansplatze', 'Gallen', 'Plainpied', 'Haus Biet'}",23
7312808,22114,"{'Wallgasse', 'Bernerhof', 'Schwanengasse', 'Bundesgasse', 'Kirchenfeld', 'Monbijou', 'Quergasse', 'Gurtengasse', 'Italien', 'Christoffelgaffe', 'Bern', 'Wattemvyl'}",12,"{'Bundesgasse, SLOC', 'Fr', 'SchwanengasseWallgasse', 'Marzilithor', 'Salzmagazins', 'Bundesrathause', 'Salzmagazin', 'Bernerhos', 'Bernerhoses', 'Rothpinte', 'WäberSchmied', 'Gasse', 'Bärenhöfli', 'Dessen', 'Eckhaus', 'Snlzmagazins'}",16,"{'Schwaneugasse', 'Berns', 'Berns, ', 'Schwanen', 'Bnndesgasse', 'Zeughausgaffe', 'Gurteugassc', 'Ringmauer', 'Schwanengasse-Wallgasse', 'Aarberger', '- gasse', 'Speichergasse', 'Znselgasse', 'Bren', '-', 'Bernerhofgasse', 'Schauplatzgasse', '- thor'}",18,"{'Bundesgasse, SLOC', 'Fr', 'Zeughausgaffe', 'Rothpinte', 'Aarberger', 'Speichergasse', '-', 'Bernerhofgasse', 'Berns', 'Berns, ', 'Bundesrathause', 'Salzmagazin', 'WäberSchmied', 'Bärenhöfli', 'Znselgasse', 'Schauplatzgasse', 'Schwaneugasse', 'SchwanengasseWallgasse', 'Schwanen', 'Bnndesgasse', 'Marzilithor', 'Dessen', 'Eckhaus', 'Schwanengasse-Wallgasse', '- thor', 'Salzmagazins', 'Bernerhos', 'Gurteugassc', 'Bernerhoses', 'Gasse', 'Snlzmagazins', '- gasse', 'Ringmauer', 'Bren'}",34
12751751,26094,"{'Fr', 'Spitalgasse', 'Schweiz', 'Paris', 'Genf', 'Allmendingen', 'Thungschneit', 'Hohfluh', 'Egypten', 'Wabern', 'Herzogenbuchsee', 'Bern', 'Schachen'}",13,"{'Teufenbach Heinrichsbad', 'Eichberg Oberhofen', 'Bern, SLOC', 'Thun Heimberg', 'Münster', 'Dießbach', 'Cäsaropapismns', 'Gäßli', 'Wasen Chr', 'Aarwangen', 'Brünnen', 'Frutigen', 'Wengi Ried', 'Matte Bern', 'Burgdorf Bützberg', 'Haus Küpfer', 'Gondiswyl'}",17,"{'Diebach', 'Madiswyl', 'Btzberg', 'Leimen', 'Blumenstein', 'Pfr lOrsa', 'Bleiken', 'Uebertrag', 'Walliswyl', 'Muri', 'Sch', 'Gerzensee', 'Wattenwyl', 'Noflen', 'Gmliqen', 'Schwanden', 'Oberhofen', 'Quart', 'Hofstetten', 'Eggiwyl', 'Bmplitz', 'Kurzenberg', 'Heimenschwand', 'Huttwyl', 'Gwatt', 'Steffisburg', 'Tellen', 'Radelfingen', 'Trb', 'Lauterbrunnen', 'Schwarzenegg', 'Beatenberg', 'Roggwyl', 'Zziwyl', 'Oppligen', 'Jnnertkirchen', 'Brnnen', 'Wiedlisbach', 'Waldegg', 'Schweikhof', 'Heinrichsbad', 'Signau', 'Konolfingen', 'Schohalde', 'Wichtrach', 'Ostermundigen', 'Rapperswyl', 'Langenegg', 'Rthenbach', 'Burgdorf', 'Sulzmatt', 'Ltzelflh', 'Stettleu', 'Ried', 'Obernz', 'Ferrenberg', 'Schiipbach', 'Worb', 'Wyachengraben', 'Regsau', 'Gurzelen', 'Rohrbach', 'Belpberg', 'Kiesen', 'Niederhallwyl', 'Belp', 'Mengen', 'Radelsingen', 'Matten', 'Berns', 'Herolfiugen', 'Langeuthal', 'Brienz', 'Thun', 'Heimberg', 'Wengi', '- burg', 'Amsoldingen', 'Deutschland', 'Jgfr', 'Oberhnigen', 'Aeschlen', 'Wy', 'Bern, ', 'Pieterlen', 'Teufenbach', 'Homberg', 'Affoltern', 'Ruegiswyl', 'Meyringen', 'Wilderswyl', 'Eichberg', 'Schlowyl'}",93,"{'Wiedlisbach', 'Waldegg', 'Schweikhof', 'Eichberg Oberhofen', 'Heinrichsbad', 'Signau', 'Konolfingen', 'Diebach', 'Madiswyl', 'Schohalde', 'Wichtrach', 'Btzberg', 'Leimen', 'Burgdorf Bützberg', 'Blumenstein', 'Gondiswyl', 'Ostermundigen', 'Rapperswyl', 'Langenegg', 'Rthenbach', 'Burgdorf', 'Cäsaropapismns', 'Pfr lOrsa', 'Bleiken', 'Uebertrag', 'Walliswyl', 'Sulzmatt', 'Wasen Chr', 'Muri', 'Bern, SLOC', 'Sch', 'Gerzensee', 'Wattenwyl', 'Ltzelflh', 'Stettleu', 'Ried', 'Obernz', 'Noflen', 'Ferrenberg', 'Gmliqen', 'Schiipbach', 'Schwanden', 'Worb', 'Münster', 'Oberhofen', 'Wyachengraben', 'Regsau', 'Gurzelen', 'Frutigen', 'Quart', 'Hofstetten', 'Eggiwyl', 'Rohrbach', 'Teufenbach Heinrichsbad', 'Belpberg', 'Dießbach', 'Haus Küpfer', 'Wengi Ried', 'Bmplitz', 'Kurzenberg', 'Kiesen', 'Heimenschwand', 'Gwatt', 'Huttwyl', 'Thun Heimberg', 'Steffisburg', 'Aarwangen', 'Niederhallwyl', 'Belp', 'Mengen', 'Radelsingen', 'Matten', 'Berns', 'Tellen', 'Radelfingen', 'Herolfiugen', 'Trb', 'Langeuthal', 'Brienz', 'Thun', 'Heimberg', 'Wengi', 'Gäßli', '- burg', 'Amsoldingen', 'Deutschland', 'Lauterbrunnen', 'Jgfr', 'Oberhnigen', 'Aeschlen', 'Wy', 'Bern, ', 'Pieterlen', 'Schwarzenegg', 'Teufenbach', 'Beatenberg', 'Homberg', 'Affoltern', 'Roggwyl', 'Ruegiswyl', 'Meyringen', 'Wilderswyl', 'Eichberg', 'Zziwyl', 'Schlowyl', 'Oppligen', 'Brünnen', 'Jnnertkirchen', 'Brnnen', 'Matte Bern'}",110
22732218,63797,"{'Neuenburgersee', 'Moesa', 'Waadt', 'Aare', 'Brugg', 'Neuenburg', 'Aarberg', 'Poschiavino', 'Zihl', 'Toskana', 'Poschiavo', 'Scheuren', 'Solothurn', 'Cornaur', 'Bielersee', 'Suaillon', 'Tulla', 'Broye', 'Attisholz', 'Aarbcrg', 'Bachmatt', 'Rhein', 'Serchio', 'Rheins', 'Biclersee', 'Landeron', 'BLelersee', 'Bern', 'Rheincgg', 'Nidau', 'Ombrone', 'Chur', 'Lucca', 'Hagneck', 'Rheines', 'Neuchatel', 'Hagncck'}",37,"{'Bern, SLOC', 'Aarbergcrkanal', 'St Blaise', 'Arnäueliennerit', 'Lindau Rorschach', 'NidauBürenKanal', 'Zürich', 'NeuenburgerSee', 'Thal der Zihl', 'Murten', 'Felsufcr', 'Meyenried', 'Büren', 'BielerSee', 'Jura'}",15,"{'Rorschach', 'Blaise', 'Neuenburger-See', 'Escherkanals', 'Zrich', '- See', 'St. Blaise', '-', 'Solothurn-Vrcke', 'Mett', 'Murtcn-Sce', 'Tardisbrcke', 'Linthbettcs', 'St.', 'Nidau-Bren-Kanal', 'Moos', 'Mooses', 'Solothurn-Brcke', 'Nidaukanals', 'Aarbcrger-Kanals', 'Lan-eron', 'Graubndten', 'Bieler', 'Bern, ', 'St. Bern', 'Zihlbrcke', 'Lindau', 'Mooslandes', 'Emme', 'Aarbergerkanals', 'Bieler-See', 'Bren', 'Aare-Kanals', 'Pieterlenmoos'}",34,"{'Rorschach', 'Blaise', 'Escherkanals', 'Zrich', '- See', 'Murten', '-', 'Solothurn-Vrcke', 'Mett', 'Murtcn-Sce', 'NidauBürenKanal', 'Linthbettcs', 'Nidau-Bren-Kanal', 'Bern, SLOC', 'Mooses', 'Solothurn-Brcke', 'Zürich', 'NeuenburgerSee', 'Aarbcrger-Kanals', 'Felsufcr', 'Bieler', 'Meyenried', 'BielerSee', 'Zihlbrcke', 'Mooslandes', 'Bieler-See', 'Bren', 'Aare-Kanals', 'Neuenburger-See', 'St Blaise', 'Lindau Rorschach', 'St. Blaise', 'Büren', 'Aarbergcrkanal', 'Tardisbrcke', 'St.', 'Jura', 'Moos', 'Thal der Zihl', 'Nidaukanals', 'Lan-eron', 'Graubndten', 'Bern, ', 'St. Bern', 'Lindau', 'Arnäueliennerit', 'Emme', 'Aarbergerkanals', 'Pieterlenmoos'}",49
15170506,154921,"{'Nidau', 'Konolfingen', 'Porrentruy', 'Berne', 'Steffisburg', 'Aarberg'}",6,"{'Jurassiens', 'Fraubrunnen Frutigen Interlaken Laufon Laupen Moutier Kiesen', 'Bernois', 'Berne, SLOC', 'Interlaken', 'Blumenstein', 'Büren', 'Langenthal', 'Emmental', 'Delémont', 'Berne Bienne', 'Jura HauteArgovie', 'Borne Konolfingon Gessenay Signau Traeliselwald', 'Emmenthal', 'FOberland', 'Laupen', 'Hintersiissen', 'Franclies', 'Rogg', 'Bremgarten', 'Tel', 'Biiuerten', 'Blosch', 'Miécourt Damphreux Goldiwil Port Lôwenburg Grellingue StUrsanne Epiquerez', 'Appenzell Ext Thurgovie Neuchâtel Genève', 'Mittelland', 'Frutigen', 'Geiser', 'Zurich Lucerne Soleure ScliaH', 'Donné Berne'}",30,"{'Oberhasle', 'Signau', 'Bienno', 'Borrentmy', 'Bas-Simtnental', 'Traohselwald', 'Neuveville', 'Fraubrunnen', 'Tliouno', 'Neuvoville', 'Bas-Sim', 'Bertlioud', 'Scbwarzonbourg', 'Delmont', 'Bienne', 'Courtelary', 'Oourtelary', 'Schwarzenbourg', 'Gessenay', 'Langea', 'Wangon', 'Sumiswald, ', 'Bren', 'Berthoud'}",24,"{'Fraubrunnen Frutigen Interlaken Laufon Laupen Moutier Kiesen', 'Oberhasle', 'Signau', 'Bienno', 'Bas-Simtnental', 'Interlaken', 'Blumenstein', 'Emmental', 'Tliouno', 'Delémont', 'Berne Bienne', 'Emmenthal', 'Neuvoville', 'Scbwarzonbourg', 'Delmont', 'Franclies', 'Bremgarten', 'Oourtelary', 'Schwarzenbourg', 'Biiuerten', 'Blosch', 'Sumiswald, ', 'Appenzell Ext Thurgovie Neuchâtel Genève', 'Frutigen', 'Bren', 'Donné Berne', 'Jurassiens', 'Bernois', 'Borrentmy', 'Berne, SLOC', 'Traohselwald', 'Büren', 'Neuveville', 'Langenthal', 'Fraubrunnen', 'Jura HauteArgovie', 'Borne Konolfingon Gessenay Signau Traeliselwald', 'FOberland', 'Laupen', 'Bas-Sim', 'Bertlioud', 'Bienne', 'Hintersiissen', 'Rogg', 'Courtelary', 'Gessenay', 'Langea', 'Tel', 'Wangon', 'Miécourt Damphreux Goldiwil Port Lôwenburg Grellingue StUrsanne Epiquerez', 'Mittelland', 'Geiser', 'Zurich Lucerne Soleure ScliaH', 'Berthoud'}",54
23178549,139503,"{'Bielersees', 'Neuenburgersee', 'Tiber', 'Castiglione', 'Linth', 'Schweiz', 'Dozigen', 'Aare', 'Willihof', 'Murten', 'Mnrtensees', 'Jerisberg', 'Italien', 'Aarberg', 'Zihl', 'Steinbachs', 'Langensee', 'Nenenburgersee', 'Aar', 'Fawer', 'Aarburg', 'Solothurn', 'Wylero', 'Murtnersee', 'Nidan', 'Bielersee', 'Altreu', 'Oberaargau', 'Genfersee', 'Hageneck', 'Broye', 'Willphof', 'Attisholz', 'Piombino', 'Bielerssee', 'Thunersee', 'Chelmsford', 'Moos', 'Challandes', 'Nicca', 'Leng', 'Murgenthal', 'Grosetto', 'Bargen', 'Cote', 'Bern', 'Meyenried', 'Holland', 'Schmadernau', 'Nidau', 'Neuenburgcr', 'Ombrone', 'Emme', 'Aargau', 'Murtensees', 'Hagneck', 'Brienzersee', 'Lausanne', 'Saane', 'Bricnzcrsee', 'Buren', 'Murtensee'}",62,"{'Fr', 'Brügg', 'Bürglen', 'Gampelen Ins', 'Ufermauer', 'Cubikfnß', 'JohannesBrücke', 'Aare Aarberg', 'Lüßligen', 'Nidau Brügg', 'Büren', 'HageneckEinschnitt', 'Ulan', 'BLelerfee', 'Hienach', 'Aare Bern', 'Broyecanals', 'Broye Canal', 'Nicca AarbergHageneckCanal', 'Zihlbrücke', 'Mittelländischen Meere', 'NidauBürenCanal', 'Canalsectio', 'Dreisam', 'Aarbettes', 'BroyeCanals', 'Staad', 'BürenTozigen', 'Canal NidauBüren', 'Möser', 'Jnsoferne', 'BürenCanals', 'NidauAltreu', 'Zihl Büren', 'Wangen', 'Flußbettes', 'Aarhochwasser', 'OrbeMovses', 'Leitcaual MeyeuriedBüren', 'Solothurn, SLOC', 'BielNidauStraße', 'Pieterlenmoos', 'Nicca Dann', 'Rhone', 'Flußlanf', 'Biberenbachs', 'Solothurner Brücke', 'AarbergBürenCmral', 'Aarelauses', 'Broye Neuenburgersee', 'Orbe', 'AarbergHageneckCanal'}",52,"{'Prujelit', 'Bridel', '-', '- see', 'Sugy', 'Brglen', 'Biel-Nidau-Strae', 'Rappenfluh', 'Hgny', 'Colmata', 'Aarberg-Hagcneck-Canal', '- brcke', 'Mcca', 'Nid', 'Wyleroltigen', 'Wallensee', 'Ltaad', 'Aarberg-Hageneck-Cnal', 'Niederwasser', 'Nidau-Brcn-Caual', 'Bren-Solothurn', 'Canal', 'Mepenried', 'Gampelen', 'Bren', 'Seme', 'Meca', 'Nidau-Bren-Caual', 'Aarberg-Bren', 'Nidau-Altreu', 'Wyleroltigen-Aarberg', 'Brgg', 'Tulla', 'Brienzer', 'Kies', 'Hageneck-Canal', 'Torfes', 'Aarberg-Hageneck-Canal', 'don Altreu', 'Schlamm', 'Moosland', 'Zihl-Canal', 'Moos.', 'Suchard', 'Aen', 'Neuenstadt', 'Mooswiesen', 'Bbton', 'Kerzerz', 'Port', 'Schleusten', 'Molasse', 'Obern', 'Aarberg-Hageneck', 'Bodensee', 'Aarberg-Bren-Canal', 'Aarberg-Hcigeneck-Canal', 'Mur', 'Tunnels', 'Nieea', 'Arch', 'Brove', 'Meyeuried-Bren', 'Glimmen', 'Aarberg-Bren-Cmral', 'Devis', 'Nirca', '- ried', 'Mooses', 'Leuligen', 'Emmenufer', 'Safnerenfeld', 'Leuggenen-Bren', 'Orbe-Movses', 'Broye-Canal', 'Vierwaldstttersee', 'Arno', 'Meyen', 'Nidau-Bren', 'Torfmoos', 'Thuner-Seen', 'Murteusee', 'Emmenholz', 'Rappenflnh', 'Nidau-Bren-Canals', 'Torf', 'Nidau-Staad', 'Wiese', 'Schleussen', 'Thun', 'Nidau-See', 'Ehiaua', 'Sugiez', 'Berner', 'Nidau-Biiren-Canal', 'Grenchen-Staad', 'Solothurn-Attisholz', 'Bern, ', 'Nidau-Bren-Canal', 'Nidau-Pieterlen-Altreu-Canal', 'Brcke', 'Safnereir', 'Aargaues', '- tensee', 'Johannes-Brcke'}",105,"{'Prujelit', 'Bridel', '-', '- see', 'Sugy', 'Brglen', 'Biel-Nidau-Strae', 'Rappenfluh', 'Hgny', 'Zihlbrücke', 'Colmata', 'Aarberg-Hagcneck-Canal', '- brcke', 'Mittelländischen Meere', 'Mcca', 'Nid', 'Wyleroltigen', 'Wallensee', 'Ltaad', 'Aarbettes', 'BürenTozigen', 'Aarberg-Hageneck-Cnal', 'Niederwasser', 'Canal NidauBüren', 'Nidau-Brcn-Caual', 'Aarhochwasser', 'Bren-Solothurn', 'OrbeMovses', 'Leitcaual MeyeuriedBüren', 'Flußlanf', 'Mepenried', 'Gampelen', 'Canal', 'Bren', 'Seme', 'Meca', 'Fr', 'Brügg', 'Bürglen', 'Ufermauer', 'Nidau-Bren-Caual', 'Lüßligen', 'Aarberg-Bren', 'Nidau-Altreu', 'Wyleroltigen-Aarberg', 'HageneckEinschnitt', 'Brgg', 'Aare Bern', 'Tulla', 'Broyecanals', 'Brienzer', 'Kies', 'Broye Canal', 'Hageneck-Canal', 'Torfes', 'don Altreu', 'Schlamm', 'Aarberg-Hageneck-Canal', 'Moosland', 'Zihl-Canal', 'Moos.', 'Suchard', 'Aen', 'Neuenstadt', 'Staad', 'Möser', 'Jnsoferne', 'Mooswiesen', 'Zihl Büren', 'Wangen', 'Bbton', 'Kerzerz', 'Port', 'Schleusten', 'Molasse', 'Obern', 'AarbergBürenCmral', 'Aarelauses', 'Aarberg-Hageneck', 'Bodensee', 'Aarberg-Bren-Canal', 'Broye Neuenburgersee', 'Orbe', 'Aarberg-Hcigeneck-Canal', 'Cubikfnß', 'JohannesBrücke', 'Mur', 'Tunnels', 'BLelerfee', 'Nieea', 'Arch', 'Brove', 'Meyeuried-Bren', 'Glimmen', 'Aarberg-Bren-Cmral', 'Devis', 'Nirca', '- ried', 'Mooses', 'Leuligen', 'Canalsectio', 'Emmenufer', 'Dreisam', 'Safnerenfeld', 'Orbe-Movses', 'Leuggenen-Bren', 'BroyeCanals', 'BürenCanals', 'NidauAltreu', 'Broye-Canal', 'Pieterlenmoos', 'Vierwaldstttersee', 'Arno', 'Meyen', 'Nidau-Bren', 'Biberenbachs', 'Torfmoos', 'Thuner-Seen', 'Murteusee', 'Solothurner Brücke', 'Rappenflnh', 'Emmenholz', 'Nidau-Bren-Canals', 'Gampelen Ins', 'Aare Aarberg', 'Nidau Brügg', 'Torf', 'Büren', 'Nidau-Staad', 'Ulan', 'Wiese', 'Schleussen', 'Hienach', 'Thun', 'Nidau-See', 'Ehiaua', 'Nicca AarbergHageneckCanal', 'Sugiez', 'Berner', 'Nidau-Biiren-Canal', 'Grenchen-Staad', 'NidauBürenCanal', 'Solothurn-Attisholz', 'Bern, ', 'Nidau-Bren-Canal', 'Nidau-Pieterlen-Altreu-Canal', 'Brcke', 'Solothurn, SLOC', 'Flußbettes', 'BielNidauStraße', 'Safnereir', 'Nicca Dann', 'Rhone', 'Aargaues', '- tensee', 'Johannes-Brcke', 'AarbergHageneckCanal'}",157
21916127,86305,"{'Weidland', 'Schwabhorns', 'Gsteig', 'Jseltwald', 'Schweiz', 'Grimsel', 'Oberhasle', 'Wien', 'Bachalp', 'Faulhorn', 'Simelihorns', 'Tschingelfeld', 'Grindelwaldthale', 'Neuenburg', 'Hohmaad', 'Lauenbach', 'Tschingelfelde', 'Schaffhausen', 'Schwarzhorn', 'Reichenbachs', 'Rosenlaui', 'Kaltbach', 'Solothurn', 'Hinterburg', 'Thurgau', 'Brienz', 'GemSberg', 'Breithorn', 'Faulhorns', 'Grindelwald', 'Meiringen', 'Frankreich', 'Thunersee', 'EuropenS', 'SchwyZ', 'RotzbergS', 'Lauterbrunnen', 'Simelihorn', 'Langnau', 'Oltschenenalp', 'FaulhornS', 'Schwabhorn', 'Oberwald', 'Rheins', 'Bottenbalm', 'Europens', 'Schwyz', 'Bern', 'Sanetsch', 'DoldenhornS', 'Zseltwald', 'Gemmenalp', 'Tschingelhorn', 'Aargau', 'Winteregg', 'Alpen', 'Kaltenbach', 'Rhone', 'Brienzersee', 'Rawyl', 'Bottenalp', 'Brienzersees', 'Axalp', 'Bernhardsberges', 'Montblanc'}",65,"{'HaSlethale', 'Bußalp', 'TschingelhornS', 'Morgenroth', 'Murten', 'GrindelwaldScheideck', 'Krummbach', 'Donnerbühl', 'Ebendemselben', 'Wiesenthal', 'PilatuS', 'Schwab', 'Iseltwald', 'Büttlosa', 'SchwabhornS', 'Hohgant', 'Stockhorn Hohgant', 'Rothhorn', 'Bättenalp', 'Denr', 'Zugerberges', 'GspaltenhoruS', 'Hühnerthal', 'Roßalp', 'Breithorns', 'Ilrceolaria', 'Lütschinen', 'Lötsebthal', 'Gspaltenhorn', 'Simelihornö', 'Straßburg', 'Der Jungfrau', 'Morgenberges', 'Dürrenberg', 'SimelihornS', 'Nothhalden', 'Scheideck', 'WirthShause', 'Baumregion', 'Alpenhase', 'Flüh Entlibuch', 'Ombilicaria', 'DieGeognostik', 'Jntramen', 'Aletsch Horns', 'NordOst', 'Grandson', 'EngelbergerthaleS', 'Melchthalerberge', 'Kulms', 'Röthihorns', 'Schneelinie', 'RöthihornS', 'Diablerets Dicht', 'Wildhorns', 'Oircaes', 'Verstrum', 'CrispaltS', 'Bergthale', 'Grindelwaldgletschs', 'RothhornS', 'Hohen Stollen', 'Simelenwäng', 'Winterecke', 'Schwändi', 'Hasle', 'GießbachS', 'Ankenfol', 'Grindelwaldgletscher', 'Glütschhorn', 'Hohe Burg', 'BlümliSalp', 'Gansenfluh', 'Tiefenthal', 'Gebirgs', 'Rigi', 'Schwarzhörn', 'Rochel', 'Kienthal', 'Lpllobiuin', 'Hüttenboden', 'GießbacheS', 'HochBrisen', 'Mühlebach', 'Großhorns', 'BürgenftockS', 'Zürich', 'Roßberg', 'Mittelmeer', 'Lütschenthal Westlich', 'Faulhorn Kulm', 'Feldspath', 'Faulhornspitze', 'Grindelwaldkirche', 'Passes Jenseits', 'Stafels', 'Emmenthaler Berge', 'Faulhorn, SLOC', 'Grindelwald Thale', 'Vom Tschingelhorn', 'Schilthornö', 'AlpbiglengletscherS', 'Tschingelgrat', 'Wängcrnalp', 'Lütschinerrthaks', 'Thunersees', 'Frienisberghöhe', 'Wängernalp', 'Seefeldalpen', 'Hohganl', 'Röthi', 'BachalpSee', 'Hochalpen', 'Ebendemselben Weg', 'Den Bach', 'Kalkspath', 'Simeliwäng', 'Hühnerthälchenö', 'Scheidecke', 'Jura', 'ISraelS', 'Wergiöthal', 'Gold auSchuttes', 'Gießbach', 'Faulborn', 'Nitzli', 'Montana', 'Doldenhorn', 'SüdWest', 'Gießbachs', 'Alpthal', 'Brachmonai', 'MmGrsn', 'Venner Wendschatz', 'Habkerenthale', 'Glarnerpässe', 'Zugersee', 'Tschingel'}",138,"{'Faul', 'Zrich', 'Keller', 'Hhnerthal', 'Rthihorns', '- alp', 'Kalk', 'Walliser', 'Tannhorns', 'Daniel Wy', 'Rothhorns', 'Buchen', 'AlpbergS', 'Bach', 'TralleS', 'Nebo', 'Bachalphtten', 'Wngcrnalp', 'Grindelwald-Scheideck', 'Grindelwalds', 'Bttenalp', 'Bachalp-See', 'Hexensee', 'Straburg', 'Alpberg', 'Drrenberg', 'Wildgerst', 'Freiburgerbergen', 'Beaten berg', 'Alp', 'BlmliSalp', 'Ltschinen', 'Schwarzhorns', 'Scharnachthal', 'Bubenberg', 'Giebachufer', 'Erlach', 'Ltschenthal', 'Bttlosa', 'Eisfeld', 'Zhringen', 'HaSlethal', 'WalliSgrnze', 'Brien', 'Grimselhospiz', 'Giebach', 'Wngernalp', 'Helios', 'Rain', '/', 'Mhlebach', 'Ltsebthal', 'GiebacheS', 'Oldenhorn', 'Interlacken', 'Roalp', 'Wald', 'Grindelwaldthal', 'RthihornS', 'Bualp', '- zersee', '- land', 'Mhren', 'Bachalpsee', 'BerchtoldS', 'Duftbach', 'Drrenbergwald', '- horn', 'Sulegg', 'Nordoft', 'Greyerz', 'Murren', 'Grindelalp', 'Winkelmaadsbrcke', 'Mergelschiefer', 'Grin', 'Aurora', 'Koppen, ', 'Kulm', '- delwald-Eismeer', 'Nord-Ost', 'GiebachS', 'Giebachs'}",83,"{'HaSlethale', 'Faul', 'Bußalp', 'Zrich', 'TschingelhornS', 'Morgenroth', 'Keller', 'Murten', 'GrindelwaldScheideck', 'Krummbach', 'Hhnerthal', 'Donnerbühl', 'Ebendemselben', 'Wiesenthal', 'PilatuS', 'Giebachs', 'Schwab', 'Rthihorns', '- alp', 'Kalk', 'Iseltwald', 'Büttlosa', 'Walliser', 'SchwabhornS', 'Hohgant', 'Stockhorn Hohgant', 'Rothhorn', 'Tannhorns', 'Bättenalp', 'Denr', 'Zugerberges', 'Daniel Wy', 'Rothhorns', 'Buchen', 'GspaltenhoruS', 'AlpbergS', 'Hühnerthal', 'Bach', 'TralleS', 'Nebo', 'Bachalphtten', 'Wngcrnalp', 'Grindelwald-Scheideck', 'Grindelwalds', 'Roßalp', 'Bttenalp', 'Bachalp-See', 'Breithorns', 'Hexensee', 'Straburg', 'Ilrceolaria', 'Lütschinen', 'Alpberg', 'Drrenberg', 'Lötsebthal', 'Wildgerst', 'Freiburgerbergen', 'Gspaltenhorn', 'Beaten berg', 'Simelihornö', 'Straßburg', 'Der Jungfrau', 'Morgenberges', 'Dürrenberg', 'SimelihornS', 'Alp', 'Nothhalden', 'BlmliSalp', 'Ltschinen', 'Scheideck', 'WirthShause', 'Baumregion', 'Schwarzhorns', 'Scharnachthal', 'Bubenberg', 'Giebachufer', 'Alpenhase', 'Erlach', 'Flüh Entlibuch', 'Ombilicaria', 'DieGeognostik', 'Jntramen', 'Aletsch Horns', 'Ltschenthal', 'Bttlosa', 'Eisfeld', 'NordOst', 'Grandson', 'EngelbergerthaleS', 'Melchthalerberge', 'Wildhorns', 'Zhringen', 'Kulms', 'Röthihorns', 'Schneelinie', 'RöthihornS', 'Diablerets Dicht', 'HaSlethal', 'WalliSgrnze', 'Oircaes', 'Verstrum', 'Brien', 'Grimselhospiz', 'Giebach', 'CrispaltS', 'Bergthale', 'Grindelwaldgletschs', 'RothhornS', 'Hohen Stollen', 'Simelenwäng', 'Winterecke', 'Schwändi', 'Wngernalp', 'Hasle', 'Helios', 'GießbachS', 'Ankenfol', 'Grindelwaldgletscher', 'Rain', 'Glütschhorn', '/', 'Mhlebach', 'Hohe Burg', 'BlümliSalp', 'Gansenfluh', 'Ltsebthal', 'GiebacheS', 'Tiefenthal', 'Gebirgs', 'Rigi', 'Schwarzhörn', 'Rochel', 'Kienthal', 'Lpllobiuin', 'Oldenhorn', 'Interlacken', 'Hüttenboden', 'GießbacheS', 'Roalp', 'HochBrisen', 'Wald', 'Mühlebach', 'Grindelwaldthal', 'Großhorns', 'RthihornS', 'Zürich', 'BürgenftockS', 'Roßberg', 'Mittelmeer', 'Bualp', 'Lütschenthal Westlich', 'Faulhorn Kulm', 'Feldspath', 'Faulhornspitze', 'Grindelwaldkirche', 'Passes Jenseits', 'Stafels', '- zersee', '- land', 'Emmenthaler Berge', 'Mhren', 'Faulhorn, SLOC', 'Vom Tschingelhorn', 'Grindelwald Thale', 'Schilthornö', 'AlpbiglengletscherS', 'Tschingelgrat', 'Wängcrnalp', 'Lütschinerrthaks', 'Thunersees', 'Frienisberghöhe', 'Wängernalp', 'Seefeldalpen', 'Hohganl', 'Röthi', 'BachalpSee', 'Hochalpen', 'BerchtoldS', 'Duftbach', 'Ebendemselben Weg', 'Den Bach', 'Kalkspath', 'Simeliwäng', 'Hühnerthälchenö', 'Drrenbergwald', 'Scheidecke', '- horn', 'Sulegg', 'Jura', 'Nordoft', 'ISraelS', 'Wergiöthal', 'Gold auSchuttes', 'Greyerz', 'Gießbach', 'Faulborn', 'Nitzli', 'Montana', 'Murren', 'Grindelalp', 'Doldenhorn', 'SüdWest', 'Gießbachs', 'Winkelmaadsbrcke', 'Alpthal', 'Mergelschiefer', 'Grin', 'Aurora', 'Koppen, ', 'Kulm', 'Brachmonai', '- delwald-Eismeer', 'Nord-Ost', 'MmGrsn', 'Venner Wendschatz', 'Habkerenthale', 'Glarnerpässe', 'Zugersee', 'GiebachS', 'Bachalpsee', 'Tschingel'}",221
13193409,1424780,"{'Lhre', 'Leberberg', 'Augsburg', 'Twann', 'Konolsingen', 'Kyburg', 'Balm', 'Interlaken', 'Mueshasen', 'Reichsburg', 'Deeland', 'Stesfisburg', 'Altreu', 'Anshelm', 'Burgunds', 'Mattstetten', 'Lasel', 'Luternau', 'Schwarzenburg', 'Balnr', 'Frankreichs', 'Kirchberg', 'Uugerol', 'Schwanden', 'Leatenberg', 'Reutigen', 'Goslar', 'Gutesberg', 'Dtolmar', 'Kabsburg', 'Bellelap', 'Italien', 'Lhambern', 'Herzogenbuchsee', 'Gberhasli', 'Ronceval', 'Thnn', 'Willisau', 'Aerzogenbu', 'Radelfingen', 'Lurgdorf', 'Verona', 'Bubenberg', 'Erlach', 'Novarra', 'Englisberg', 'Eallnach', 'Rodt', 'Savopen', 'Sygriswil', 'Dremgarten', 'Tellenburg', 'Neuenstadt', 'Genfersees', 'Durgerrstein', 'Zlarberg', 'Gberhofen', 'Aagaz', 'Roggwyl', 'Burg', 'Schafshausen', 'Tromwpl', 'Gber', 'Blanlrenburg', 'Brakau', 'Roggwpl', 'vercelli', 'Gltigen', 'IVaadtlandes', 'Wedischwpl', 'Sreiburgs', 'Kappel', 'Konolfingen', 'Sternenberg', 'Grafenried', 'Lricdcn', 'Uyburg', 'Ivangen', 'Moosseedorf', 'Allmend', 'Sempachersees', 'Lindenach', 'Oberland', 'Langnail', 'Emmenthale', 'Icinanden', 'Venedig', 'Reichenbach', 'Monolfingen', 'Kpburg', 'Dieszbach', 'Grasivvl', 'Okastilien', 'Uri', 'Spiezberg', 'Monolsingen', 'Lmme', 'Scheunenberg', 'Warl', 'Lramburg', 'Aareusers', 'Lrankreich', 'Dornach', 'Gberaargau', 'Lenzburg', 'Aubonne', 'Ivorb', 'Luchsee', 'Vern', 'Allmendland', 'Helsenburg', 'Lirchdors', 'Gelbach', 'Thunersees', 'Inkwpl', 'Herzwitz', 'Pensa', 'Europas', 'Regensburg', 'Spiez', 'Sarns', 'Jura', 'Asfoltern', 'Grindelwald', 'Thunstetten', 'Simmenthals', 'Greyerz', 'Burgunden', 'Limmat', 'Kappelen', 'Mlchgasse', 'Meienried', 'Gltingen', 'Ravensburg', 'Gisenstein', 'Deutschlands', 'Srienisberg', 'Dicsbach', 'Seedors', 'Bechburg', 'Montenach', 'Belpberges', 'Romainmotiers', 'Bicki', 'Sigriswpl', 'Huttwpl', 'Aargaues', 'Mmuchthal', 'Schwarzcnburg', 'Krauchthal', 'Tvaadt', 'Gberburg', 'Altenberg', 'Srei', 'Mumenthal', 'Tompostella', 'Lerchtolds', 'IVimmis', 'Niederbipp', 'Vurgdorf', 'Mailands', 'Zollikofenfi', 'Gerbern', 'Frankfurt', 'Alemannien', 'Breisach', 'Aarburg', 'Mrchlindach', 'Gurzclen', 'Zofingen', 'Malmaison', 'Zrieirisberg', 'Schwendi', 'INuri', 'Gutenburg', 'Europa', 'Muri', 'Gerzensee', 'Andlau', 'Wartini', 'Lanpen', 'Lrau', 'Murgenthal', 'Schweden', 'Utzenstorf', 'Obcr', 'Zolli', 'Lchallens', 'Lmmenthal', 'Lausanne', 'Cnglisberg', 'Brod', 'Anatomicgasse', 'Ursenbach', 'Geristein', 'Zosingen', 'Schangnau', 'Ringgenberg', 'Trachselwald', 'Schwarzwaldes', 'Paris', 'schweiz', 'Baden', 'Gchsenbein', 'Thurgau', 'Kirchdorf', 'Scharnachthal', 'Thorberg', 'Aigle', 'Mailand', 'kyburg', 'Wunsingen', 'Bernern', 'Zimmerwald', 'Lriswpl', 'Vernein', 'Hnlterfingen', 'Novara', 'Saanen', 'Lrientsberg', 'Buchegg', 'Marziliweg', 'Aargau', 'Ainggolhwil', 'Tschachtlan', 'Trimstein', 'Stratzburg', 'Nidouwe', 'Dreiburg', 'Seeland', 'Glten', 'Meinis', 'Meicnburg', 'Mannenberg', 'Luntenthurm', 'Signau', 'Goldswpl', 'Hettiswyl', 'Neuenegg', 'Iferten', 'Savoyen', 'Brodschaal', 'Zwieselberg', 'Sursee', 'Lreiburg', 'Burgdorf', 'Brandis', 'Frankreich', 'Oberrheins', 'Lrlinsburg', 'Italiens', 'Eichwald', 'Gelnhausen', 'Grindel', 'Srieswyl', 'Durheim', 'Bremgarten', 'Schadau', 'Buszen', 'Liebenau', 'Kriegstetten', 'Kerzers', 'Alpen', 'Lpnunger', 'Mcienburg', 'Goldiwpl', 'Tessenberg', 'Lindenthal', 'Palermo', 'Saluzzo', 'Bremgartenwald', 'Belp', 'Aarberg', 'bern', 'Warktgasse', 'Langenthal', 'Mederwpl', 'Brienz', 'Oesterreich', 'Lelvetiens', 'Mestschweiz', 'Sreiburg', 'Ensisheim', 'pavia', 'Thunersee', 'Papenheim', 'Rhein', 'Zlltenberg', 'Rheins', 'INoosseedorf', 'Kerrenried', 'Aachen', 'Pieterlen', 'Niedersimmenthal', 'Ivaadt', 'Bonstetten', 'Ueberlingen', 'Lerna', 'Brienzersees', 'Saane', 'Brenzikofen', 'Eairo', 'Uiedersibenthal', 'Spaniens', 'Murten', 'Irem', 'Blumenstein', 'Sraubruuneir', 'Aargaus', 'Gottstatt', 'Buchsgau', 'Ungarn', 'Bremen', 'Jagdburg', 'Mainz', 'Bisthum', 'Schwarzwasser', 'Meienburg', 'Limpach', 'Beatenbcrg', 'Crlach', 'Lothringen', 'Seeberg', 'Utzistorf', 'Lrienisberg', 'Illisivyl', 'Diesbach', 'Iseltivald', 'Rufshusen', 'Erlinsburg', 'Dleienbach', 'Ulaikirch', 'Schweiz', 'Crlinsburg', 'Zeughausgasse', 'Ober', 'Ilrsenbach', 'Reigoldswpl', 'Dielst', 'Selm', 'Altenburg', 'Gbersimmenthal', 'Erlenbach', 'Eriz', 'Srienis', 'Srankreichs', 'Rothenfluh', 'Wynau', 'Mons', 'Heidelberg', 'Berchtoldshos', 'Laupen', '5ternenberg', 'Savoyens', 'Kreuzgasse', 'Konstanz', 'Nomberg', 'Delsberg', 'Lauterbrunnen', 'Hreiburg', 'Buchsee', 'Burgund', 'Gberhosen', 'Luzcrn', 'Holland', 'Miedlisbach', 'Ulm', 'Greverz', 'Zollikosen', 'Tentenberg', 'Jerusalem', 'Breisgau', 'INeiringen', 'Barcelona', 'Tschenbach', 'Mrnenried', 'Emmenthals', 'Wedischwyl', 'Mellingen', 'Sels', 'Gbcrhaslc', 'Sizilien', 'Pampeluna', 'Moossecdorf', 'Lrciburg', 'Luzern', 'Schwaben', 'Stuttgart', 'Sumiswald', 'Meder', 'Rarberg', 'Melchnau', 'Bipp', 'Jucharte', 'Sriesenberg', 'Dentenberg', 'Icgistorf', 'Grinnnenstein', 'Burgdorsl', 'Biel', 'Srankfurt', 'Ivwzogenbuchsec', 'Stephanstage', 'Schwadernau', 'Bargeu', 'Niederschwaben', 'Solothurir', 'Grimmenstein', 'Genf', 'RottweilI', 'Ivnnigen', 'Ileuenburg', 'Grasburg', 'Sumis', 'Bargen', 'Luineilsivalt', 'Alemanniens', 'Dattenried', 'Leatenberges', 'Burgdors', 'Solothnrn', 'Nyon', 'Screnbalmst', 'Reichenau', 'Zollikofen', 'Michtrach', 'IVaadt', 'Bernfl', 'Thurnen', 'Marktgasse', 'Srutigen', 'Aar', 'Berns', 'Oberbalm', 'Spitzenberg', 'Rohr', 'Langcnthal', 'Zlrch', 'Schivarzenlnirg', 'Lchenkenberg', 'Amsoldingen', 'Sriedrichs', 'Uttingen', 'Maikirch', 'Burgistein', 'Basel', 'Iselgau', 'Avignon', 'Sigrisnnst', 'Eisenach', 'Bleichenbach', 'Murtenh', 'Lindau', 'Eambray', 'Grenehen', 'Kramgasse', 'Affoltern', 'Aarau', 'Velp', 'Durgdorf', 'Buren', 'Srciburg', 'Oberburg', 'Oesterreichs', 'INettenwpl', 'Gsteig', 'Ziohrbach', 'Brugg', 'Zwingclhofc', 'Beru', 'Sempacher', 'Licocca', 'Thuirstetten', 'frankreich', 'Tsehenbach', 'Lohwpl', 'Rcichsburg', 'Teuffelen', 'IVattenwyl', 'Znlg', 'Lannwpl', 'Ltrafzberg', 'Srankreich', 'Grenchen', 'Langnau', 'Luchsgau', 'Sulgenbach', 'Neapel', 'Givatt', 'Landshut', 'Balmegg', 'Reutigcn', 'Suiniswald', 'Genua', 'Oberhofen', 'Interlalren', 'Bucheggbergs', 'Stettlen', 'Delp', 'Morges', 'Schwsp', 'Rapperswpl', 'Egcrten', 'Kaufbeuren', 'Steffisburg', 'Kienholz', 'Westschweiz', 'Neuenburg', 'Linisterra', 'Rom', 'Schaffhausen', 'Crsigen', 'Jegistorf', 'Lauperswyl', 'Nieder', 'Straszburg', 'Thurwalden', 'Brittnau', 'Grandson', 'Thierstein', 'Sternerrberg', 'Nantes', 'Bern', 'Hrienisberg', 'Aeschi', 'Uordwesten', 'Laubegg', 'Wangen', 'Beatenberg', 'Tmme', 'Sraukreichs', 'Twing', 'England', 'Hornbach', 'Riggisberg', 'Schlipsen', 'Lolothurn', 'Blankenburg', 'Aare', 'Unterseen', 'Donstanz', 'Gempenach', 'Guggisberg', 'Reichenaul', 'Hagenau', 'Solothurn', 'Trogen', 'Haslelandes', 'Slumenthal', 'Bielersee', 'Greperz', 'Rougemont', 'Lndlisberg', 'Mrchberg', 'Lrlach', 'Dchntz', 'Lpburg', 'Toulouse', 'Ivaldshut', 'Lrei', 'Rjicggisberg', 'Nidau', 'Nverdon', 'Lern', 'Lombardei', 'Radolfszell', 'Mdau', 'Luchegg', 'Lpsach', 'Ligerz', 'IVattenwpl', 'Rottweil', 'Allensbach', 'Jagberg', 'Aarwangen', 'Lnternan', 'Suinenswalt', 'Ueuenstadt', 'Ulontenach', 'Rottzehnt', 'Thun', 'Labsburg', 'Liel', 'Heimberg', 'Ivaadtland', 'Deutschland', 'Ueuenburg', 'Hasli', 'Seftigen', 'Gbergerbern', 'Langenstein', 'Weiszenburg', 'Lolzwpl', 'Icharnachthal', 'Wallis', 'Nasleberg', 'Wauzwpl'}",597,"{'Bern Unterseen Gberhofen', 'Metzgerkapelle', 'Erguel', 'Hainen', 'Miner', 'Lauterbrunnenthale', 'lOkerlauel', 'Lornm', 'Ivinkelmanns', 'Illiswpl Seeivpl Miggiswpl', 'Zihl', 'Lmminghaus', 'Röthenbach', 'Sriedensidee', 'Stubengeselle', 'Elsaß', 'Dstnastie', 'DerSchultheiß', 'Burgdorf Thun Obersibenthal', 'Sründ', 'Dürrenroth', 'Schloß Brücke', 'Köuiz', 'Stadtz Augsburg', 'Deutschordenshauses', 'bernischen Landen', 'Spinnstube Burgerspital', 'Strättligen Senn', 'IValliser Bergen', 'INünsterthal', 'Srauen', 'St Katharina', 'Lerncrhofc', 'Susz', 'Gallon tschachtlan Eschi', 'Dürrcnroth', 'MederIVangen', 'Dtopist', 'Armengut', 'Rümligen', 'Gampelen', 'Crblandc Aargau', 'Oberlandes', 'Lllerbach', 'Mich Bätterkinden', 'kirN', 'Bipp Wiedlisbach', 'rhein', 'Tontrccscarpe', 'Interlachen', 'Lrwcrbs', 'Sraucnkloster Tedlingcn', 'Stadtalmosen', 'Scucrstein', 'Almosners', 'Irnigi', 'Vüttcnberg', 'Lans Srairz llägeli', 'Trachselwald OberEmmenthal', 'Dotalicien', 'Bern Sryheiten', 'zürn', 'Sigismunds', 'Meißenburg', 'Grimmenstcin', 'Biet', 'Ripailles', 'Innerschweiz', 'Veril', 'Lriswvl', 'Justingerchronik', 'Mühledorf', 'Gimmelwald Murren Lauterbrunnen Trachscllaucnen Sichellauenen', 'Saar', 'Zurzach', 'Nothwehr', 'Lch', 'Uttigen', 'Lattringen', 'Äumenthal', 'Alterthum', 'Beruh', 'Bcrnerschcn', 'Tggholzes', 'Trnbertal Gninnren', 'Berner Archiv', 'Gümmenen', 'Keimberg Langenegg', 'Rüeggisberg Amsoldingen', 'Lucbsi', 'Münstcrthal', 'Burgund Bremgarten', 'Schissleuteu', 'Longue', 'Ritzenbach', 'Ivaffenhandwerk', 'Gurizcllon', 'Uutz', 'Ritterschlages Jerusalem', 'Kaiserlose', 'Verfass', 'Urtenen', 'Hist Ilelv', 'Büttillon', 'Hier Rathe', 'Rohleder', 'Dießenberg', 'IVohnung', 'Muri Stettlen Vechigen', 'Nürnberg', 'Istarls', 'Wurstcnbergcrthnrm', 'Venedig Rom', 'Raron', 'Ichdeckbrücke', 'Thierachern Bluinenstein Gurzelen Kirchdorf', 'Müllenberg', 'Rüegsbach', 'Bolligen', 'Zähringcn', 'Sreiherrschast Mamburg', 'Ltadtbach', 'Gümmcnen', 'Liinpach', 'INühlcberg', 'Irnperii', 'Solz', 'Neuß', 'Laßb', 'Stäffis', 'LenziVerschwörung', 'Unspunnen Gberhofen', 'Ulünze', 'Mittellöwcn', 'Miaut', 'Holz Dremgarten', 'Zürich', 'Mühlethal', 'Biglen', 'Rüeggisbcrg', 'Lantzlep', 'Düren', 'Stistsschaffners Düntz', 'Masli', 'AllerseelenLaplanei', 'Dominikanerkirche', 'Isaus', 'Mülhusen', 'Loh', 'Dtönigsfelden', 'Vechi', 'Oominns', 'Ulülinon', 'Oberlande', 'Marseille', 'Grünenberg', 'Mir Luch', 'Iserrenschwand', 'Leißigen', 'Mühlethurnen', 'Gutsindeu', 'Bern Äktavband', 'Rütschi', 'Lschenbach', 'Schönenwerdt', 'Grbe Grandson', 'Lilage', 'Vogt Laupen', 'Nontes', 'Schoren', 'Lötn', 'Schcrzligen', 'Möschberg', 'Belpp Lelp Dorfs', 'Ried Lnglisberg Rümmligen lllünsigen Almedingen', 'Buchsee München', 'Graswpl', 'Gießbach', 'kirchl', 'Hünenberg', 'Rathsmanualcu', 'Gösgen', 'Isauptstadt', '129s', 'Aüeggisberg', 'Rodt Ltadtgeschichte', 'Balligen', 'Dohna', 'Zähringen', 'Bntzwpl', 'Sanitätsrath', 'Lrbfürstenthum', 'Schongouw', 'Büetigen', 'Thonon Ternier Gex', 'Rother Löwen', 'Villmergen', 'Zürichkrieges', 'Kriegstetteu Subingen', 'Lurkart', 'Vedrängniß', 'Haus Buchsee', 'Burgcrnaincn', 'Mittelland', 'Linzclstellilng', 'Stubenzins', 'Llure', 'Liaufakt', 'Dönilzberg', 'IVeißenburg', 'GberBlatkron', 'bieoburgensiz', 'Bartholomäus', 'OberWorben', 'Slüe', 'Bärengraben', 'Haus Haus', 'Rathhaus', 'Balm Südabhang', 'Räthe Bern', 'Entlebuch', 'Edelknechts', 'Großen Rathe', 'Bönigen', 'Zeitglockenthurm', 'St Petersinsel', 'Meinen Rath', 'Saane Gurbrü', 'Stalden', 'Schultheiß', 'Schwanau', 'Nied', 'Rottwyl', 'Brieffs', 'Aargau Bern', 'Köln', 'Rathsmanual', 'Schloß Simmenegg', 'Böspfennig', 'Buchen', 'Alchistors', 'Graubünden', 'Biberschi', 'Längenbühl', 'Bärn', 'Dkei', 'Bonn Rhein', 'Grüsisbergwald', 'München', 'Schulrath', 'Iveißenau', 'Inuocentium', 'Mährend', 'Iriedeus', 'Schsenbein', 'lmcvon', 'Burgerthums', 'Interlaben', 'ZSö Nantes Alb', 'MuenburgMdau', 'Schanz', 'Christosfclvorwerk', 'Brienzersee Ringgenberg Mederried', 'Gertzense', 'Räthe', 'Ligerz Tivann Diilz Ivalpers', 'Gbertosfen IDinzcnriede', 'Lraubrunnen', 'Seeberg Inkwpl', 'Rüblimahles', 'Ncuenstadt', 'Boresto', 'Saanelandcs', 'Oberhasli Aarberg', 'Lützelflüh', 'Gbergerbcrnhauses', 'Aütschelen', 'Twingherrenstreites', 'Römer', 'Ivei', 'Bern Burglehen', 'Neuburg Elsaß', 'Lriswnl', 'Appellationskammer', 'Lern Bern', 'Bellevue', 'Höricourt', 'Lyonft', 'Riggisberg Spiez', 'Bern ZOO', 'Bern Line', 'Ulühlenen', 'Lamilien', 'Böniz', 'St Jakob', 'Ilürenberg ZOO', 'Sigris', 'Lalschmünzerei', 'Ölten', 'Signau Spiez', 'Srutingen', 'Rüegsau', 'Mrzogenbuchsee', 'ecclesiu', 'Breitenrain', 'Aargaus Ulacht', 'Karthause', 'Lombarden', 'Hessen', 'Dünn Dkoune Zir', 'INühlenen Reichenbach', 'Lischofsstnhl', 'Den Bernern', 'Rathsgliederu', 'Iveißenburg', 'Amerten', 'Schloß Oberhofen', 'Meinen Rathes', 'Schweizerisches Museum', 'Spiez Gbcrhofen', 'Otenr', 'Rath Bern', 'Ziis', 'Maadt Unterthan', 'Gerbcrn', 'Lötschen Planalp', 'Mßlingschen Lause', 'MeinGnmmenen', 'Mlcheri Langnouw', 'Rüeggisberg Srienisberg Interlaken', 'Aeschlen AuszerBirrmoos Barschwand', 'Lern Lde', 'aargau', 'Sriedens', 'Km4 Ponies', 'Uötken', 'Meritgasse', 'Srevelsachen', 'Sulensee Honrich', 'Reichsland', 'Reichsboden', 'Rothe Buch', 'Mrch', 'Lüren', 'Aothschild', 'Schafshauscn', 'Dupilero', 'GolattcnmattgaszthorthurnV', 'Sach Heutigen', 'UUirteii', 'Weißenau', 'Niesten', 'Grasburg Gltingcn', 'Uutkerum', 'Veste Laupen', 'Bern SLettler', 'Der Schultheiß', 'St Andrestag', 'Wildegg', 'Verburgrechtete', 'Laane', 'Biberen Jerenbalm', 'Diemtigen', 'Visthum', 'IVeißenau', 'Lüttich', 'Asse', 'Lhafte', 'Teitiilgen', 'Burgistein Münsingen', 'Gaupp puA', 'Twingen', 'Ielmkleinods', 'Gbergerbernhaus', 'Assen', 'Ziehende', 'Mten', 'Mrchhören', 'Isswpl', 'LünevillerSrieden', 'Thcatcrplatz', 'Bellmnnd', 'koutcs', 'Mennorialia', 'Burgdorf Line', 'Hofstatt', 'Almosenkammer', 'Berken Inkwifl', 'Jougne', 'Märitgasse', 'Nüeggisperg', 'Merth', 'Bern Stürler', 'Ursenbach Rohrbach', 'Rustwald', 'Lmmen', 'Lngi', 'Rothes Buch', 'Lipp Ain', 'Hoch', 'Vonteb Voutes', 'Bielersewc', '4röniz', 'Burglehen', 'Rath Distelzwang', 'Niederlande', 'Mittclgcrbern', 'GesterreichSavoyen', 'Gberlande', 'Bern Burgdorf', 'Rüegsau Rüegsbach', 'UuK', 'Bilcheri', 'Reichsthal', 'Rüdlen', 'Heiligen Bethlehem', 'Sebruar', 'Christofscl', 'Moster Twing', 'Limpach Rütti Leilzigen', 'Suellcn', 'Deutschen Orden', 'Gairzeir', 'UeuenburgMdau', 'Därstetten', 'Vberbürron', 'Nöthe Buch', 'Nöthe Buch Jahre', 'Illitbnrgcr', 'Kiburgers', 'Lchnciderhand', 'Burgdorf Amtsbuch', 'Isropie', 'Rathhausplah', 'Thal Ari', 'Bernern Unterthan', 'buchsee', 'Inierlaken', 'Aathsbeschluß', 'Münsingen', 'Olilcheri', 'Wartenstein', 'Schloß Montenach', 'Sans Sranz llägeli', 'Ikts Bern', 'Rütti', 'Lern Land VIII', 'Brechtseher guldin Dis', 'Illai', 'Dießbach', 'Schlettstadt', 'Gbergisenstein', 'Schloß Thun', 'Schoßhalde', 'Durgcrnziels', 'Gotteshause', 'Gesellschastshauses', 'Kramgasse Schattseite', 'IVädiswpl', 'Laubegg Blankcnburg', 'Münchenbuchsee', 'Mergentheim', 'Bumplilz', 'Längenberge', 'Amsoldingen Saanen', 'St Gttmarstag', 'Württembergs', 'Tübingen', 'Mrche', 'wyler Kaufdorf', 'Lauffer Nathsmanual', 'Die Gbergerber', 'Eellerarius', 'Kohlerthurm', 'Uuwenegg', 'Rathsmannal', 'Biberstein iZlargau', 'Thürme', 'Bern Aarberg', 'Twing Lotzwpl', 'Büttikon', 'Rütte', 'Mähren', 'Großburg', 'Diesbachs', 'Cmmenthal', 'Heisterbach', 'Mittellöwen', 'Speltcil', 'Uebrigens', 'Rothe Luch', 'Üantone', 'Dtaufsgegeustandes', 'Röthcnbach', 'Aohrberg Gberaargau', 'Oberkomman', 'Bern Basel', 'LiZiNo', 'Sagade', 'Königshause', 'Landshut Jegistors', 'Lütschenthal', 'Sause Buchsee', 'Straß', 'Aeffligenz', 'StefsisburgDorf', 'Schwerte', 'Thurm Montenach', 'Thonon', 'Roßmarkt', 'Tmmeii', 'Samilien', 'Aare Aare', 'Solothurn Ulurten', 'bipp', 'Ranslüh', 'Müliuen', 'Limpach Emmen', 'P3A', 'Strätlingen', 'IVeißenan', 'Lalmegg', 'Haus Büren', 'Dchivarzeiiburg', 'Rhodanische Republik', 'Rümlingen', 'Nürnberg Goslar', 'Irrthum', 'Aathes', 'Güm', 'Grundcigcnthum', 'bernisät', 'Schscnbein', 'Göttingen', 'Iilterlakeil', 'Weißenburg', 'Dtoppingen', 'Gonzenbach', 'Bern Murten', 'Anerris', 'Rüderswnl', 'Rathsherren', 'IZZl', 'Stammburg', 'Grüsisberg', 'Cäsarius', 'Moster Interlaken', 'Bahnhofplatz', 'Hauskaus', 'Büttenberg', 'Büren', 'Oermunos', 'St Latten', 'Radolfzeller', 'Naisersberg Diolmar', 'Münsterthalcs', 'Aubonnc', 'Lontessio', 'IlordJuvopen', 'St Johannsen', 'LGhves', 'Documenta', 'Haus Spiez', 'Saurilie', 'UicderRuntigcn', 'Utzigen', 'Crlach Mdau', 'Umschlin', 'Lommis', 'Vogt Wangen', 'Rath', 'Riggisberg Zimmerivald Velp', 'Xnmm', 'Bümpliz', 'Brunnadcrn', 'Ringgenberc', 'Theaterplah', 'INittelschweiz', 'Aarberg Bern', 'ZOO', 'Mülhausen', 'NonteZ', 'Dpnastenhause', 'Rüeggisberg', 'Ivir Schultheiß Rhät', 'Iveges', 'Klus', 'Landwirthschast', 'Donuerbühl', 'Tosten', 'Landshut Langenthal Laufen Laupcn Madiswyl Melchnau Mühleberg Münsingcn Münster Muri Ileuenstadt Mdau Medersimmenthal Gberhofen Gbersimmenthal Gltingen Petersinsel', 'Ivatteuwpl', 'Dchüpfen', 'Diallnach', 'Zetinbucb', 'Röche', 'Miegsrath', 'Zravaverit', 'Cosfres, SLOC', 'Unterthanenland', 'Bibereir DtleinGümmenen', 'wcicycm', 'Bern Illeisterz', 'St Bern', 'Stadtkirche', 'Sinai', 'Ivattenwpl', 'Rothes Luch', 'Zell', 'Köniz', 'RinggenbergBrienz', 'Bühberg', 'Layade', 'Thun Wimmis', 'Isesse', 'Erlach Biel', 'Ausburger Ulan', 'Meißcnburg', 'Lreiherrn Usingen', 'Küngin', 'Elisried', 'Haus Nöniz', 'Lrsigen', 'Gberwichtrach', 'Sestigen', 'Rabat', 'Stettlers', 'Ordenshause Ulünchen', 'Diel Bern', 'Vinelz Sinsterhennen Tschugg Teuffelen Gerolsingen Hagneck', 'Münster', 'Montfaucon', 'kirchberg Kirchl', 'Rumisberg Sarneren', 'Kappelen Vargeir Kallirach Diselen Teusfelen', 'Berns Aargau', 'Üilcheri Sygriswil', 'Sumiswald Dürrenroth', 'Samtlie', 'kabsburg', 'Spätlingen', 'Straßburg', 'Aathe', 'Meinem Rath', 'Höchstetten', 'Kriegsraths', 'Sumiswald Trachsclwald', 'Zürichgau', 'Mittelmeeres', 'Schwarzenburg Grasburg', 'Stattweibel', 'Längenberg Kühlewyl', 'Dnrg Geristein', 'Dynast Burglehen', 'Wülinen', 'Ie', 'Sürglen', 'Bern Lehen', 'Ivattenwyl', 'Seclsorge', 'Saaneslusses', 'Köniz Gberbalm llerlenegg', 'Oiireuzgaffe', 'Almosens', 'wolhusen', 'Lern OLLcium', 'Bündmß Gümminen', 'Iran', 'Uoah', 'Irüsisberps', 'Lataloxue', 'St Gallen', 'Rath ZOO', 'Saanelandes', 'Ligerl', 'Grünenbcrg', 'Dosten', 'Bern Fontes', 'Bucheggbergcs', 'Twing und Bann', 'Meinen Gnedigen', 'Museum Bern', 'Kloster Gott', 'Npdeck', 'Wedischwist', 'Adelboden', 'St Urban', 'Delpberge', 'Interlacensi', 'Dotzigen', 'Spiez Lehen', 'Lcherzlingen', 'Helvetischen Republik', 'Sekrctsiegcl', 'XVI Jahrhunderts Line', 'Deutschordenshause Bern', 'Okaufleutengesellschaft', 'Iteimber', 'Stettlerst Line', 'Aarberg Lpß Zlsfoltern Ivengi Rapperswpl Degistorf lllünchenbuchsee Vreingarten Kirchlindach', 'TschachtlanDittlingerchronik', 'Doubs', 'Mannlchen', 'Ivegmühle', 'Lausanner Bischofsstuhlcs', 'Kapaunen', 'GrdensEomthur', 'Königsfelden', 'Plappart', 'Gberhofen Balm', 'Rathes', 'Rödel', 'Gerlafingen Ipsach', 'Längenbergc', 'Tennenbach', 'Thürings', 'Watteuwyl', 'Lrcitagsschanzc', 'llpon', 'Aarelauf', 'Joh Bubenberg', 'Illit', 'KleinBurgund', 'Drandunglüek', 'Meiligen', 'Mühleberg', 'Rath Zülse', 'Köniz Bern', '2ligle', 'Lern Michtland', 'Ittigen', 'Gümminen', 'BoUigcn', 'Isasli', 'Ulan', 'Münsterbau', 'Baar', 'Mlcheri iMtorffingerr', 'Ilothdurft', 'Aar Urk', 'Bath', 'Ltrauchthal Ivallrringen Linlpach', 'Diönigthums', 'Buchsee 2Z0 Zlrt Juicungue', 'Straßberg', 'Rus', 'Mrcheusatz', 'Lnglisberg Lehrsatz Belp', 'Zlbdruck', 'Rath Alles', 'Ohmgeldkammer', 'Thurn iserrn', 'Sankt Gallen', 'Oeeolumpuäii', 'Alb', 'Bätterkinden', 'Rodt Stadt', 'städtischen Republik', 'Wimmis', 'Gülten', 'Oberländer', 'Großen Rath', 'Thüringen'}",763,"{'Ulatthi', 'Weienau', 'Lotzwnl', 'Seeivpl', 'Schnegg', 'Drugg', 'Kolmar', 'senbrggen', 'Ehillon', 'Mlhausen', 'Venneren', 'Diebach', 'Muraltbecher', 'Swartzcnburg', 'Madiswyl', 'Bttenberg', 'Sulz', 'Aarthal', 'Sesch', 'Graben', 'Atschelen', '- kosen', 'Deedorf', 'Ivalpers', 'Oberivyl', 'Markt', 'Mnsterthal', 'Bern.1ZZ', 'Schande', 'Seyst', 'Mnchen', 'Ganting', 'Dult', 'Lauterburg', 'IVerdenbcrg', 'Aarbcrg', 'Sier', 'Gsenbrggen', 'Rderswpl', 'Nelvr', 'ststburg', 'lllhleberg', 'Mschberg', 'Johannes', 'Planalp', 'Ilrenberg', 'Strtlingen', 'Inkwnl', 'pillichody', 'Lressoney', 'Bsrnensis', 'Landerswpl', 'Goildiswi', 'Lngenbergc', 'Reggisberg', '- menthal', 'Ueuenburg-Mdau', 'Wncheubuchsce', 'Petersinsel', 'Mnchenwpler', 'Gttingen', 'Vlittwoch', 'Strabcrg', 'Rpchisperg', 'St. Urban', 'Uwenstadt', 'Llumet', 'Stefanstag', 'Lptingen', 'Instinger', 'SLettler', 'St. Stephan', 'Hager', 'Reich', 'Irciburg', 'Lilie', 'Thunfelde', 'Eirrzelne', 'Bluinenstein', 'Sreiburgcr', 'Selhosen', 'Matthi', 'Wien', 'Graswyl', 'Tillier', 'Leintz', 'Uleinisberg', 'Mlhusen', 'Cndlisberg', 'Schrder', 'Lngenbhl', 'Rdlen', 'Grndson', 'Berncrn', 'Werdenberg', 'Ober-Worben', 'Mull', 'Lastelen', 'Aelen', 'Loos', 'Wattenwvl', 'Kpburgs', 'Truberthal', 'Bael', 'Schafhusen', 'Gwing', 'Ireiburg', 'Liicn', 'Wattenmyl', 'Savop', 'Houorius', 'Gberivil', 'Ltschenthal', 'Simmenegg', 'Elsa', 'Aegsau', 'Ostern', 'Matile', 'Wrttembergs', 'Bickigen', 'Stcttlen', 'Mlincn', 'Buwile', 'Ulllcr', 'Bttillon', 'Horden', 'Lonstors', 'Vivis', 'Marswyl', 'Tessin', 'Sim', 'Tscherlitz', 'Altishofen', 'INlinen', 'Reiben', 'Licilicn', 'Sees', 'Alpenrosen', 'Seitenthals', 'Tivelle', 'Mller', 'Sacconay', 'Iveienburg', 'Ikolmar', '- bipp', 'Schenkenberg', 'lochberg', 'Bueh', '- diswpl', 'Clsa', 'Bubenberge', 'Lentulus', 'Nugerol', 'Lands', 'Rtti', 'Mn', 'Lerner', 'iKnmenhauscn', 'Sriswpl', 'Maggcnberg', 'Verburg', 'BelpI', 'Lhristof', 'Rthenbach', '- harduskapelle', 'Trubschachen', 'Mittellwen', 'Zwingelhof', 'Schribrnritz', 'Schr-tz', 'pohannscn', 'Teusfelen', 'Roll', 'Gallen', 'Ilord-Juvopen', 'Lyburg', 'Stefsisberg', 'Gltingcn', 'Regsbach', 'Lchburg', 'Mlerzins', 'lten', 'Schuottwpl', 'Rtte', 'Ivabern', 'Amsoldingcn', 'Ivippingen', 'Segesser', 'Trachselivald', 'Duwpl', 'Ivinterswpl', 'Uchon', 'Thrru', 'Iviedlisbach', 'Breiburg', 'Srciburgs', 'Aon', 'Sustingcn', 'Rud Steck', 'Knitz', 'Muenburg-Mdau', 'IVeienburg', 'Messen', 'Lreisgau', 'Opelingen', 'Habsburg', 'Baselstab', 'Mnster', 'Grsisberg', 'Biberach', 'Vren', 'Griers', 'Monstanz', 'ldabsburg', 'Tavel', 'llrscnbach', 'Blwgund', 'Muralt', 'Ivegmhle', 'Sries', 'Wickartswpl', 'Laus', 'Grdl', 'Christoph', 'Lckemunden', 'Lebr', 'Allshelm', 'Zrichkrieg', 'Wmtersnwl', 'Grafenricd', 'Golattenmattgasse', 'Tegertsche', 'Allinend', 'Bnigen', 'Fontes', 'Rud', 'Liebcnau', 'Eggiwnl', 'Guntram', 'Kranchthal', '/ ade', 'Uhenstorf', 'Gberwangen', 'Thlln', 'tsomberg', 'Zlrberg', 'Undersewen', 'Mhlethurnen', 'ramburg', 'Graffenried', 'Morgarten', 'Buetingen', 'Berners', 'Dunrad', 'Zhringcn', 'wisnau', 'St. Peter', 'Vttcnberg', 'Gber-Blatkron', 'Bittwpl', 'Pellmunt', 'Spbold', 'Urach', 'Hricourt', 'iZlargau', 'Gbcrhofen', 'Lrlach Aarberg', 'Kerrinanil', 'Aiggisberg', 'Lorst', 'Altgerbern', 'Gerberngraben', 'Lasli', 'Osterdienstag', 'Ddingen', 'Lipp', 'Ulorges', 'Brodschal', 'IslO', 'Diokletian', 'Sirium', 'Deitingenst', 'Kelergasse', 'Whren', 'Neuen', 'Strttlingen', 'Scftingen', 'Rtsch', 'Nidegger', 'IVerdt', 'Maiche', 'Schlipfen', 'Vinzenzen-Mnsters', 'IVpttenbach', 'Tdingcn', 'Drrenroth', 'Goslewil', 'kuttwyl', 'Rodeln', 'waitz', 'Bleien', 'Innocenz', 'Lnglisberg', 'Grpund', 'Laupersivpl', 'Thrings', 'Bcx', 'Gurbr', 'Berqq', 'Rderswnl', 'Durrocbm', 'Kallirach', 'Mhleberg', 'NNnterstetten', 'Stern enberg', 'Mlchberg', 'Tittlingerr', '^', 'Teuffelcn', 'Lren', 'Lom', 'Maslithal', 'Sets', 'Stettlcr', 'Ilsen', 'Schnenwerdt', 'Schwarzcnegg', 'Sricnisberg', 'Mlchdorf', 'Lohnn', 'witeubach', 'Cngi', 'Jggi', 'Tivann', 'Stanthart', 'Mchurg', 'Stefsisburg-Dorf', 'Gkt', 'Diilz', 'Bamberg', '- kirchberg', 'Hagneck', 'Josua', 'St. Trachselwald', 'Dicocca', '- Fontes', 'Bren', 'Brre', 'Mhldors', 'reiburg', 'Tedlingcn', 'Trlach', 'vilmergen', 'Illarktgasse', 'Stadnz', 'Ulutterstadt', 'Speier', 'Hcimberg', 'Udelbuch', 'Oebien', 'Berncr', 'lllarignano', 'Golaten', 'lvalendorf', 'Thierstcin', 'Distelzwan', 'Baselwind', 'Sannen', 'Straberg', 'Ipsach', 'Aegcrtengasse', 'Gegau', 'Allod', 'Judica', 'Maadt', 'Tscharner', 'Lilcia', 'Lauterbrunnenthals', 'Durghut', 'Hilterfingcn', 'Bernensis', 'Sroburg', 'Illlinen', 'Peter Bielersee', 'Lykurg', 'Trb', 'Bernthaler', 'Ucucnstadt', 'Auszer-Birrmoos', 'Stffis', 'Oberlands', 'Uetendorff', 'Sraubrunne', 'Lraueutag', 'Srobnrg', 'Vuchegg', 'llcucnburg', 'Serren', 'Dtnigshofen', 'Lalkcngarten', '- singenst', 'Lotz', 'Stein', 'Allmendingen', 'Twingherrenstreit', 'Sleisch', 'Diel', 'Rmlingen', 'Kieronymus', 'Losenegger', 'Tschugg', 'Lrgg', 'Sraubrunnen', 'Bernbatzen', 'Irischherz', 'Sferten', 'Theobald', 'Uiederulmiz', 'Ascensio', 'Seuer', 'Lriswyl', 'Iliemand', 'Lobsigen', 'Ulrich', 'Degistorf', 'Gyps', 'pannonien', 'Nlous', 'Burgdarf', 'Sarneren', 'Schnppisen', 'Luno', 'Gberwrff', 'Lumiswald', 'Brienzwvlcr', 'Gm', 'Gerolsingen', 'piemont', 'Dez', 'Aechberg', 'Ltrauchthal', 'Zwiselberg', 'Nieder-Oenz Rthenbach', 'Lngenberg', 'Nienberg', 'Rcgcnsburg', 'Herzwyl', 'Vul-e-Ku', 'Lorn', 'Dntz', 'Bernse', 'Fyburg', 'Langhans', 'Grnenberg', 'Tannerrbuel', 'Gptingen', 'Ueuenegg', 'Niederwpl', 'St. Petersinsel', 'Medergerbcrn', 'Slumenthal Balm Gnsberg', 'labsburg', 'Grneberg', 'Bietzivil', 'Aheinfelden', 'Ulark', 'Ka', 'Uordschwaben', 'Nancy', 'Ober-Emmenthal', 'Ponies', 'uenegg', 'Uicder-Runtigcn', 'Ileuenstadt', 'Rmligen', 'Thun Fontes', 'Lahors', 'INutach', 'Drln', 'Slumet', 'Kaufdorf', '- Limpach', 'IVeiszenburg', 'Gravenriet', 'Schwarzen', 'Gurzelen', 'INnsterthal', 'IVallisgebirge', 'Keimberg', 'Ursach', 'Liern', 'IVestschweiz', 'Lmpliz', 'Ilnspunnen', 'Ueu', 'Nota', 'Ivinterthur', 'Sankt', 'IVpler', 'Brandts', 'Lhalchegg', 'Donuerbhl', 'Lllenwvl', 'Stra', 'Gmmenen', 'Ulargaretha', 'Liinppach', 'Meszort', 'Kancy', 'IVissenburg', 'Blocken', 'Mnchen-Buchsi', 'Ulhlenen', 'Grnenbcrg', '- wpl', 'Mamburg', 'Zrinach', 'Illoudon', 'Ulmpelgard', 'Sicglcr', 'Mnchenstein', 'Gugspurger', 'Rougeinont', 'Iliaurice', 'Bhberg', 'Vuchsee', 'Friedrichs', 'Rdel', 'Amsoltingen', 'Zrei', 'Mattenwyl', '- burg', 'Stadtrodel', 'Lriz', 'Drstetten', 'Luzcru', 'IValdsttten', 'Gberwpl', 'Dietrich', 'Albligen', 'Srnd', 'ldusz', 'Bann', 'Bern xag', 'Zhringcrn', 'Lutstorf', 'Subingen', 'lvolfgaug', 'Graubnden', 'Ladenzins', 'Nikodep', 'Ita', 'Inkwifl', '- und Meder-IVangen', 'Saanenks', 'Tbingen', 'Rthcnbach', 'Reu', 'Pfenningen', 'Kram', 'St. Bern', 'IDalpurg', 'Sterchi', 'Risold', 'Balthasar', 'Ullibach', 'Riedburg', 'Trinrstein', 'Milden', 'Aarestadt', 'IDuralt', 'Stadtz', 'Nrnberg', 'Bernbuch', 'Lonstetten', 'Palm-Montag', 'Neueu', 'Tarascona', 'Walliswpl', 'Jegistors', 'Obergerbern', 'Ilpon', 'Sieronymus', 'Sreibnrg', 'lvaadt', 'Arles', 'Lenk', 'Nicr', 'Lremgarten', 'llov', 'Lbeck', 'Litzi', 'Hettiswpl', 'Inrhof', 'Instingers', '- aargau', 'Cggiwyl', 'Verbrg', '-', 'Lvian', 'Loosschstem', 'Mcinisberg', 'Lasarraz', 'Drniz', 'Ris', 'Lienhardt', 'Sstcrn', 'Archiv', 'lvengen', 'Romarkt', 'Lreibnrg', 'Sptcz', 'Richenbach', 'DraubriNiiien', 'St. Gttmarstag', 'Kvburg', '- gen', 'Miggiswpl', 'Lallwyl', 'Burkhard', 'Rarem', 'Linaben', 'Gericourt', 'Scedorf', 'Selsenburg', 'Dieenhofen', 'Ittlingen', 'Laufen', 'Bernst', 'Zchilling', 'Burgen', 'Blankcnburg', 'Smmerthal', 'ileuenstadt', 'lvorb', 'Ulzenstorf', 'lllnchenbuchsee', 'Geristcin', 'itpser', 'Lchnenberg', 'Mnz', 'kmbsburgs', 'Stubenrodel', 'Straburg', 'Tedlingen', 'lvpler', 'Lreuzgasse', 'Bonn', 'Leerenschwand', '- gau', 'llidau', 'IVasser', 'Brron', 'Spins', 'Lerbort', 'Hericourt', 'Anshelms', 'Lchbnrg', 'Lrlachs', 'Uerno', 'Voutes', 'Gbernz Rthenbach', 'Mhledorf', 'chsee', 'Bayern', 'trw', 'Michtland', 'Mnstcrthal', '- burgergeld', 'Nerno', 'chstctten', '- berg', 'Twiirg', 'Uilterseen', 'Bmpliz', 'St.', 'Ionqnire', 'Sritzenbach', 'Batzen', 'Kln', 'Karins', '- burg-Kpburg', 'Morms', 'Fipburg', 'Mhlethal', 'Sptlingen', 'Iranqne', '- simmenthal', 'Aarbergergassc, ', 'Genos', 'Grtschwaben', 'Zselgau', 'Ulmiz', 'Usfern', 'Npdau', 'Mllen', 'Eronica', 'Ueuen', 'lleuenburg', 'Tofsen', 'Steiger', 'Zhringen', 'Lern xag', 'Lhalons', 'Oculi', '- sing', 'Grncnberg', 'bubenberg', 'Llankenburg', 'Bilrgdorf', 'Ulontsalvens', 'Vigneulle', 'Osten', 'Tedliirgen', 'Schongouws', 'IVieg', 'Eotzingen', 'Walde', 'Mauchthal', 'Lttich', 'Neu-Bubenberg', 'Ivattenwil', 'Switz', 'Ulurten', 'Luxemburg', 'Dies', 'Wiedlisbach', 'Nrn', 'Aderswpl', 'labs', 'Efslingen', 'Pfauen', 'bkpburg', 'Win', 'Tvattenwyl', 'Bernerlandes', 'IVdiswpl', 'Ausburger', 'Konolstngen', 'isolawegen', 'Drandunglek', 'absburg', 'Aarethals', 'Iverdon', 'Hallwpl', 'Aarwangcn', 'Sachseten', 'Obersibenthal', 'Gstern', 'Gber-Arnlingen', 'Vevep', 'swartzenburgs', 'Gberhasle', 'Harnasch', 'Zischcnzen', 'Langenegg', 'Ks', 'Ostermontag', 'Mnsingen', 'Madiswpl', 'Kienthal', 'Riggis', 'Lrauenkappelen', 'Lngenberge', 'Linlpach', 'Dchpfen', 'Sense', 'Uider-Amlingen', 'Brenigartenwald', 'Gals', 'Hraubrunnen', 'altschnnd', 'Hmmer', 'Pest', 'Habstetten', '- ried', 'Ltzelflh', 'voralpen', 'kpburg', 'Delsbcrg', 'Ulnchen', 'Dtnigsfelden', 'Medersimmenthal', 'Johannsen', 'IVilheln', 'labkcrn', 'ivartenstein', 'Wittigkowen', 'Khn', 'umenthal', '- mnsters', 'Kirchlindach', 'Sept', 'Venedigs', 'Lause', 'Lggiwpl', 'Srankreichft', 'Slse', 'Lang', 'Dren', 'Ulerich', 'Audolss', 'Sstcrmontag', 'Zosingeu', 'Regsau', 'Niedergerbern', 'Rohrbach', 'Kiburg', 'Ullinen', 'Kalis', 'Marzielistra', 'Trutzbudnitz', 'Ufs', 'Savopens', 'INontmajor', 'Bucheggberg', 'Alchistorf', 'Diolmar', 'Bclp', 'Okauf', 'Horgenwpl', 'Lrlenbach', 'Lliburg', 'Steck', '4-rniz', 'Dicmtigen', 'Aath', 'Ivattcnwyl', 'Kpburger', 'Martini', 'IValter', 'Neuenburg-Uidau', 'Naisersberg', 'Sraubrunneu', '- bach', 'Lipburg', 'Neggisperg', 'Thune', 'Oron', 'Dtettlen', 'Nidan', 'Illiswpl', 'Tiving', 'Berken', 'Sqvopen', 'Dipp', 'Kantons', '- dingen', 'Obcrbipp', 'Marsili', 'Straberg-Bren', 'Ivedischwpl', 'Br', 'Jenff', 'Grassenried', 'St. vinzcnzenmnsters', 'Iveienau', 'Wattenwile', 'Bnchsee', 'Berner', 'Lid', 'Eppern', 'Stessisburg-Thuu', 'Berchtolds', 'Oster-Illontag', 'Bniz', 'St. Berchtenstag', 'Dieenberg', 'St. vinzenzenstists', 'Mritgasse', 'lvvnau', 'Urchenbrunnen', 'Heimiswpl', 'Troppau', 'Brn', 'Oitpburg', 'Klein-Burgund', 'Junghcrr', 'burg', 'IVangeu', 'Burgdorfertrrieg', 'Simmenthal', 'Neu', 'Sranksurt', 'Sberburg', 'lliederbipp', 'Kabs', 'Reggisbcrg', 'Ivestschweiz', 'Stadtbach', '- gasse', 'Rcggisberg', 'Leinzmanntz', 'INhlcberg', 'IVierezwyl', 'Gon', 'Rabs', 'Dtienberg', 'Sreitag', 'Zrich', 'Burgdorff', 'Serenberg', 'Vinelz', 'Zlttiswpl', 'Aom', 'Sreudenreich', 'Wlinen', 'Turin', 'Anshclm', 'Upon', 'Matzenried', '- menen', 'Rovcrea', 'Margr', 'Ssp', 'Meisterz', 'Inner-Birrmoos', 'RtschelenI', 'Thu', 'Thrurstetten', 'Sreibcrgen', 'Lupiru', 'Stefensburg', 'Isaall', 'ousfdors', 'Uiklaus', 'Savopcn', 'Berntz', 'Kpbnrgs', 'Zosingen-Stift', 'Wattenwyl', 'Srcibnrg', 'Derns', 'Derno', 'Leilzigen', 'Dantes', 'Lonbach', 'Dietersivpl', 'Ltadtrod', 'Weienburg', 'Avenches', 'Burgernziel', 'Uloudon', 'IValendors', 'Webern', 'Berlin', 'Illnsingen', 'Betigen', '- mendingen', 'Jalathurn', 'Srienisbcrg', 'Ringgenberg-Brienz', 'Word', 'Palmmontag', 'Hrau', 'Lotzwpl', 'Barschwand', 'Harnischschau', 'Uidau', 'Sibenthal', '- hnigen', 'Kuiz', 'Zeerleder', 'Ivallis', 'Kniz', 'Sszeli', 'Ufels', 'Baumgarten', 'Illainz', 'Waadt', 'Gerechtigkeitsgasse', 'Illeisterz', 'Lnzi', 'Sechier', 'Mardern', 'Liram', 'Luzernbuch', 'Luntziker', 'Nainen', 'Zrichgau', 'Kien', 'Tellen', 'Vreingarten', 'Peter', 'perrod', 'Niedcrsimmenthal', 'Nicdergerbern', 'Athenbach', 'Alpweiden', 'Trachsclwald', 'Diopien', 'Npon', 'Seedorf', 'Interlakcn', 'Sarb', 'Gberbren', 'Lallwpl', 'Schauplatzgasse', 'Jakobi', 'Tribolet', 'Xnello', 'Amsol', 'Lipp wiedlisbach', 'Gloggen', 'Bernds', '- stellau', 'Romainmotier', 'Domo dGssola', 'Scherzligen', 'Lireuzgasse', 'Ifwist', 'Neubau', 'Biberstein', 'Ircibergen', 'Liebcwpl', '- kofen', 'Giebach', 'llladiswpl', 'Shnenberg', 'Uloutenach', 'Glepres', 'Dubenberg', 'Schlo', 'Ivediswpl', 'Kpfer', 'Mlitrrrndorr', 'St. Jakob', 'Ltn', 'Blcienbach', 'Lerber', 'Berne', 'Mnsingcn', 'Mflmrg', 'Dieterswpl', 'Attiswpl', 'Vrunnadern', 'Gmminen', 'Thal', 'Gchs', 'Neuencgg', 'Irallbrunnen', 'Aoggwpl', 'Mlinen', '- buchsee', 'Trsigen', 'Glungenbrunuen', 'Cgerdon', 'Aargan', 'Mnchenbuchsee', 'Ivinngen', 'Ringoldingen', 'Srankrcichs', 'lvillading', 'Groszhchstetten', 'Wattenwpl', 'lvolfisberg', 'Meder-Emmenthal', 'Mlchturndon', 'Schanguau', 'Serrn', 'lviedlis', 'Mattenwpl', 'Dippsach', 'Lursee', 'Tmmenthales', 'llikadan', 'Gaupp', 'vergl Fontes', 'Mein-Burgund', 'Ried', 'Kanton', 'Tavcl', 'Oechsli', 'Mscmiu', 'Rche', 'Mslin', 'Sac', 'St. Leonhard', 'Gesterreich-Savoyen', 'Diselen', 'Ldcl', 'cimberg', 'Neuburg', 'Krtegstetten', 'wanchdors', 'Mnsterthalcs', 'Mclchnau', 'Irag', 'Dampfwpl', 'Viterbo', 'IVeienau', 'Delpberges Fontes', 'Bonmont', 'IVanner', 'Lerzogenbuchsee', 'Solothuru', 'IVinterthur', 'Aittingen', 'Ironien', 'Knuchel', 'Eschen', 'Mhren', 'Dipburg', 'St. Georgentag', 'Dabp', 'Trachsel', 'Lapeten', 'Wpl', 'Diezbach', 'Osilir', 'Dyburg', 'Wisnowe', 'IVangen', 'Habs', 'wolsgang', 'Matten', 'Thdingen', 'Lniz', 'Vordcrrvil', 'Ulonteuach', 'Kestenholz', 'trlin', 'Michaelis', 'Aohrberg', 'Dnrheim', 'Rumisberg', 'tipburg', 'Stetler', 'Vadian', 'Tschiffeli', '- Lmminghaus', 'Schirmbries', 'Ivan', 'Unterwaldcn', 'Ueucnburg', 'Vogt', 'Lonstorff', '- burgcr', 'Inkwyl', 'Speichingen', 'lluwenburg', 'Knigsfelden', 'Gron', 'Ringgcnberg', 'ivarzivald', 'Laupcn', 'VIeinisberg', 'St. Johannsen', 'Mannenbcrg', 'Baggwpl', 'lveienburg', 'St. Gallen', 'Brcke', 'lvattenwyl', 'Leipzig', 'Vinzenzen', 'Schl', 'kuenz', 'Rubigen', 'lliedcrbipp', 'Obcrhofen', 'Dnilzberg', 'Thring', 'Murzelen', 'Sorst'}",1165,"{'Bern Unterseen Gberhofen', 'Erguel', 'Lotzwnl', 'Schnegg', 'Drugg', 'Kolmar', 'Diebach', 'Miner', 'Madiswyl', 'Sulz', 'Lornm', 'Aarthal', 'Illiswpl Seeivpl Miggiswpl', 'Zihl', 'Lmminghaus', 'Röthenbach', 'Graben', 'Atschelen', 'Stubengeselle', 'Elsaß', 'Markt', 'Dstnastie', 'Dürrenroth', 'Mnchen', 'Deutschordenshauses', 'Dult', 'IVerdenbcrg', 'Aarbcrg', 'lllhleberg', 'Planalp', 'Ilrenberg', 'Bsrnensis', 'IValliser Bergen', 'INünsterthal', 'Landerswpl', 'Goildiswi', 'Lerncrhofc', 'Susz', 'Lngenbergc', 'Reggisberg', '- menthal', 'Ueuenburg-Mdau', 'Wncheubuchsce', 'Dürrcnroth', 'Vlittwoch', 'Rpchisperg', 'St. Urban', 'Rümligen', 'Gampelen', 'Lptingen', 'Lllerbach', 'Lilie', 'Thunfelde', 'Bluinenstein', 'Sreiburgcr', 'Selhosen', 'Matthi', 'Bipp Wiedlisbach', 'Wien', 'Tontrccscarpe', 'Tillier', 'Lrwcrbs', 'Leintz', 'Stadtalmosen', 'Scucrstein', 'Schrder', 'Lngenbhl', 'Grndson', 'Irnigi', 'Trachselwald OberEmmenthal', 'Dotalicien', 'Bern Sryheiten', 'Werdenberg', 'Ober-Worben', 'Mull', 'Lastelen', 'Meißenburg', 'Loos', 'Wattenwvl', 'Kpburgs', 'Truberthal', 'Biet', 'Ripailles', 'Ireiburg', 'Innerschweiz', 'Veril', 'Wattenmyl', 'Houorius', 'Gimmelwald Murren Lauterbrunnen Trachscllaucnen Sichellauenen', 'Gberivil', 'Elsa', 'Nothwehr', 'Lch', 'Matile', 'Lattringen', 'Alterthum', 'Bickigen', 'Beruh', 'Trnbertal Gninnren', 'Mlincn', 'Keimberg Langenegg', 'Gümmenen', 'Lucbsi', 'Bttillon', 'Horden', 'Vivis', 'Schissleuteu', 'Tessin', 'Sim', 'Tscherlitz', 'Altishofen', 'INlinen', 'Sees', 'Tivelle', 'Kaiserlose', 'Iveienburg', 'Ikolmar', '- bipp', 'Schenkenberg', 'lochberg', 'Urtenen', 'Hist Ilelv', 'Büttillon', 'Hier Rathe', 'Bueh', 'IVohnung', 'Muri Stettlen Vechigen', 'Lentulus', 'Lands', 'Mn', 'Sriswpl', 'Thierachern Bluinenstein Gurzelen Kirchdorf', 'Verburg', 'BelpI', 'Bolligen', 'Zähringcn', 'Trubschachen', 'Mittellwen', 'Sreiherrschast Mamburg', 'Teusfelen', 'Roll', 'Liinpach', 'INühlcberg', 'Solz', 'Ilord-Juvopen', 'Irnperii', 'Stefsisberg', 'Stäffis', 'lten', 'LenziVerschwörung', 'Unspunnen Gberhofen', 'Ulünze', 'Rtte', 'Mittellöwcn', 'Ivabern', 'Miaut', 'Mühlethal', 'Trachselivald', 'Duwpl', 'Uchon', 'Rüeggisbcrg', 'Aon', 'Sustingcn', 'Stistsschaffners Düntz', 'AllerseelenLaplanei', 'IVeienburg', 'Messen', 'Lreisgau', 'Opelingen', 'Mnster', 'Griers', 'Monstanz', 'Vechi', 'Oominns', 'Ivegmhle', 'Ulülinon', 'Oberlande', 'Laus', 'Mir Luch', 'Allshelm', 'Grafenricd', 'Mühlethurnen', 'Allinend', 'Rütschi', 'Bern Äktavband', 'Bnigen', 'Rud', 'Lschenbach', 'Schönenwerdt', 'Lilage', 'Liebcnau', 'Eggiwnl', 'Kranchthal', '/ ade', 'Thlln', 'Belpp Lelp Dorfs', 'Möschberg', 'Zlrberg', 'Undersewen', 'Buchsee München', 'Graswpl', 'Vinelz Sinsterhennen Tschugg Teuffelen Gerolsingen Hagneck', 'ramburg', 'Hünenberg', 'Rathsmanualcu', 'Isauptstadt', 'Morgarten', 'Aüeggisberg', 'Rodt Ltadtgeschichte', 'Berners', 'Dunrad', 'Zhringcn', 'Vttcnberg', 'Gber-Blatkron', 'Balligen', 'Pellmunt', 'Dohna', 'Urach', 'Bntzwpl', 'Hricourt', 'Sanitätsrath', 'Gbcrhofen', 'Büetigen', 'Rother Löwen', 'Villmergen', 'Lorst', 'Kriegstetteu Subingen', 'Zürichkrieges', 'Vedrängniß', 'Burgcrnaincn', 'Linzclstellilng', 'Lasli', 'Osterdienstag', 'Ddingen', 'Lipp', 'Llure', 'Liaufakt', 'IVeißenburg', 'Brodschal', 'Diokletian', 'Deitingenst', 'GberBlatkron', 'bieoburgensiz', 'Kelergasse', 'Bartholomäus', 'OberWorben', 'Slüe', 'Scftingen', 'Rtsch', 'Nidegger', 'Räthe Bern', 'Maiche', 'Schlipfen', 'Edelknechts', 'IVpttenbach', 'Großen Rathe', 'Tdingcn', 'Rodeln', 'Innocenz', 'Lnglisberg', 'Grpund', 'Meinen Rath', 'Saane Gurbrü', 'Laupersivpl', 'Stalden', 'Thrings', 'Schultheiß', 'Schwanau', 'Rderswnl', 'Durrocbm', 'Kallirach', 'Mhleberg', 'Rottwyl', 'Brieffs', 'Stern enberg', 'Mlchberg', 'Tittlingerr', 'Rathsmanual', '^', 'Teuffelcn', 'Lom', 'Maslithal', 'Buchen', 'Ilsen', 'Alchistors', 'Sricnisberg', 'Lohnn', 'Cngi', 'Jggi', 'Mchurg', 'Stefsisburg-Dorf', 'Dkei', '- kirchberg', 'Grüsisbergwald', 'München', 'Josua', 'Iveißenau', '- Fontes', 'Bren', 'Brre', 'Biglen', 'Mährend', 'Schsenbein', 'Tedlingcn', 'Ulutterstadt', 'Burgerthums', 'vilmergen', 'Speier', 'MuenburgMdau', 'Hcimberg', 'Interlaben', 'Schanz', 'Oebien', 'Berncr', 'Golaten', 'lvalendorf', 'Christosfclvorwerk', 'Baselwind', 'Gertzense', 'Räthe', 'Gbertosfen IDinzcnriede', 'Lraubrunnen', 'Seeberg Inkwpl', 'Ipsach', 'Aegcrtengasse', 'Gegau', 'Tscharner', 'Lilcia', 'Maadt', 'Hilterfingcn', 'Sroburg', 'Ucucnstadt', 'Illlinen', 'Peter Bielersee', 'Lykurg', 'Twingherrenstreites', 'Ncuenstadt', 'Bern Burglehen', 'Auszer-Birrmoos', 'Römer', 'Ivei', 'Sraubrunne', 'Lraueutag', 'Srobnrg', 'Appellationskammer', 'llcucnburg', 'Höricourt', 'Lyonft', '- singenst', 'Bern ZOO', 'Bern Line', 'Allmendingen', 'Twingherrenstreit', 'Ulühlenen', 'Lamilien', 'Böniz', 'St Jakob', 'Diel', 'Losenegger', 'Signau Spiez', 'Lrgg', 'Bernbatzen', 'Sraubrunnen', 'ecclesiu', 'Rüegsau', 'Theobald', 'Mrzogenbuchsee', 'Uiederulmiz', 'Ascensio', 'Lriswyl', 'Iliemand', 'Aargaus Ulacht', 'Dünn Dkoune Zir', 'Ulrich', 'INühlenen Reichenbach', 'Nlous', 'Amerten', 'Schloß Oberhofen', 'Meinen Rathes', 'Schnppisen', 'Luno', 'Gberwrff', 'Brienzwvlcr', 'piemont', 'Gerolsingen', 'Dez', 'Aechberg', 'Otenr', 'Ziis', 'Lngenberg', 'Lötschen Planalp', 'Rcgcnsburg', 'Mßlingschen Lause', 'Mlcheri Langnouw', 'Lorn', 'Dntz', 'Bernse', 'Lern Lde', 'aargau', 'Ueuenegg', 'Sriedens', 'Km4 Ponies', 'Uötken', 'Medergerbcrn', 'Slumenthal Balm Gnsberg', 'Grneberg', 'Reichsland', 'Aheinfelden', 'Ober-Emmenthal', 'uenegg', 'Rmligen', 'Thun Fontes', 'Lahors', 'INutach', 'Drln', '- Limpach', 'Lüren', 'Gravenriet', 'Aothschild', 'Schafshauscn', 'Dupilero', 'Keimberg', 'Ursach', 'Liern', 'IVestschweiz', 'GolattcnmattgaszthorthurnV', 'Lmpliz', 'Ilnspunnen', 'Ueu', 'Sankt', 'Sach Heutigen', 'UUirteii', 'Brandts', 'Lhalchegg', 'Niesten', 'Lllenwvl', 'Ulargaretha', 'Meszort', 'Kancy', 'Blocken', 'Liinppach', 'IVissenburg', 'Mnchen-Buchsi', 'Bern SLettler', 'Zrinach', 'Illoudon', 'Wildegg', 'Verburgrechtete', 'Laane', 'IVeißenau', 'Diemtigen', 'Bhberg', 'Vuchsee', 'Friedrichs', 'Lhafte', 'Zrei', 'Burgistein Münsingen', 'Stadtrodel', 'Drstetten', 'ldusz', 'Mten', 'Lutstorf', 'Subingen', 'Nikodep', 'Isswpl', 'Ladenzins', 'LünevillerSrieden', 'Ita', '- und Meder-IVangen', 'Saanenks', 'Tbingen', 'Rthcnbach', 'Thcatcrplatz', 'Reu', 'Burgdorf Line', 'Pfenningen', 'Kram', 'St. Bern', 'koutcs', 'IDalpurg', 'Jougne', 'Nüeggisperg', 'Ullibach', 'Riedburg', 'Trinrstein', 'Ursenbach Rohrbach', 'Aarestadt', 'IDuralt', 'Stadtz', 'Nrnberg', 'Bernbuch', 'Lngi', 'Lonstetten', 'Palm-Montag', 'Lipp Ain', 'Neueu', 'Vonteb Voutes', 'Tarascona', 'Walliswpl', 'Jegistors', '4röniz', 'Ilpon', 'Burglehen', 'Mittclgcrbern', 'Lremgarten', 'llov', 'Litzi', 'Inrhof', 'Hettiswpl', 'Rüegsau Rüegsbach', 'Instingers', '- aargau', 'Cggiwyl', 'Verbrg', '-', 'Lvian', 'UuK', 'Mcinisberg', 'Reichsthal', 'Drniz', 'Ris', 'Rüdlen', 'Lienhardt', 'Sstcrn', 'Heiligen Bethlehem', 'lvengen', 'Romarkt', 'Lreibnrg', 'Sebruar', 'DraubriNiiien', 'St. Gttmarstag', 'Deutschen Orden', 'Miggiswpl', 'UeuenburgMdau', 'Därstetten', 'Nöthe Buch', 'Burkhard', 'Rarem', 'Illitbnrgcr', 'Linaben', 'Gericourt', 'Selsenburg', 'Ittlingen', 'Laufen', 'Bernst', 'Burgen', 'Smmerthal', 'Burgdorf Amtsbuch', 'Bernern Unterthan', 'Olilcheri', 'buchsee', 'Inierlaken', 'Münsingen', 'ileuenstadt', 'lvorb', 'Schloß Montenach', 'Ulzenstorf', 'lllnchenbuchsee', 'Lern Land VIII', 'Geristcin', 'itpser', 'kmbsburgs', 'Stubenrodel', 'Straburg', 'Tedlingen', 'Gbergisenstein', 'Durgcrnziels', 'lvpler', 'Lreuzgasse', '- gau', 'IVasser', 'Brron', 'Spins', 'Kramgasse Schattseite', 'Laubegg Blankcnburg', 'Münchenbuchsee', 'Uerno', 'Bumplilz', 'Gbernz Rthenbach', 'St Gttmarstag', 'Bayern', 'Württembergs', '- burgergeld', 'Nerno', 'Mrche', '- berg', 'Lauffer Nathsmanual', 'Twiirg', 'Ionqnire', '- burg-Kpburg', 'Eellerarius', 'Kln', 'Fipburg', 'Mhlethal', 'Iranqne', '- simmenthal', 'Genos', 'Zselgau', 'Usfern', 'Npdau', 'Twing Lotzwpl', 'Eronica', 'Ueuen', 'Rütte', 'lleuenburg', 'Mähren', 'Lhalons', 'Großburg', '- sing', 'bubenberg', 'Llankenburg', 'Bilrgdorf', 'Vigneulle', 'Cmmenthal', 'Osten', 'Tedliirgen', 'IVieg', 'Eotzingen', 'Diesbachs', 'Mittellöwen', 'Rothe Luch', 'Dtaufsgegeustandes', 'Luxemburg', 'Win', 'Nrn', 'Aderswpl', 'Efslingen', 'Tvattenwyl', 'Bernerlandes', 'IVdiswpl', 'Ausburger', 'Konolstngen', 'Aohrberg Gberaargau', 'Drandunglek', 'absburg', 'Aarethals', 'Hallwpl', 'Oberkomman', 'LiZiNo', 'Sachseten', 'Aeffligenz', 'Sause Buchsee', 'Obersibenthal', 'Straß', 'Thurm Montenach', 'Gberhasle', 'Harnasch', 'Zischcnzen', 'Lrauenkappelen', 'Lngenberge', 'Linlpach', 'Aare Aare', 'bipp', 'Ranslüh', 'Hmmer', 'Limpach Emmen', 'P3A', 'Strätlingen', 'IVeißenan', 'Lalmegg', 'Delsbcrg', 'Medersimmenthal', 'Dtnigsfelden', 'Johannsen', 'Ulnchen', 'umenthal', 'Kirchlindach', 'Venedigs', 'Srankreichft', 'Slse', 'Irrthum', 'Aathes', 'Güm', 'Sstcrmontag', 'Göttingen', 'Kiburg', 'Marzielistra', 'Ufs', 'Trutzbudnitz', 'Rüderswnl', 'Rathsherren', 'Bucheggberg', 'IZZl', 'Diolmar', 'Grüsisberg', 'Bclp', 'Okauf', 'Lrlenbach', 'Moster Interlaken', 'Lliburg', 'Dicmtigen', 'Ivattcnwyl', 'Hauskaus', 'Büttenberg', 'Büren', 'Neuenburg-Uidau', 'St Latten', 'Thune', 'Neggisperg', 'Oron', 'Naisersberg Diolmar', 'Dtettlen', 'Tiving', 'Kantons', 'IlordJuvopen', 'LGhves', 'Grassenried', 'Haus Spiez', 'Berner', 'Lid', 'Eppern', 'Utzigen', 'Crlach Mdau', 'Berchtolds', 'Bniz', 'Mritgasse', 'Urchenbrunnen', 'lvvnau', 'Lommis', 'Heimiswpl', 'Bümpliz', 'Theaterplah', 'IVangeu', 'INittelschweiz', 'Dpnastenhause', 'NonteZ', 'Rüeggisberg', 'Stadtbach', 'Iveges', 'Klus', 'Ivir Schultheiß Rhät', 'Landwirthschast', 'Tosten', 'Gon', 'Dchüpfen', 'Diallnach', 'Zetinbucb', 'Zrich', 'Röche', 'Miegsrath', 'Serenberg', 'Vinelz', 'Zlttiswpl', 'Aom', 'Bibereir DtleinGümmenen', 'Sreudenreich', 'Wlinen', 'wcicycm', 'Bern Illeisterz', 'St Bern', 'Upon', 'Matzenried', 'Rovcrea', 'Margr', 'Zell', 'Köniz', 'Lupiru', 'RinggenbergBrienz', 'Bühberg', 'Isaall', 'Thun Wimmis', 'Isesse', 'Berntz', 'Erlach Biel', 'Wattenwyl', 'Lreiherrn Usingen', 'Srcibnrg', 'Derno', 'Aütschelen', 'Küngin', 'Lonbach', 'Dietersivpl', 'Weienburg', 'Avenches', 'Burgernziel', 'Webern', 'Rabat', 'Diel Bern', 'Illnsingen', 'Betigen', '- mendingen', 'Jalathurn', 'Srienisbcrg', 'Münster', 'Ringgenberg-Brienz', 'Word', 'Rumisberg Sarneren', 'Palmmontag', 'Hrau', 'Lotzwpl', 'Barschwand', 'Kappelen Vargeir Kallirach Diselen Teusfelen', '- hnigen', 'Kniz', 'Ufels', 'Sumiswald Dürrenroth', 'Lnzi', 'Sechier', 'Samtlie', 'kabsburg', 'Nainen', 'Tellen', 'Höchstetten', 'Vreingarten', 'perrod', 'Niedcrsimmenthal', 'Athenbach', 'Alpweiden', 'Diopien', 'Npon', 'Sarb', 'Lallwpl', 'Längenberg Kühlewyl', 'Dnrg Geristein', 'Dynast Burglehen', 'Tribolet', 'Gloggen', 'Köniz Gberbalm llerlenegg', 'Domo dGssola', 'Romainmotier', 'Lireuzgasse', 'Almosens', 'Ircibergen', '- kofen', 'llladiswpl', 'Lern OLLcium', 'Iran', 'Uoah', 'Glepres', 'Dubenberg', 'Schlo', 'Rath ZOO', 'Ligerl', 'Grünenbcrg', 'Ivediswpl', 'Bern Fontes', 'Mlitrrrndorr', 'Ltn', 'Bucheggbergcs', 'Lerber', 'Mnsingcn', 'Twing und Bann', 'Mflmrg', 'Wedischwist', 'Interlacensi', 'Gchs', 'Neuencgg', 'Thal', 'Irallbrunnen', 'Lcherzlingen', 'Aoggwpl', 'Mlinen', 'Trsigen', 'Sekrctsiegcl', 'Glungenbrunuen', 'Mnchenbuchsee', 'Ringoldingen', 'lvillading', 'Okaufleutengesellschaft', 'Groszhchstetten', 'Wattenwpl', 'lvolfisberg', 'Stettlerst Line', 'Mlchturndon', 'Schanguau', 'lviedlis', 'Mattenwpl', 'Doubs', 'Mannlchen', 'Lursee', 'Tmmenthales', 'llikadan', 'Gaupp', 'Ivegmühle', 'Mein-Burgund', 'Ried', 'Oechsli', 'Mscmiu', 'Rche', 'Lausanner Bischofsstuhlcs', 'Kapaunen', 'GrdensEomthur', 'St. Leonhard', 'Gesterreich-Savoyen', 'Diselen', 'Gberhofen Balm', 'Viterbo', 'IVeienau', 'Rathes', 'Bonmont', 'Rödel', 'Solothuru', 'Ironien', 'Thürings', 'Watteuwyl', 'Lrcitagsschanzc', 'Dabp', 'llpon', 'Aarelauf', 'Joh Bubenberg', 'KleinBurgund', 'Drandunglüek', 'Meiligen', 'Mühleberg', 'Rath Zülse', 'Köniz Bern', 'Dyburg', 'Wisnowe', 'IVangen', 'Lern Michtland', 'Ittigen', 'Thdingen', 'Isasli', 'Ulan', 'Vordcrrvil', 'Münsterbau', 'Ulonteuach', 'Kestenholz', 'trlin', 'Michaelis', 'Dnrheim', 'Rumisberg', 'Ltrauchthal Ivallrringen Linlpach', 'Buchsee 2Z0 Zlrt Juicungue', 'Straßberg', 'Rus', '- Lmminghaus', 'Lnglisberg Lehrsatz Belp', 'Unterwaldcn', 'Ueucnburg', 'Zlbdruck', '- burgcr', 'Rath Alles', 'lluwenburg', 'Thurn iserrn', 'Sankt Gallen', 'ivarzivald', 'VIeinisberg', 'St. Johannsen', 'Mannenbcrg', 'St. Gallen', 'Brcke', 'lvattenwyl', 'Leipzig', 'Rodt Stadt', 'kuenz', 'Rubigen', 'Gülten', 'Dnilzberg', 'Murzelen', 'Großen Rath', 'Metzgerkapelle', 'Ulatthi', 'Weienau', 'Seeivpl', 'Hainen', 'senbrggen', 'Mlhausen', 'Venneren', 'Ehillon', 'Muraltbecher', 'Swartzcnburg', 'Bttenberg', 'Lauterbrunnenthale', 'lOkerlauel', 'Ivinkelmanns', 'Sriedensidee', 'Sesch', '- kosen', 'Schwerte', 'Deedorf', 'Ivalpers', 'Oberivyl', 'Burgdorf Thun Obersibenthal', 'DerSchultheiß', 'Sründ', 'Mnsterthal', 'Bern.1ZZ', 'Schande', 'Seyst', 'Köuiz', 'Ganting', 'bernischen Landen', 'Stadtz Augsburg', 'Lauterburg', 'Schloß Brücke', 'Spinnstube Burgerspital', 'Strättligen Senn', 'Sier', 'Gsenbrggen', 'Rderswpl', 'Nelvr', 'ststburg', 'Mschberg', 'Johannes', 'Strtlingen', 'Inkwnl', 'pillichody', 'Lressoney', 'Srauen', 'St Katharina', 'Gallon tschachtlan Eschi', 'Petersinsel', 'Mnchenwpler', 'Gttingen', 'Strabcrg', 'Armengut', 'MederIVangen', 'Llumet', 'Uwenstadt', 'Stefanstag', 'Dtopist', 'Crblandc Aargau', 'Instinger', 'SLettler', 'St. Stephan', 'Hager', 'Reich', 'Irciburg', 'Oberlandes', 'Mich Bätterkinden', 'kirN', 'Eirrzelne', 'rhein', 'Interlachen', 'Graswyl', 'Uleinisberg', 'Sraucnkloster Tedlingcn', 'Mlhusen', 'Almosners', 'Cndlisberg', 'Rdlen', 'Berncrn', 'Lans Srairz llägeli', 'Vüttcnberg', 'zürn', 'Sigismunds', 'Aelen', 'Grimmenstcin', 'Bael', 'Weißenburg', 'Schafhusen', 'Gwing', 'Bern Murten', 'Lriswvl', 'Justingerchronik', 'Mühledorf', 'Liicn', 'Savop', 'Saar', 'Ltschenthal', 'Simmenegg', 'Zurzach', 'Aegsau', 'Ostern', 'Uttigen', 'Äumenthal', 'Bcrnerschcn', 'Tggholzes', 'Stcttlen', 'Buwile', 'Berner Archiv', 'Ulllcr', 'Rüeggisberg Amsoldingen', 'Lonstors', 'Münstcrthal', 'Burgund Bremgarten', 'Marswyl', 'Longue', 'Ritzenbach', 'Licilicn', 'Reiben', 'Ivaffenhandwerk', 'Alpenrosen', 'Seitenthals', 'Gurizcllon', 'Mller', 'Uutz', 'Sacconay', 'Verfass', 'Ritterschlages Jerusalem', 'Plappart', 'Rohleder', 'Dießenberg', '- diswpl', 'Clsa', 'Bubenberge', 'Nugerol', 'Nürnberg', 'Rtti', 'Lerner', 'iKnmenhauscn', 'Istarls', 'Wurstcnbergcrthnrm', 'Venedig Rom', 'Raron', 'Maggcnberg', 'Ichdeckbrücke', 'Müllenberg', 'Lhristof', 'Rüegsbach', 'Rthenbach', '- harduskapelle', 'Zwingelhof', 'Schribrnritz', 'Schr-tz', 'pohannscn', 'Gallen', 'Ltadtbach', 'Gümmcnen', 'Neuß', 'Laßb', 'Lyburg', 'Gltingcn', 'Regsbach', 'Lchburg', 'Schuottwpl', 'Zürich', 'Holz Dremgarten', 'Amsoldingcn', 'Ivippingen', 'Segesser', 'Ivinterswpl', 'Thrru', 'Iviedlisbach', 'Breiburg', 'Lantzlep', 'Srciburgs', 'Düren', 'Rud Steck', 'Knitz', 'Masli', 'Muenburg-Mdau', 'Dominikanerkirche', 'Habsburg', 'Baselstab', 'Grsisberg', 'Biberach', 'Isaus', 'Vren', 'Mülhusen', 'Loh', 'ldabsburg', 'Dtönigsfelden', 'Tavel', 'llrscnbach', 'Blwgund', 'Muralt', 'Saanelandcs', 'Sries', 'Marseille', 'Wickartswpl', 'Grünenberg', 'Grdl', 'Christoph', 'Lckemunden', 'Lebr', 'Iserrenschwand', 'Leißigen', 'Zrichkrieg', 'Wmtersnwl', 'Golattenmattgasse', 'Gutsindeu', 'Tegertsche', 'Fontes', 'Vogt Laupen', 'Grbe Grandson', 'Guntram', 'Nontes', 'Uhenstorf', 'Gberwangen', 'tsomberg', 'Schoren', 'Schcrzligen', 'Lötn', 'Ried Lnglisberg Rümmligen lllünsigen Almedingen', 'Mhlethurnen', 'Gießbach', 'kirchl', 'Graffenried', '129s', 'Gösgen', 'Buetingen', 'wisnau', 'St. Peter', 'Bittwpl', 'Spbold', 'Zähringen', 'iZlargau', 'Lrbfürstenthum', 'Lrlach Aarberg', 'Schongouw', 'Kerrinanil', 'Thonon Ternier Gex', 'Aiggisberg', 'Lurkart', 'Altgerbern', 'Haus Buchsee', 'Mittelland', 'Gerberngraben', 'Stubenzins', 'Dönilzberg', 'Ulorges', 'IslO', 'Sirium', 'Bärengraben', 'Whren', 'Balm Südabhang', 'Neuen', 'Rathhaus', 'Strttlingen', 'Haus Haus', 'IVerdt', 'Entlebuch', 'Vinzenzen-Mnsters', 'Drrenroth', 'Goslewil', 'kuttwyl', 'waitz', 'Bleien', 'Bönigen', 'Zeitglockenthurm', 'St Petersinsel', 'Bcx', 'Nied', 'Gurbr', 'Berqq', 'Aargau Bern', 'NNnterstetten', 'Köln', 'Lren', 'Schloß Simmenegg', 'Böspfennig', 'Sets', 'Stettlcr', 'Schnenwerdt', 'Schwarzcnegg', 'Graubünden', 'Mlchdorf', 'Längenbühl', 'Biberschi', 'witeubach', 'Tivann', 'Stanthart', 'Bärn', 'Gkt', 'Diilz', 'Bamberg', 'Bonn Rhein', 'Delpberge', 'Hagneck', 'St. Trachselwald', 'Dicocca', 'Inuocentium', 'Schulrath', 'Mhldors', 'Iriedeus', 'reiburg', 'Udelbuch', 'Trlach', 'Illarktgasse', 'ZSö Nantes Alb', 'Stadnz', 'lmcvon', 'lllarignano', 'Thierstcin', 'Brienzersee Ringgenberg Mederried', 'Distelzwan', 'Sannen', 'Straberg', 'Ligerz Tivann Diilz Ivalpers', 'Allod', 'Judica', 'Lauterbrunnenthals', 'Durghut', 'Rüblimahles', 'Bernensis', 'Oberhasli Aarberg', 'Trb', 'Bernthaler', 'Stffis', 'Oberlands', 'Boresto', 'Uetendorff', 'Ulark', 'Vuchegg', 'Lützelflüh', 'Neuburg Elsaß', 'Lriswnl', 'Serren', 'Dtnigshofen', 'Lalkcngarten', 'Lern Bern', 'Lotz', 'Bellevue', 'Stein', 'Riggisberg Spiez', 'Sleisch', 'Ilürenberg ZOO', 'Rmlingen', 'Kieronymus', 'Tschugg', 'Sigris', 'Lalschmünzerei', 'Ölten', 'Srutingen', 'Irischherz', 'Sferten', 'Seuer', 'Breitenrain', 'Karthause', 'Lombarden', 'Hessen', 'Lobsigen', 'Degistorf', 'Gyps', 'Lischofsstnhl', 'Rathsgliederu', 'pannonien', 'Den Bernern', 'Iveißenburg', 'Burgdarf', 'Sarneren', 'Schweizerisches Museum', 'Spiez Gbcrhofen', 'Lumiswald', 'Gm', 'Rath Bern', 'Ltrauchthal', 'Maadt Unterthan', 'Zwiselberg', 'Nieder-Oenz Rthenbach', 'Nienberg', 'Gerbcrn', 'MeinGnmmenen', 'Herzwyl', 'Vul-e-Ku', 'Rüeggisberg Srienisberg Interlaken', 'Aeschlen AuszerBirrmoos Barschwand', 'Fyburg', 'Langhans', 'Grnenberg', 'Tannerrbuel', 'Gptingen', 'Niederwpl', 'St. Petersinsel', 'labsburg', 'Meritgasse', 'Srevelsachen', 'Sulensee Honrich', 'Bietzivil', 'Ka', 'Reichsboden', 'Uordschwaben', 'Rothe Buch', 'Nancy', 'Ponies', 'Uicder-Runtigcn', 'Ileuenstadt', 'Slumet', 'Mrch', 'Kaufdorf', 'Schwarzen', 'IVeiszenburg', 'Gurzelen', 'INnsterthal', 'IVallisgebirge', 'Nota', 'Ivinterthur', 'Weißenau', 'IVpler', 'Grasburg Gltingcn', 'Donuerbhl', 'Stra', 'Gmmenen', 'Uutkerum', 'Veste Laupen', 'Aarberg Bern', 'ZOO', 'Ulhlenen', 'St Andrestag', 'Grnenbcrg', '- wpl', 'Mamburg', 'Ulmpelgard', 'Sicglcr', 'Mnchenstein', 'Gugspurger', 'Rougeinont', 'Iliaurice', 'Biberen Jerenbalm', 'Visthum', 'Lüttich', 'Rdel', 'Amsoltingen', 'Asse', 'Mattenwyl', 'Teitiilgen', '- burg', 'Gaupp puA', 'Lriz', 'Luzcru', 'IValdsttten', 'Twingen', 'Gberwpl', 'Dietrich', 'Ielmkleinods', 'Albligen', 'Srnd', 'Gbergerbernhaus', 'Assen', 'Bann', 'Bern xag', 'Zhringcrn', 'Vinzenzen', 'lvolfgaug', 'Graubnden', 'Milden', 'Ziehende', 'Mrchhören', 'Inkwifl', 'Mennorialia', 'Hofstatt', 'Almosenkammer', 'Berken Inkwifl', 'Sterchi', 'Risold', 'Balthasar', 'Märitgasse', 'Merth', 'Bern Stürler', 'Rustwald', 'Lmmen', 'Rothes Buch', 'Hoch', 'Bielersewc', 'Sieronymus', 'Obergerbern', 'Sreibnrg', 'Arles', 'Lenk', 'lvaadt', 'Niederlande', 'Nicr', 'Gbergerbcrnhauses', 'Bern Burgdorf', 'Rath Distelzwang', 'GesterreichSavoyen', 'Gberlande', 'Lbeck', 'Mlerzins', 'Bilcheri', 'Loosschstem', 'Lasarraz', 'Archiv', 'Christofscl', 'Sptcz', 'Moster Twing', 'Limpach Rütti Leilzigen', 'Richenbach', 'Suellcn', '- gen', 'Kvburg', 'Gairzeir', 'Lallwyl', 'Vberbürron', 'Nöthe Buch Jahre', 'Kiburgers', 'Scedorf', 'Dieenhofen', 'Zchilling', 'Lchnciderhand', 'Blankcnburg', 'Isropie', 'Rathhausplah', 'Thal Ari', 'Wartenstein', 'Aathsbeschluß', 'Sans Sranz llägeli', 'Ikts Bern', 'Rütti', 'Lchnenberg', 'Mnz', 'Brechtseher guldin Dis', 'Illai', 'Dießbach', 'Schlettstadt', 'Schloß Thun', 'Schoßhalde', 'Gotteshause', 'Bonn', 'Gesellschastshauses', 'Leerenschwand', 'llidau', 'IVädiswpl', 'Lerbort', 'Anshelms', 'Hericourt', 'Lchbnrg', 'Lrlachs', 'Mergentheim', 'Voutes', 'Längenberge', 'Amsoldingen Saanen', 'Mhledorf', 'chsee', 'trw', 'Michtland', 'Tübingen', 'Mnstcrthal', 'chstctten', 'wyler Kaufdorf', 'Bmpliz', 'Uilterseen', 'St.', 'Die Gbergerber', 'Sritzenbach', 'Batzen', 'Karins', 'Morms', 'Uuwenegg', 'Kohlerthurm', 'Rathsmannal', 'Sptlingen', 'Biberstein iZlargau', 'Grtschwaben', 'Aarbergergassc, ', 'Ulmiz', 'Thürme', 'Bern Aarberg', 'Büttikon', 'Mllen', 'Tofsen', 'Steiger', 'Zhringen', 'Lern xag', 'Oculi', 'Grncnberg', 'Walde', 'Ulontsalvens', 'Heisterbach', 'Schongouws', 'Speltcil', 'Mauchthal', 'Uebrigens', 'Lttich', 'Üantone', 'Neu-Bubenberg', 'Ivattenwil', 'Switz', 'Ulurten', 'Dies', 'Wiedlisbach', 'labs', 'Pfauen', 'bkpburg', 'Sorst', 'Röthcnbach', 'isolawegen', 'Bern Basel', 'Iverdon', 'Sagade', 'Aarwangcn', 'Königshause', 'Landshut Jegistors', 'Lütschenthal', 'StefsisburgDorf', 'Thonon', 'Vevep', 'Gstern', 'Gber-Arnlingen', 'Roßmarkt', 'swartzenburgs', 'Langenegg', 'Ks', 'Ostermontag', 'Tmmeii', 'Mnsingen', 'Madiswpl', 'Kienthal', 'Riggis', 'Samilien', 'Solothurn Ulurten', 'Dchpfen', 'Sense', 'Uider-Amlingen', 'Brenigartenwald', 'Gals', 'Hraubrunnen', 'altschnnd', 'Pest', 'Habstetten', '- ried', 'Müliuen', 'Ltzelflh', 'voralpen', 'kpburg', 'labkcrn', 'Haus Büren', 'IVilheln', 'ivartenstein', 'Khn', 'Wittigkowen', '- mnsters', 'Dchivarzeiiburg', 'Rhodanische Republik', 'Rümlingen', 'Sept', 'Nürnberg Goslar', 'Lause', 'Lggiwpl', 'Lang', 'Dren', 'Ulerich', 'Audolss', 'Zosingeu', 'Regsau', 'Grundcigcnthum', 'bernisät', 'Niedergerbern', 'Schscnbein', 'Rohrbach', 'Iilterlakeil', 'Ullinen', 'Kalis', 'Savopens', 'Dtoppingen', 'INontmajor', 'Anerris', 'Stammburg', 'Alchistorf', 'Cäsarius', 'Horgenwpl', 'Steck', '4-rniz', 'Bahnhofplatz', 'Aath', 'Kpburger', 'Martini', 'IValter', 'Sraubrunneu', 'Naisersberg', 'Oermunos', '- bach', 'Lipburg', 'Radolfzeller', 'Münsterthalcs', 'Nidan', 'Illiswpl', 'Aubonnc', 'Berken', 'Sqvopen', 'Lontessio', 'Dipp', '- dingen', 'Obcrbipp', 'Straberg-Bren', 'Marsili', 'Documenta', 'Gonzenbach', 'St Johannsen', 'Ivedischwpl', 'Br', 'Jenff', 'St. vinzcnzenmnsters', 'Iveienau', 'Wattenwile', 'Bnchsee', 'Saurilie', 'UicderRuntigcn', 'Stessisburg-Thuu', 'Umschlin', 'Oster-Illontag', 'St. Berchtenstag', 'Dieenberg', 'St. vinzenzenstists', 'Vogt Wangen', 'Troppau', 'Rath', 'Xnmm', 'Riggisberg Zimmerivald Velp', 'Brn', 'Oitpburg', 'Brunnadcrn', 'Ringgenberc', 'Bellmnnd', 'Klein-Burgund', 'Junghcrr', 'burg', 'Burgdorfertrrieg', 'Simmenthal', 'Neu', 'Sranksurt', 'Sberburg', 'lliederbipp', 'Kabs', 'Reggisbcrg', 'Ivestschweiz', 'Der Schultheiß', '- gasse', 'Rcggisberg', 'Mülhausen', 'Leinzmanntz', 'Donuerbühl', 'INhlcberg', 'IVierezwyl', 'Landshut Langenthal Laufen Laupcn Madiswyl Melchnau Mühleberg Münsingcn Münster Muri Ileuenstadt Mdau Medersimmenthal Gberhofen Gbersimmenthal Gltingen Petersinsel', 'Ivatteuwpl', 'Rabs', 'Dtienberg', 'Sreitag', 'Burgdorff', 'Zravaverit', 'Cosfres, SLOC', 'Unterthanenland', 'Anshclm', 'Turin', 'Stadtkirche', 'Sinai', 'Ivattenwpl', '- menen', 'Rothes Luch', 'Inner-Birrmoos', 'Ssp', 'Meisterz', 'RtschelenI', 'Thu', 'Thrurstetten', 'Sreibcrgen', 'Stefensburg', 'Layade', 'ousfdors', 'Uiklaus', 'Savopcn', 'Kpbnrgs', 'Zosingen-Stift', 'Ausburger Ulan', 'Meißcnburg', 'Derns', 'Leilzigen', 'Dantes', 'Ltadtrod', 'Elisried', 'Haus Nöniz', 'Lrsigen', 'Gberwichtrach', 'Uloudon', 'Sestigen', 'IValendors', 'Stettlers', 'Berlin', 'Ordenshause Ulünchen', 'Montfaucon', 'kirchberg Kirchl', 'Harnischschau', 'Uidau', 'Berns Aargau', 'Sibenthal', 'Kuiz', 'Üilcheri Sygriswil', 'Zeerleder', 'Sszeli', 'Ivallis', 'Baumgarten', 'Illainz', 'Waadt', 'Gerechtigkeitsgasse', 'Illeisterz', 'Spätlingen', 'Straßburg', 'Mardern', 'Liram', 'Luzernbuch', 'Luntziker', 'Aathe', 'Meinem Rath', 'Zrichgau', 'Kien', 'Peter', 'Nicdergerbern', 'Kriegsraths', 'Trachsclwald', 'Sumiswald Trachsclwald', 'Seedorf', 'Zürichgau', 'Interlakcn', 'Mittelmeeres', 'Gberbren', 'Schwarzenburg Grasburg', 'Schauplatzgasse', 'Jakobi', 'Stattweibel', 'Wülinen', 'Ie', 'Amsol', 'Xnello', 'Sürglen', 'Lipp wiedlisbach', 'Bern Lehen', 'Ivattenwyl', 'Seclsorge', 'Saaneslusses', 'Bernds', '- stellau', 'Oiireuzgaffe', 'Scherzligen', 'Ifwist', 'Neubau', 'Biberstein', 'Liebcwpl', 'wolhusen', 'Giebach', 'Shnenberg', 'Bündmß Gümminen', 'Uloutenach', 'Irüsisberps', 'Lataloxue', 'St Gallen', 'Saanelandes', 'Dosten', 'Kpfer', 'St. Jakob', 'Meinen Gnedigen', 'Blcienbach', 'Berne', 'Museum Bern', 'Kloster Gott', 'Npdeck', 'Dieterswpl', 'Adelboden', 'St Urban', 'Attiswpl', 'Vrunnadern', 'Gmminen', 'Dotzigen', 'Spiez Lehen', 'Helvetischen Republik', '- buchsee', 'XVI Jahrhunderts Line', 'Cgerdon', 'Aargan', 'Ivinngen', 'Srankrcichs', 'Deutschordenshause Bern', 'Iteimber', 'Aarberg Lpß Zlsfoltern Ivengi Rapperswpl Degistorf lllünchenbuchsee Vreingarten Kirchlindach', 'TschachtlanDittlingerchronik', 'Meder-Emmenthal', 'Serrn', 'Dippsach', 'vergl Fontes', 'Kanton', 'Tavcl', 'Mslin', 'Sac', 'Königsfelden', 'Ldcl', 'cimberg', 'Neuburg', 'Krtegstetten', 'wanchdors', 'Mnsterthalcs', 'Mclchnau', 'Irag', 'Dampfwpl', 'Delpberges Fontes', 'IVanner', 'Lerzogenbuchsee', 'Gerlafingen Ipsach', 'IVinterthur', 'Aittingen', 'Längenbergc', 'Tennenbach', 'Knuchel', 'Eschen', 'Mhren', 'Dipburg', 'St. Georgentag', 'Trachsel', 'Lapeten', 'Wpl', 'Diezbach', 'Illit', 'Osilir', '2ligle', 'Habs', 'Gümminen', 'wolsgang', 'Matten', 'BoUigcn', 'Lniz', 'Baar', 'Aohrberg', 'Mlcheri iMtorffingerr', 'Ilothdurft', 'Aar Urk', 'Bath', 'tipburg', 'Diönigthums', 'Stetler', 'Vadian', 'Tschiffeli', 'Mrcheusatz', 'Schirmbries', 'Ivan', 'Vogt', 'Lonstorff', 'Ohmgeldkammer', 'Inkwyl', 'Speichingen', 'Knigsfelden', 'Gron', 'Ringgcnberg', 'Oeeolumpuäii', 'Alb', 'Laupcn', 'Baggwpl', 'lveienburg', 'Bätterkinden', 'städtischen Republik', 'Wimmis', 'Schl', 'Oberländer', 'lliedcrbipp', 'Obcrhofen', 'Thring', 'Wrttembergs', 'Thüringen'}",1928
23563758,290507,"{'Euphorbia', 'Hexandria', 'Brandenburg', 'Kreta', 'Keucnegg', 'Spirsea', 'Oleazeen', 'KronB', 'Kirchberg', 'Celastraceen', 'Thessalien', 'Lyssach', 'Sibirien', 'Radelfingen', 'Tussilago', 'Mondraute', 'Englisberg', 'Bellis', 'Wolilen', 'Lobsigensee', 'Barillen', 'Geisshlatt', 'Spergularia', 'Konolfingen', 'Wichtrach', 'Eimatt', 'Oberland', 'Elceagnaceen', 'Holligen', 'Antennaria', 'Kydon', 'Reichenbach', 'Bremgartemvald', 'Scrophulariaceen', 'Voralpen', 'Stellaria', 'Barbaraea', 'Moosseedorfsee', 'Aardamm', 'Lauterbach', 'Ilun', 'Asien', 'Hirzenfeld', 'Coiydalis', 'Unctoria', 'Vogelheu', 'Aruncus', 'Gurtendorf', 'Kranchthal', 'Jura', 'Pirus Cydonia', 'Priniulaceen', 'Sensematt', 'BlKr', 'China', 'Belpberges', 'Xeubriick', 'Pulmonaria', 'Balkanhalbinsel', 'Krauchthal', 'Altenberg', 'Andromeda', 'Yechigenmoos', 'Cicuta', 'Tamariscaceen', 'Krauch', 'Europa', 'Muri', 'Landorf', 'Mcyenmoos', 'Gerzensee', 'Wichtvach', 'Seliuum', 'Malraeeen', 'Felsenau', 'Lippe', 'Tiigertsclii', 'Eiholzmoos', 'Zolli', 'Pirus', 'Murtenstrasse', 'Rutazeen', 'Sclerantlms', 'Belpmooses', 'Geristein', 'Frienis', 'Wiggiswyl', 'Anethum', 'Paris', 'Niederlindachwald', 'Schreb', 'Labiaten', 'Orient', 'Betonica', 'Allmendingen', 'Borrago', 'Zimmerwald', 'Fragaria', 'Chryso', 'Emme', 'Bellidiastrum', 'Lobsigen', 'Gentianaceen', 'Mannenberg', 'Hasle', 'Papaveraceen', 'Solanaceen', 'Hiihnliwald', 'Burgdorf', 'Halorrhagidaceen', 'Nymphsea', 'Neslea', 'Anchusa', 'Bremgarten', 'Filago', 'Alpen', 'Giimligenberg', 'Platanaceen', 'Cornaceen', 'Stottlen', 'Campanuia', 'Elfenau', 'Cochlearia', 'Bremgartenwald', 'Aarberg', 'Belp', 'Riieggisberg', 'Lochbachwald', 'Engewald', 'Australien', 'Belpmoos', 'Hippocastanaceen', 'Papilionaceen', 'Basilienkraut', 'Peru', 'Ceratophyllaceen', 'Cydonia', 'Bryonia', 'Saane', 'Steinbach', 'Atropa', 'Syringa', 'Repsdotter', 'Oenothera', 'Anthyllis', 'Berula', 'Afrika', 'Hindelbank', 'Jaberg', 'Buchenau', 'Rog', 'Ungarn', 'Althaea', 'Lattich', 'Asclepiadaceen', 'StbB', 'Caryophyllaceen', 'Droseracem', 'Armenien', 'Dipsaceen', 'Scherlibachfall', 'Hunziken', 'Primula', 'Nicotiaua', 'Schweiz', 'Ober', 'Erythraea', 'Euphrasia', 'Betonie', 'Thaumantei', 'Orchidaceen', 'Gypsopliila', 'Yoralpen', 'Laupen', 'Iliirnberg', 'Cistaceen', 'Caprifoliaceen', 'Walkringenmoos', 'Buchsee', 'Lythraceen', 'Onagraceen', 'Waldeck', 'Astragalus', 'Weissklee', 'Atliyrium', 'Roth', 'Conringia', 'Sempervivum', 'Alpenrose', 'Sensenmatt', 'Helminthia', 'Rosaceen', 'Pavia', 'Wislisau', 'Pirolaceen', 'Ulmizberg', 'Dentenberg', 'Sanicula', 'Silaus', 'Engehalde', 'Krauclithal', 'Anagallis', 'Allmendingenmoos', 'Yaleriana', 'Kirch', 'Keu', 'Belpberg', 'Agrimonia', 'Kiesen', 'Zollikofen', 'Tilia', 'Seihofen', 'Droseraceen', 'Schwarzwasserthal', 'Orobancho', 'Satureia', 'Campanulaceen', 'Erucastrum', 'Nicaudra', 'Orobanchaceen', 'Balsaniinaceen', 'Centaurea', 'Apocynaceen', 'Malvaceen', 'Kitaibel', 'Oberburg', 'Salvia', 'Wylerfeld', 'Arctostaphylos', 'Amerika', 'Gleclioma', 'Berberidaceen', 'Marzili', 'Eiholz', 'Pinguicula', 'Geraniaceen', 'Berberis', 'Turritis', 'Brunella', 'Englisbergwald', 'Sommerhauswald', 'Gentiana', 'Sulgenbach', 'Biberklee', 'Comarum', 'Polyandria', 'Iberland', 'Aquilegia', 'Borraginaceen', 'Meyenmoos', 'Neueneck', 'Arenaria', 'Yerbena', 'Ilunziken', 'Euphorbiaceen', 'Carlsruhe', 'Baldgreis', 'Stirp', 'FrKn', 'Niesswurz', 'Seuebiera', 'Bern', 'Wangen', 'Rebhalde', 'Pirola', 'Stiegrain', 'Ostasien', 'Cynara', 'Riggisberg', 'Lyss', 'Fumariaeeen', 'Artemisia', 'Kirchenfeld', 'Aare', 'Saxifragaceen', 'Capsella', 'Bursa', 'Arabis', 'Scrophularia', 'Philadelphus', 'Aquifoliaceen', 'Griechenland', 'Pilosella', 'Murifeld', 'Stenactis', 'Nassiwald', 'Amarantaceen', 'Wabern', 'Bunias', 'Bodenst', 'Calainintha', 'Buxaceen', 'Antirrhinum', 'Lens', 'Thanwald', 'Cardamine', 'Teucrium', 'Sidgenbach', 'Spergula', 'Genista', 'Thymelaeaceen', 'Stockeren', 'Neubriick', 'Cucurbitaceen', 'Gurtenthal', 'Bockshart', 'Oberlindach', 'Nymphaeaceen', 'Lochbach', 'Haulisthai'}",310,"{'Fumaria', 'MENYAN', 'MSeedorfsee', 'Yom Berge', 'HüllB', 'Aecker', 'DeckB Jun', 'Lobsigensee Off', 'Sesleria Setaria Sherardia', 'KronB EMai', 'Rosskastanie', 'Bern Burgdorf Aarberg', 'Köniz Längenberg', 'Heleocharis', 'Genista Ginster St', 'Hunzikenbrücke', 'Kehrsatz Zimmerwald', 'Sonnenthau', 'Aare Radelfingen', 'SAsien', 'Aarberg Periclymenum', 'Döll Habermark St', 'Hieracium', 'KlWabern', 'Längenberg', 'Yechigen Kig', 'Furnariae', 'Bern Belpberg', 'KLindach', 'Icosandria', 'Wabern Wylerhölzchen', 'Jura Phegöpteris Buchenfarn Buche', 'Burgdorf Torfmoor', 'Schaftelen Schafthalm Schaftheu Schalotte Scharbockskraut', 'Schuttes', 'Holligen Felsenau', 'Carex Carlina', 'Stbf Röhre', 'Burgdorf Niederlindach Lobsigen Radelfingen', 'Belpmoos Aardamm', 'seewald Lyss', 'Fr', 'Willcl EMai', 'Liebesapfel', 'LaurierTin', 'Bern Gurten', 'Monöcisch', 'OberMuhlercn', 'Alpenbäche', 'Gerzensee Burgdorf Radelfingen', 'AspUmium Milzfarn', 'Kresse', 'Muri Stein', 'Bremgartenwald MBuchsee', 'Mcehringia', 'Leibschmerz Stock', 'Steinmispel', 'Steinbrech Saxum Fels', 'Kronß', 'Salep Gymnadenia', 'Lyss Zollikofen', 'AVohlcn', 'Gremii', 'Faulenmatt', 'Lyss der Sense', 'Wylerfeld Gurtenthal', 'Könizbergwaldes', 'Bern Kehrsatz', 'Bittersüss', 'Sir Sterile', 'Reichenbach Bodenacker', 'Podagräria', 'Reichenbach Radelfingen', 'Gümmenen', 'Hypochoeris', 'Mülilethurnen', 'Bern Eiholz', 'OberLindach', 'Bern Muristalden', 'HK', 'Utes St', 'BthStand', '0Europa', 'Verbenaceen', 'Moehringie', 'Wylerhölzchens', 'Aarberg der Emme', 'Könizbei', 'Aeste', 'Lttigcn', 'Irippig Scheinquirle Szählig silvaticum St', 'Bantiger Oschwand', 'Laupen Aare', 'Köniz Fussweg', 'Heide', 'Mühlethal', 'Grossuläria', 'SEuropa', 'Giimligenmoos', 'Kirchlindach Kadelflngen', 'Oberburg Gasei', 'MBuchseewald Burgdorf Dryopteris Fee öpüc Eielie Aspidium Dryopteris Bcmm', 'Aira Ajuga', 'Lauchkraut', 'Lerchensporn', 'Peplis Portula', 'Xatterzunge', 'Bern Stadtbach', 'Elteaijniis', 'Zahmkirsche', 'Hesperis', 'KebenB', 'Buvgdovf Radelfingen', 'Melica Melilotus', 'Könizberg', 'Schloss Wyl', 'Alcea Verschieden', 'TriPolygynia', 'Krauchthal Tanne', 'Seihofenmoos OAbhang', 'Längenberg Meven', 'Wylerfeld Gummersloch', 'Onertig Aehrchen', 'Oberburg der Emme', 'Krauchthal Kühweid', 'Frringf', 'Sinngrün', 'Riedburg Fussweg', 'Zehendermättoli', 'Thörishaus', 'Timothegras Tintenbeere', 'Rutamuraria', 'Mollii St Jkantig', 'Keueneck Stitt', 'Burgdorf Samstalwald', 'Trigynia Gif', 'Heracleum', 'Längenberg N', 'Sandrain', 'Bärlapp Bauernsenf', 'Bergföhre Bergrose', 'Polium', 'Anemone', 'Convallaria Convolvulaceen', 'Bern Bundesrathhausterrasse', 'KZähne', 'Kiel', 'Ibsclio', 'Garcke St kahl', 'Leindotter', 'Oltigen Pneumonunthe', 'Burgdorf Aarberg', 'MSeedorf', 'DeclcB', 'Btli Btli', 'Giirbe', 'Felsenau Tiefenaubrückc', 'Scop St', 'Bern Thanwald', 'Burgdorf Riggisberg', 'Küeggisbergegg', 'Primulaceen', 'Burgdorf Coriandrum', 'MBuchseewald Grauholz', 'Birke Bisamhyacinthe Bitterklee', 'Lyss Burgdorf', 'TöTpayiovo', 'Büsclii', 'Lenne', 'Könizbergwald Waldrand', 'Engewald MBucli', 'Ammer Ankenbälli', 'KScherli', 'Hünigen', 'Emme Sense', 'FlugHafer', 'Süssgras', 'Fssigbaum Fr roth', 'Römer', 'Langacker Gümligen', 'Bern Walkringenmoos', 'Bern Sanguisörba', 'Belpberges Girisberg', 'Ufevge', 'PentOctandria', 'NSclierli', 'yuvayyr', 'Vill', 'Lathreea', 'Bern Bremgarten', 'Cupressaceen Cupuliferen Cuscuta', 'Kirchberg Emme Biglen', 'Oberburg Lochbach', 'Knaulgras Knoblauch Knopfgras Knotenblume Knöterich', 'Bern Waldrand Eiholz', 'Eupatorium', 'Köniz Bubenberg Schwarz', 'Wallroth', 'Bern Muri Jaberg', 'Schlossfelsen Aarberg', 'Krätzkraut', 'Reithgras Rempe', 'Angelica', 'KapselFr', 'DiTrigynia', 'Sauerbeere', 'Araceen Araliaceen', 'WiUd St', 'Bern Dählhölzli', 'Egghölzli', 'Harzes', 'Karben', 'Atriplex', 'Kanarienhirse Karde', 'Thorberg Burgdorf', 'Hunzikenbriicke', 'Nacktdrüse Nägeli', 'Boiligen M', 'NebenB', 'Durheim', 'Vill St', 'Burgdorf Thorberg', 'Uromyces Pisi', 'Goa', 'Crocus Cruciferen', 'Paris Parnassia', 'Nessel Nestwurz Niele', 'Xelkomvurz', 'Steinkirsche', 'Rncligras', 'Könizbergwald', 'Pollich St', 'Waldrand Ostermundigen', 'Buchsee Burgdorf Radelfingen', 'Bern Sollrütiwakl', 'Belpberg Gerzensee', 'St WStock', 'WAsien', 'Bern Weinhalde', 'MBuchseemoos', 'Wylerhölzchen', 'Aarberg Lyss', 'Gümligen MBuchseemoos Hindelbank Burg', 'Rothtanne', 'bevg', 'Schüpfen', 'ZitrÖsli, SLOC', 'Engewald Muri', 'Küeggisberg', 'Burgdorf Gsteig', 'Hopfenidee', 'Fromental Froschlöffel Fuchsschwanz Gamander', 'Rosette', 'Zollikofen Uliswyl', 'BthZeit', 'Bern Burgdorf', 'NScherli', 'Roth St', 'Gümligonmoos', 'Koch Kahl', 'Hausset Hauswurz', 'Roggen Rohrglanzgras', 'Bbtli', 'Amaryllidaceen Amelanchier', 'SteinFr', 'Nüsslikraut', 'Pers Strauch oval', 'Gurtendorf Ulmizberg', 'Solrüti', 'Taumellolch Triimmel St', 'Mistel Mohn', 'Hilllspelze', 'BRosetten', 'Blasenfarn Bocksbart', 'Bethlehem Hin', 'Flühe', 'Bodenacker Gurten', 'Gerzensee Burgdorf', 'Scliwanz', 'Ghaerophyllmn Myrrhis', 'Wohlen', 'Feldahorn Masholder', 'Bodenacker Wylerfeld', 'Klette', 'Borkhausen', 'Burgdorf Weg', 'Belpberg Gerzensee Rüeggisberg', 'Münsingen', 'Wabern der Aare', 'Yar St', 'Bern Belpmoos Aardamm Längenberg', 'Jasione', 'Kühlewylwald', 'Thuill', 'Iberis', 'Kalmus Kamille', 'Narcisse Natterkopf', 'Englisbergwald Bütschel', 'Wimm Grab', 'Köniz Belpberg', 'Münchenbuchsee', 'Tormentllla Schrcmk', 'Thörishaus Zollikofen', 'Bärenklau', 'Lockerrasig', 'Kuhkraut', 'Mimsingen', 'Lam Ohne', 'Tlieil', 'Burgdorf Lobsigensee', 'Dählhölzli Waldrand', 'Avena Französisches Raygras Fromen', 'Heliantlius', 'Hippophae', 'Burgdorf MBuchsee', 'Holligen Brem', 'SSibirien', 'Chrysanthemum', 'Köniz MBuchsee', 'Anthemis', 'Aarberg M', 'Hainbuche Hainsimse Hanf Hanfnessel', 'Bern Aarberg', 'KZipfel', 'Weisstanne Weizen Welschkorn Wercli', 'Belpberges Ferrenberg', 'Zilang', 'Sollrütiwald', 'Köniz Ruhigen Kirchdorf', 'Yar EMai', 'Karbe', 'Ruta Ruta Raute', 'Bütschelegg', 'Keubriicke', 'Zäziwyl ArGia', 'Lysimachia Lvsimachie', 'Ankenblümli', 'Bern Reichenbachweg', 'Belpberg N', 'Aveiss', 'Belpberg Thanwald', 'Köniz Bremgartenwald', 'Bern Belpmoos Burgdorf', 'Btli', 'Glasbrunnen', 'Hachen', 'Wabern Muri', 'Ohnhorn Osterluzei Palmdorn', 'Mercurialis', 'Desr arvensis IVallroth St', 'Belpberg AViesen', 'Solrütiwald Engehalde Gur', 'Gurtenthal Belpmoos', 'Diessbach Längenberg', 'Anm arcensis', 'Güterbahnhof', 'Frienisbergliöhe', 'Jun Hecken', 'Köniz Forst', 'Idappiq', 'Trrspov', 'Köniz Ulmizberg', 'NLindachwald', 'MBuclisee', 'Tcixa', 'Buchsee Lyss Thorberg', 'Rupreohtsk', 'Espe Fadenkraut', 'MBucksee', 'MBuchsee', 'Lochbach Rappenfluh', 'Bantiger Radelfingen', 'Buxaceen Bth', 'Bärenried', 'Frienisberghöhe', 'Seedorf Radelfingen', 'Gummersloch Gurteiithal Längenberg', 'Bern Altenberg Marzili Aarberg', 'Bern Felsen', 'Ziegelhütte', 'Oltigen Aare', 'Börstel', 'Schönbühl', 'Worblen', 'Plätaiius Platane Xxtuc', 'Papiermühle', 'Kornblume rothe', 'Vitt Chlorocrepis', 'Ayena Ballota', 'Hiillchen', 'Bümpliz', 'WStock', 'Hauswurz Semper', 'Borstendolde', 'Borstengras Braunheil', 'Burgdorf BlKr', 'SOEuropa', 'Chenopocliaceen', 'Cyparissias xuapicrrro Cvpresse St', 'Rüeggisberg', 'Spitzahorn Lenne', 'Bern Gurtenthal', 'Könizstrasse', 'Ziost', 'Gümligen Thörishaus', 'Münze', 'Belpberges Yecbigenmoos MBuchseemoos', 'Steinlinde', 'Dolde', 'Zeliendermätteli', 'Yar', 'Var cristatum Milde', 'Balsamina', 'Köniz', 'Bern Gümligen', 'Riedgras Rippenfarn Rispengras Rittersporn', 'Rapiinzli', 'Löhrmoos BlKr', 'Dählhölzli', 'Bern Neubrückfussweg', 'Weinrose', 'Burgdorf Lyss', 'Melandryum', 'Schierling Conium', 'Tannenwald Ulmizberg Buchenwald', 'Hinterkappelen MBuch', 'Roth maoupo Eichhörnchen', 'Azalea', 'Fr comosa St', 'Lauterbach Samstalwald', 'Weyermannshaus Gramineen', 'Landorf Landers', 'Helleborus', 'zvDoc Blume WStock', 'BeerenFr Berberis', 'BthStandes', 'Niederlindaehwald Waldrand', 'Grauholz Oberburg', 'Ilasli Holligen', 'Bolligen MBuchsecwald', 'Felsenau Dählhölzli Muri Weg', 'Windfahne Windhalm Windröschen', 'Malvales', 'Anethum Dil', 'NordAmerika', 'Bern Schermenwald', 'Försterhaus Waldrand', 'Dentenbevg', 'Neubrückstrasse', 'Burgdorf Betönica Betonio Urspr Yettonica', 'Milz', 'KAmerika', 'Mäuseklee', 'Oberburg Thorberg', 'StBasis', 'Goodyera Gramineen', 'thal', 'BthStände', 'Engewald Wald', 'Hufeisenklee', 'Bern Tannacker', 'Lappa', 'Mannagrütze', 'Lutetia', 'Wollgras Wollkraut', 'Snervig', 'Bern Bremgartenwald', 'Bern Torfmoor', 'Haargras Habermark', 'Burgdorf Schüpfen', 'Hypericaceen', 'Aarberg Burgdorf', 'Schilf', 'Cystöpteris', 'CAMPYLO', 'Ehrh ulmifolia', 'PapiUonaceen', 'Belpberg Thurnen Gurtenthal Ulmiz', 'Brie WStock', 'Cotonea', 'MBJ St', 'Thelgpteris', 'Burgdorf Bargen', 'Zimmerwald Kirche', 'Bllvr', 'Krauchthal Burgdorf', 'Gürbe', 'Hedera', 'Dioscoreaceen Diplotaxis', 'Lyss Gramineen Nerven', 'Lam St Antonskraut St', 'BlKv', 'Ilunzikenbriicke', 'Opuntinae', 'Erle Esche', 'FrFleisch', 'Steinbrück', 'Corallorrhiza Coriandrum', 'Aehrchen', 'Perlgras Perlkraut', 'Löhrmoos', 'Burgdorf Schlossberg Thorberg Myrrhis Süssdolde abpp Myrrhe', 'Lornaceen Dolden Kronß', 'Belpberges Bütschel', 'Mühleberg', 'Cynosürus Kammgras', 'Saxifraf', 'Zehendermätteli', 'Saumfarn', 'Bethlehem Gurten', 'Aavberg TliysseliTmiii', 'Forst Lobsigensee', 'KlAsien', 'Steinhölzli', 'Holl Bärenried', 'Arve Atticli', 'Garcke Fragaria', 'Lausekraut', 'Thorberg Trimstein', 'Kiesen der Emme', 'Arctostäphylos', 'Bern Wylerfeld', 'Anm Gärten', 'Buchseemoos Anm Catabrosa', 'Zollikofen Jjaubberg', 'Englisberg Längenberg', 'Arnpelopsis', 'Mondraute Montie', 'Dählhölzli Bremgarten'}",529,"{'Diaudria', 'Thymian', 'Stieg', 'Borstengras', 'Waldrndern', 'Prunus', 'Gurteiithal', 'Ruta', 'Adenostyles', 'Dipsacus', 'Populus', 'Oleaceen', 'Alisma', 'vulgaris', 'Wylerhlzchen', 'Picea', 'Salix', 'Ampfer', 'Silau', 'Btschel', 'Amelanchier', 'Schwelle', 'Mattenhof', 'Buvgdovf', 'Girisberg', 'Draba', 'Parnassus', 'Rhinanthus', 'Heiteren', 'Yerbascum', 'Adoxaceen', 'Hirschdorn', 'Thalgut', 'Persoon', 'Grbe', 'Sedum', 'Ulme', 'Maiblume', 'Var stellata', 'Pimpinella', 'Cystopus', 'Eberwurz', 'Smith', 'Zziwyl.689', 'Soyer-Willemet', 'Gurke', 'Yiburnum', 'Dianthus', 'Ballota', '- zikenbriieke', 'Grosshchstetten', 'Polypodium', 'Gnrtencorf', 'Borretsch', 'Sclireb', 'Vechigenmoos', 'Yeronica', 'Reggisberg', 'Dalmazi', 'Beifuss', 'Yinca', 'Hanf', 'germanica', 'Bellardi', 'Mertens', 'Rippenfarn', 'St. Metern', 'Platterbse', 'Segge', 'Swartz', 'Orobanche', 'Filipendula', 'Avieder', 'Baldrian', 'Sanguisorba', '- briiche', 'Farsetia', 'Bergrose', 'Miinsingen', 'violettroth', 'Galeopsis', 'Carciflia', 'Solanum', 'Farbkraut', 'Dhlhlzli', 'Carum', 'Ammer', 'Rosa', 'Schrder', 'Chivon', 'Haller', 'Pippau', 'Binse', 'Lwenschweif', 'Amselberg', 'Sibthorp', 'Sympliytum', 'Sclnvarzwasserthal', 'Sameula', 'Bubenberg', 'Lieschgras', 'Cycadinae', 'Rutaceen', 'Specularia', 'Grab', 'Engelsss', '- Muhleren Belpberg', 'Scl', 'Mnch', 'Monogynia', 'M.Bucksee', 'Tragopogon', 'Goldstriten', 'Schpfen', 'Poa', 'Tunica', '- gartenwald', 'Wermut', 'Kandergrien', 'Gevzensee', 'Ocimum', 'Geranium', 'Odermennig', 'Cannabacecn', 'Trilis', 'Uettligenwald', 'Burg', 'Typhaceen', '0.Indien', 'Peiitandria', 'S.Asien', 'Briza', 'Frsterliaus', 'Malachium', 'Whlst', 'Betula', 'Palisot', 'Ankenblmli', 'Schwarz', 'Plantaginaceen260', 'Solidago', 'Ornitliogalum', 'Sherardia', 'Scorzonera', 'Safran', 'Ostermundigenberg', 'M.Buclisee', 'Saxifraga', 'Moosseedorf', 'Yincetoxicum', 'Schwarzwasserbrcke', 'Kautzenhubel', 'Convolvulaceen', 'Beselireps', 'Picris', 'Pent-Octandria', 'Bolligen', 'Knautia', 'Rettig', 'Pestwurz', 'Lolch', 'Rispengras', 'Yicia', 'Landers', 'RoMnia', 'Carp', 'Boiligen', 'Galium', 'S.Russland', 'Schlossfelsen', 'Resedaceen', 'Tschuggen', 'Caltha', 'Immergrn', 'Biitschelbachthal', 'Atticli', 'Uhus', 'Biglen', 'rosettig', 'Sssgras', 'W.Stock', 'Mavkirch', 'Brentraube', 'Grmsch', 'Portula', 'Timothegras', 'Radieschen', '- steinbruch', 'Tannenwald', 'N.Sclierli', 'Betulaceen', 'Achillea', 'Oxycoccos', 'Bartgras', 'Ful', 'lutAola', 'Willdenow', 'Gummihubel', 'Ervmn', 'Weidenrschen', 'Masholder', 'St.B', 'Spec', 'Jkantig', 'Utricularia', 'Juncaceen', 'Ajuga', 'Gbelbach', 'Bocksbart', 'Yalerianella', 'Kiesenbach', 'Hasenlattich', 'Adlerfarn', 'Amarantus', 'Sinapis', 'Aira', 'Laufenbad', 'Yettonica', 'Sauerdorn', 'Betonio', 'Breitklbchen', 'Niele', 'Buchenfarn', 'Btsehelegg', 'Robinia', 'Ophrys', 'M.uchseemoos', 'foetida', 'Lhrmoos', 'Mhlethurnen', 'Sagina', 'Pisum', 'Pastinak', 'Nees', 'Ulmizberg.933', 'Sclnneerwurz', 'Schwalbenwurz', 'Solrti', 'Stocheren', 'Rapa', 'farinosa', 'Armeniaca', 'Vitaceen', 'Didynainia', 'Lantdna', 'Biembacli', 'Maulbeerbaum', 'Maximowicz', 'B.Scheiden', 'Sandboden', 'Melisse', 'Bth.Trauben', 'Ankenblli', 'Prenanthes', 'N.Scherli', 'Punica', 'St. stig', 'Ballenbhl', 'Polygonum', 'Belpbergs', 'Drakau', 'Ophioglossum', 'Crantz', 'Convallaria', 'Tetradynamia', 'Mrzglckchen', 'Haargras', 'Sapindaceen', 'Lemna', 'Schlipfen', 'Egelmoos', 'Wimmer', '- bacli', 'Lwenmaul', 'Hrnberg.920', 'Pentagynia', 'Bodenst.B', 'Braunwurz', 'Alsine', 'Colchicum', 'Schlossberg', 'JNeuenegg', 'Hecken', 'Mhleberg', 'Bittersss', 'Agrostemma', 'Coriandrum', 'Grossulria', '^', 'Milzkraut', 'Taxaceen', 'intermedia', 'Sambucus', 'M.Bucbsee', 'Akazie', 'Dioscoreaceen', 'Happig', 'St. rosettig', 'Meertriibeli', 'ArGia', 'Troll', 'Kautzen', 'Grten', 'Reithgras', 'Sori', 'Pedicularis', '- briieke', '- gisherg', 'Glyceria', 'Chelidonium', 'M.Buchsee', 'S.Afrika', 'Kohl', 'Rhamnus', 'Tri-Polygynia', 'M.Seedorfsee', 'Asperula', 'Aavberg', 'Corona', 'Tanne', 'Helvetia', 'Glatthafer', 'Brlapp', 'Pastinaca', 'Bth.Bodens', 'Holl', 'Schwarzwassorthal', 'Baden', 'Stbf', 'Reggisbergegg', 'Digitalis', 'Medien', 'Kirchdorf', 'Syngenesia', 'Lois', 'Gypskraut', 'Straussgras', 'Thorberg', 'Peplis', 'Ulmaceen', 'Kies', 'Buchseemoos', 'Alyssum', 'Haselnuss', 'Stein', 'Perlgras', 'Sanguisrba', 'Lampsana', 'Ober-Muhleren', 'Sonchus', 'Xanthium', 'Caucalis', 'Huds', 'Frieswyl', 'Platanthera', 'Eberesche', 'Crepis', 'Hainsimse', 'Rhamnazeen', 'Zziwyl', 'Ononis', 'Hartheu', 'Reseda', 'Biitschelegg', 'Trimstein', 'Salisbury', 'Knizberg', 'Wimm', 'Zea', 'Majoran', 'Samstalwald', 'Rubiaceen', 'mollis', 'Schwarzdorn', 'Tetrandria', 'Gm', 'Capsa', 'Podagrria', 'Myrrhis', 'Tetragonlobus', 'Luzerne', 'Blechnum', 'Lngenberg', 'Guvtenthal', 'Bth.Stand', 'Knopfgras', 'Bupleurum', 'Nopota', 'Tofieldia', 'St.Glied', 'Hunzikenbrcke canina', 'N.Seite', 'Herbstrose', 'Keggisberg', 'Kiitzing', 'Aparine', 'Galeobdolon', 'Fvienisbevg', 'Ophioglossaceen', 'cathrtica', 'Polypodiazeen', 'Faba', 'Tiliaceen', '0.Europa', 'Yiola', 'atrata', 'Cumarin', 'Emmeschachen', 'Knoblauch', 'Zollikofenwald', 'Petasites', 'Sarothamnus', 'Di-Pentagynia', 'Bzhlig Dolden', 'Scutellaria', '- tenthal', 'Callitriche', 'Biitsclielegg', 'Artischoke', 'Riedgras', 'Blasenfarn', 'Datura', 'Yillars', 'Fetthenne', 'Oxalis', 'Ledihhe', 'Niederlindach', 'Rainfarn', 'Lhr', 'Platanus', 'Gmmenen', 'Hippocrepis', 'Tannmark', 'Lindenthal', 'Polygalaceen', 'Callitrichaceen', 'A.Lindachwald', 'Elseagnaceen', 'Milzfarn', 'Vogehvicke', 'Engler', 'Kiesgruben', 'Beitenwyl', 'Jircaea', 'Thrishaus', 'Stdcliys', 'Pirol', 'Cannabis', 'Aug Grben', 'Oesterreich', '- egg', 'Beckig', 'Weyermannshaus', 'Secare', 'Brenried', 'Baumtropfen', 'Arum', 'Bims', 'Buta', 'Keggisbergegg', 'Ceratophyllum', 'Weiden', 'Waldrand', 'Kreuzdorn', 'Polygamia', 'Bibern', 'Wiesen', 'Beinwurz', 'Dodecandria', 'Gnsel', 'Brassica', 'Tpfelfarn', 'Salicuria', 'Lwenzahn', 'Arve', 'Brw', '- zikenbrcke', 'Rhododendron', 'Zehendermtteli', '- brck', 'Beitemvyl', 'Goldrutbe', 'Potamogeton', 'Amarant', 'Tilia Tilia', 'Rchb', 'Riedburg', 'Sollrtiwald', 'Oryza', 'Raphanus', 'Monadelphia', 'Euphorbice', 'Loranthaceen', 'Alismaceen', 'Aconitum', 'Cicer', 'Taxus', 'Sauerklee', 'Enzian', 'Sibth', 'Schwarzkorn', 'Betnica', '-', 'Sorbus', 'Schachtelhalm', 'Linse', 'Vicia', 'Graslilie', 'Robert', 'montana montana Gaud', 'Farn', 'Lam', 'Topinambur', 'Linde', 'Steinbrck', 'Koch', 'Kl.Asien', 'Yecbigenmoos', 'Neubrckstrasse', 'Sumpf', 'Grilnibach', 'Scluitt', 'Allium', 'Mainz', 'Gur', 'Monandria', 'Khlewylwald', 'Tintenbeere', 'Lythrum', 'Minze', 'Mlilethurnen', 'Muristalden', 'N.Lin', 'Typha', 'Sccndola', 'Schllkraut', 'Rainkohl', 'Cynoglossum', 'Pers', 'Koriander', 'M.Seedorfsees', 'Aesculus', 'Gleisse', 'Cannaba', 'Chaerophylium', 'Steinhlzli', 'Camelina', 'S.Sibirien', 'Brzelenholz', 'Lindleg', 'Glanzgras', 'Araceen', 'Delphinium', 'Cucumis', '- mooses', 'Pulicaria', 'Torfmoor', 'Portulak', 'Fennich', 'Polygala', 'Wedel', 'Waldau', 'Dryopteris', 'Wulfen', 'Bidens', 'Fries', 'St.Basis', 'Waldstein', 'St. holzig', 'Bilsenkraut', 'Habermark', 'Potentilla', 'Bauernsenf', '- berg', 'Trauben', 'AYas', 'St.', 'Bmpliz', 'Lamarck', 'Iiunziken', 'Sanddorn', 'Schuhes', 'Mhlethal', 'Meerrettig', 'Serratula', 'Knizbergwald', 'Maykirch', 'Ulmiz', 'Uliswyl', 'Fam', 'Niederlindaehwald', 'Ainus', 'Yill', 'Malve', 'Neottia', 'Scirpus', 'Lob', 'Adoxa', 'Belpinoos', 'Convolvulus', 'Diemerswyl', 'Secale', '- Mulderen longiflia', 'Jussieu', 'Malva', 'Chrosle', 'Silan', 'Melde', 'Sclirad', 'Kabis', 'Ceratophylluin', 'Doronicum', 'Aug', 'Periclymenum', 'Monotropa', 'Ascherson', 'Sanguis', 'Saunifarn', 'Knaulgras', '- sigensees', 'EuphorMaceen', 'Antonskraut', 'Emmer', 'Onobrychis', 'Good', 'Seringe', 'Mais', 'Thracien', 'Schnbhl', 'Cichorium', 'Nuphar', 'Stachys', 'Thrishads', 'Bell', 'Raygras', 'Mnsingen', 'Agrostis', 'Turf', 'Tetragonolobus', 'Ayena', 'Yei', 'Ser', 'Gaud', 'Seihofenmoos', 'Buchenwald', 'Mikro', 'Corallorrhiza', 'Perlkraut', 'Sense', 'Striten', 'Botrychium', 'Cavanilles', 'Robinie', 'Fussweg', 'tuberosa', 'Willd', 'Wiesenknigin', 'M.Buchsecwald', 'Bargen', 'Apfelbaum', 'Scilla', 'Knizstrasse', 'Schreber', 'Schermenwald', 'Salicaceen', 'M.Buchseemoos', 'Uromyces', 'Btschelbach', 'Setaria', 'Welschkorn', 'Deronospora', 'Taraxacum', 'Cydllia', 'Scopoli', 'Thlaspi', 'parviflora', 'Bruuch', 'Liebefeld', 'Teichbinse', 'Krauehthal', 'Brombeere', '- wald', 'Reg', 'Lysimachos', 'Zinnia', 'Cadoglossum', 'Bethlehem', '- rain', 'Mono-Digynia', 'Linne', 'Chlm', 'Thurnen', 'Hahnenfuss', 'labra', 'Santalaceen', 'Traganth', 'arvense', 'Sssdolde', 'Oberbalm', 'Aceraceen', 'Dichasien', 'Plantago', 'Mikrosporangien', 'Ober-Lindach', 'Kl.Wabern', 'Diadelphia', 'Gummersloch', 'Mispel', 'Krauchthalalp', 'Grauholz', 'Weissdorn', 'Clematis', 'Cucurbita', 'Saponaria', 'Cardon', 'Ahorn', 'Ulmaria', 'Emmoschachen', '- tigen', '- hofen', 'Utzigen', 'Rapistrum', 'Schosshaldenholz', 'Portulacaceen', '- moos', 'Leguminosen', 'Aim', 'Bth', 'Akelei', 'Cypergras', 'Stitt', 'Aktenbeere', 'Rispe', 'Papaver', 'Sanas', 'Weinhalde', 'Araliaceen', 'Aav', 'Senecio', 'Bachbummeln', 'Ehrhart', 'Montie', 'Birola', 'Var', 'Trkenkoni', 'Stadtbach', 'Prinvulaceen', 'AspUmium', 'Crassulaceen', 'Myrtaceen', 'X.Amerika', 'N.Amerika', 'S.Amerika', 'Gsteig', 'Wiesenknigin, ', 'M.Seedorf', 'Grisebach', 'Stndentenrsehoii', 'Wulf', 'Knterich', 'Weiderich', 'Help', 'Aetliusa', 'rubra', 'Oxalidaceen', 'Chrysosplenium', 'Matzenried', 'AViesen', 'Torilis', 'Belpbcrg', 'Dld', 'Panicum', 'Torfmooren', 'M.Buchseewald', 'Bodenacker', 'Streifenfarn', 'K.Amerika', 'Hun', 'Cargophyllaceen', 'Evonymus', 'Nelke', 'Conium', 'Gmligenmoos', 'Cotoneaster', 'Tanacetum', 'Khlewylegg', 'eissenstein', 'TTpayiovo', 'Wiesel', 'F.ssigbaum', 'Inula', '- sporen', 'Rubus', 'Violaceen', 'Uhnizberg', 'Aarufer Aardamm', 'rudim', 'Riederen', 'Laburnum', 'Crdccct', 'Rhynchospora', 'Marrubium', 'Aprikosenbaum', 'Gmligen', 'Beauvois', 'Berteroa', 'B.Rosetten', 'Chlorophyll', 'Polygonaceen', 'W.Asien', 'Aceras', 'Sparganium', 'Digynia', 'Szhlig', 'Brenklau', 'Kniz', 'Loran', 'Pfriemcnstrauch', 'Baumgarten', 'Va', 'K.Lindach', 'Birke', 'Lila', '- wyl', 'Julienne', 'Ribes', 'Alchemilla', 'Negundo', 'Silene', 'Arrhenatherum', 'Di-Trigynia', 'Spargelerbse', 'Corylus', 'Poltjgonaceen', 'Ilasli', 'Seedorf', 'Sevenbaum', 'S.Europa', 'gwald', 'Ackersenf', 'Schwavzwassevthal', 'Portulaca', '- thal', 'Reggisbevg', 'Spinacia', 'Meven', 'Calluna', 'Sinau', '- inoos', 'Thysselinum', 'Succisa', 'Rieh', 'Mangold', 'Forst', '- dorf', 'Thesium', 'Spiranthes', 'ThuilUer', 'Nestwurz', 'Schotenklee', 'Nelkenwurz', 'Alopecurus', 'Grind', 'Grabowski', 'latifolia', 'Ohnhorn', 'Augentrost', 'rubra Lam', 'Petersilie', 'Sesleria', 'Petrosolinum', 'Potamogetonaceen', 'Circma', 'Erucago', 'Cuscuta', 'Meierysli', 'intermedia Vill', 'Strassentunnels', 'Bantiger', 'Reichenbachweg', 'Drosera', 'Solrtiwald', 'Berle', 'Buxus', 'Riviniana', 'Fanu', 'Strauch', 'Thymus', 'Steinsame', 'Jf.Amerika', 'Johannisbeere', '/', 'Strandling', 'Moosbeere', 'Palmdorn', 'Withering', 'Diessbach', 'Gmligenberg', 'Besenheide', 'Ober-Muhlercn', 'Cav', 'roseum', 'Brem', 'Thuja', 'Oltigen', 'B.Rosette', 'Tetragynia', 'Goodenough', 'Mnchenbuchsee', 'Gramineen', 'Jennershaus', 'Keueneck', 'Brachypodium', 'Mohn', 'Bromus', 'Dahlenwald', 'Sisymbrium', 'Bsclii', 'Asplenium', 'Saarbaum', 'Echium', 'Rabenhorst', 'Goodyera', 'cylin', 'Jjaubberg', 'Polygam', 'Ferrenberg', 'Brown', 'Lyssbach', 'Capland', 'Oschwand', 'Khweid', 'Beta', 'jM.Buclisee', 'Thierlibaum', 'Frienisberghhe', 'Nessel', 'Juglans', 'Sporen', 'Maiglckchen', 'Gundelrebe', 'Birnbaum', 'Andrz', 'Phyteuma', 'Gandin', 'Kig', 'Pa', 'S.O.Europa', 'Scabiosa', 'Berberitze', 'Polygonatuin', 'Scop', 'Hornstrauch', 'Crataegus', 'Tamus', 'Hainbuche', 'Beauv', 'Ahlkirsche', 'Ortschwaben', 'Alant', 'Srbus', 'Ittigen', 'Knizbei', 'Asparagus', 'Radeltingen', '- ligenberg', 'Allioni', 'Aristolochia', 'Besenstrauch', 'Thun', 'Circaea', 'Knizberg.678', '- berghhe', 'Deutschland', 'Polygynia', 'Gaudin', 'Wahlenberg', 'rothbraun KronB', 'Lungenkraut', 'Lysimachia', 'Egghlzli', 'Melone', 'Myriophyllum', 'Ginster', 'Sporangien', 'Schoenus', 'Andrzeiowski', 'Margritli', 'Sollrtiwakl', 'Litorella', 'Btschelegg', 'Nord-Amerika', 'Gmligonmoos', 'Tiefenauwald', 'alpina', 'Granatum', 'Wegdorn', 'Seegras', 'Amaryllidaceen', 'Coi onilla', 'Aegopodium', 'tomentsa', 'Stockerensteinbruch', 'Molassefelsen', 'Osterluzei', 'Parnassia', 'Phegopteris'}",1007,"{'Fumaria', 'Stieg', 'Borstengras', 'Prunus', 'Gurteiithal', 'Yom Berge', 'Sesleria Setaria Sherardia', 'HüllB', 'DeckB Jun', 'Lobsigensee Off', 'Adenostyles', 'KronB EMai', 'Dipsacus', 'Alisma', 'Wylerhlzchen', 'Btschel', 'Bern Burgdorf Aarberg', 'Amelanchier', 'Mattenhof', 'Girisberg', 'Heleocharis', 'Rhinanthus', 'Yerbascum', 'Adoxaceen', 'Thalgut', 'Persoon', 'Grbe', 'Sedum', 'Var stellata', 'Pimpinella', 'Eberwurz', 'Aarberg Periclymenum', 'Zziwyl.689', 'Soyer-Willemet', 'Yiburnum', 'Dianthus', 'Bern Belpberg', 'KLindach', 'Gnrtencorf', 'Sclireb', 'Vechigenmoos', 'Yeronica', 'Reggisberg', 'Burgdorf Torfmoor', 'Schaftelen Schafthalm Schaftheu Schalotte Scharbockskraut', 'Beifuss', 'Hanf', 'germanica', 'Bellardi', 'Mertens', 'Rippenfarn', 'Platterbse', 'Orobanche', 'Swartz', 'Baldrian', '- briiche', 'seewald Lyss', 'Bergrose', 'Fr', 'Miinsingen', 'Willcl EMai', 'Liebesapfel', 'Carciflia', 'LaurierTin', 'Bern Gurten', 'Carum', 'OberMuhlercn', 'Ammer', 'Rosa', 'Schrder', 'Haller', 'Alpenbäche', 'Binse', 'Amselberg', 'Sympliytum', 'Kronß', 'Cycadinae', 'Rutaceen', 'Salep Gymnadenia', 'AVohlcn', 'Monogynia', 'M.Bucksee', 'Lyss der Sense', 'Könizbergwaldes', 'Bittersüss', 'Goldstriten', 'Tunica', 'Reichenbach Bodenacker', 'Wermut', 'Kandergrien', 'Podagräria', 'Ocimum', 'Geranium', 'Odermennig', 'Gümmenen', 'Cannabacecn', 'Trilis', 'Hypochoeris', 'Mülilethurnen', 'Bern Eiholz', 'Peiitandria', 'HK', 'Briza', 'Frsterliaus', 'Malachium', 'Betula', 'Ankenblmli', 'Palisot', 'Solidago', 'Sherardia', 'Verbenaceen', 'Scorzonera', 'Safran', 'Moehringie', 'Saxifraga', 'Aarberg der Emme', 'Yincetoxicum', 'Beselireps', 'Kautzenhubel', 'Picris', 'Könizbei', 'Aeste', 'Bolligen', 'Pestwurz', 'Knautia', 'Yicia', 'RoMnia', 'Carp', 'Boiligen', 'Galium', 'Bantiger Oschwand', 'Laupen Aare', 'S.Russland', 'Schlossfelsen', 'Heide', 'Tschuggen', 'Caltha', 'Atticli', 'Mühlethal', 'rosettig', 'Grossuläria', 'Mavkirch', 'Brentraube', 'Kirchlindach Kadelflngen', 'N.Sclierli', 'Betulaceen', 'MBuchseewald Burgdorf Dryopteris Fee öpüc Eielie Aspidium Dryopteris Bcmm', 'Ful', 'Willdenow', 'Lerchensporn', 'Gummihubel', 'Peplis Portula', 'Ervmn', 'Bern Stadtbach', 'Masholder', 'St.B', 'Spec', 'Jkantig', 'Utricularia', 'Juncaceen', 'Zahmkirsche', 'Ajuga', 'Gbelbach', 'Adlerfarn', 'Amarantus', 'Sinapis', 'Aira', 'Buvgdovf Radelfingen', 'Laufenbad', 'Yettonica', 'Sauerdorn', 'Btsehelegg', 'Robinia', 'Schloss Wyl', 'TriPolygynia', 'Krauchthal Tanne', 'Sagina', 'Pisum', 'Pastinak', 'Ulmizberg.933', 'Schwalbenwurz', 'Wylerfeld Gummersloch', 'Solrti', 'Stocheren', 'Oberburg der Emme', 'Frringf', 'Armeniaca', 'Vitaceen', 'Riedburg Fussweg', 'Didynainia', 'Lantdna', 'Biembacli', 'Timothegras Tintenbeere', 'Thörishaus', 'Maulbeerbaum', 'Sandboden', 'Melisse', 'Ankenblli', 'St. stig', 'Ballenbhl', 'Belpbergs', 'Keueneck Stitt', 'Crantz', 'Trigynia Gif', 'Heracleum', 'Tetradynamia', 'Sapindaceen', 'Lemna', 'Schlipfen', 'Anemone', '- bacli', 'Lwenmaul', 'Hrnberg.920', 'Bodenst.B', 'Bern Bundesrathhausterrasse', 'Braunwurz', 'Schlossberg', 'Kiel', 'Hecken', 'Mhleberg', 'Coriandrum', 'Grossulria', '^', 'Milzkraut', 'Taxaceen', 'Burgdorf Aarberg', 'Sambucus', 'M.Bucbsee', 'Btli Btli', 'Dioscoreaceen', 'Giirbe', 'Happig', 'St. rosettig', 'Felsenau Tiefenaubrückc', 'Scop St', 'Kautzen', 'Grten', 'Burgdorf Riggisberg', 'Bern Thanwald', 'Reithgras', 'Küeggisbergegg', '- briieke', 'Glyceria', 'Burgdorf Coriandrum', 'S.Afrika', 'Kohl', 'Rhamnus', 'M.Seedorfsee', 'Asperula', 'Aavberg', 'Corona', 'Lyss Burgdorf', 'Helvetia', 'Büsclii', 'Glatthafer', 'Bth.Bodens', 'Engewald MBucli', 'Holl', 'Baden', 'Reggisbergegg', 'Medien', 'Hünigen', 'FlugHafer', 'Fssigbaum Fr roth', 'Römer', 'Lois', 'Gypskraut', 'Bern Walkringenmoos', 'Belpberges Girisberg', 'Buchseemoos', 'Alyssum', 'Haselnuss', 'Ufevge', 'NSclierli', 'yuvayyr', 'Vill', 'Bern Bremgarten', 'Lampsana', 'Sonchus', 'Xanthium', 'Cupressaceen Cupuliferen Cuscuta', 'Frieswyl', 'Platanthera', 'Eberesche', 'Knaulgras Knoblauch Knopfgras Knotenblume Knöterich', 'Ononis', 'Hartheu', 'Reseda', 'Eupatorium', 'Trimstein', 'Köniz Bubenberg Schwarz', 'Wallroth', 'Salisbury', 'Schlossfelsen Aarberg', 'Krätzkraut', 'Zea', 'Angelica', 'Majoran', 'DiTrigynia', 'Samstalwald', 'Rubiaceen', 'mollis', 'Araceen Araliaceen', 'Schwarzdorn', 'Tetrandria', 'Luzerne', 'Lngenberg', 'Knopfgras', 'Karben', 'Bupleurum', 'Nopota', 'Atriplex', 'St.Glied', 'Hunzikenbrcke canina', 'Kanarienhirse Karde', 'Herbstrose', 'Thorberg Burgdorf', 'Fvienisbevg', 'Aparine', 'Ophioglossaceen', 'cathrtica', 'Faba', 'atrata', 'Cumarin', 'Zollikofenwald', 'Di-Pentagynia', 'Vill St', 'Scutellaria', 'Bzhlig Dolden', '- tenthal', 'Burgdorf Thorberg', 'Callitriche', 'Biitsclielegg', 'Artischoke', 'Riedgras', 'Blasenfarn', 'Uromyces Pisi', 'Goa', 'Fetthenne', 'Oxalis', 'Nessel Nestwurz Niele', 'Niederlindach', 'Rainfarn', 'Steinkirsche', 'Lhr', 'Platanus', 'Könizbergwald', 'Rncligras', 'Lindenthal', 'Callitrichaceen', 'A.Lindachwald', 'Waldrand Ostermundigen', 'Vogehvicke', 'Kiesgruben', 'Belpberg Gerzensee', 'Bern Sollrütiwakl', 'Beitenwyl', 'St WStock', 'WAsien', 'Stdcliys', 'Pirol', 'Oesterreich', '- egg', 'Weyermannshaus', 'Secare', 'Brenried', 'Baumtropfen', 'Beckig', 'Arum', 'Bims', 'Wylerhölzchen', 'Aarberg Lyss', 'Ceratophyllum', 'Bibern', 'Waldrand', 'Kreuzdorn', 'Beinwurz', 'Dodecandria', 'Wiesen', 'Rothtanne', 'Brassica', 'Gümligen MBuchseemoos Hindelbank Burg', 'bevg', 'Schüpfen', 'Salicuria', 'ZitrÖsli, SLOC', 'Brw', 'Rhododendron', 'Zehendermtteli', '- brck', 'Beitemvyl', 'Engewald Muri', 'Riedburg', 'Oryza', 'Burgdorf Gsteig', 'Monadelphia', 'Loranthaceen', 'Alismaceen', 'Cicer', 'Taxus', 'Rosette', 'Enzian', 'Sibth', 'Bern Burgdorf', 'Roth St', '-', 'Hausset Hauswurz', 'Bbtli', 'montana montana Gaud', 'Nüsslikraut', 'Farn', 'Topinambur', 'Pers Strauch oval', 'Linde', 'Gurtendorf Ulmizberg', 'Koch', 'Solrüti', 'Sumpf', 'Taumellolch Triimmel St', 'Grilnibach', 'Scluitt', 'Allium', 'Mainz', 'Gur', 'Monandria', 'Hilllspelze', 'Blasenfarn Bocksbart', 'Khlewylwald', 'Mlilethurnen', 'N.Lin', 'Scliwanz', 'Feldahorn Masholder', 'Typha', 'Sccndola', 'Bodenacker Wylerfeld', 'Rainkohl', 'Cynoglossum', 'Belpberg Gerzensee Rüeggisberg', 'Borkhausen', 'Klette', 'Münsingen', 'M.Seedorfsees', 'Aesculus', 'Yar St', 'Bern Belpmoos Aardamm Längenberg', 'Gleisse', 'Cannaba', 'Chaerophylium', 'Camelina', 'S.Sibirien', 'Englisbergwald Bütschel', 'Araceen', 'Delphinium', '- mooses', 'Pulicaria', 'Torfmoor', 'Wimm Grab', 'Münchenbuchsee', 'Portulak', 'Fennich', 'Wedel', 'Waldau', 'Waldstein', 'Fries', 'St. holzig', 'Thörishaus Zollikofen', 'Habermark', 'Potentilla', 'Kuhkraut', 'Bauernsenf', '- berg', 'Trauben', 'Mimsingen', 'AYas', 'Lam Ohne', 'Tlieil', 'Dählhölzli Waldrand', 'Lamarck', 'Iiunziken', 'Sanddorn', 'Hippophae', 'Schuhes', 'Mhlethal', 'Holligen Brem', 'Köniz MBuchsee', 'Anthemis', 'Knizbergwald', 'Uliswyl', 'Fam', 'Aarberg M', 'Zilang', 'Belpberges Ferrenberg', 'Yill', 'Malve', 'Sollrütiwald', 'Köniz Ruhigen Kirchdorf', 'Scirpus', 'Lob', 'Adoxa', 'Belpinoos', 'Karbe', 'Ruta Ruta Raute', 'Sclirad', 'Keubriicke', 'Ceratophylluin', 'Ankenblümli', 'Monotropa', 'Sanguis', 'Belpberg N', 'Aveiss', 'Knaulgras', '- sigensees', 'Emmer', 'Onobrychis', 'Good', 'Seringe', 'Bern Belpmoos Burgdorf', 'Mais', 'Thracien', 'Btli', 'Glasbrunnen', 'Hachen', 'Cichorium', 'Stachys', 'Thrishads', 'Bell', 'Tetragonolobus', 'Ser', 'Seihofenmoos', 'Perlkraut', 'Belpberg AViesen', 'Striten', 'Gurtenthal Belpmoos', 'Diessbach Längenberg', 'Cavanilles', 'Anm arcensis', 'Fussweg', 'Idappiq', 'Wiesenknigin', 'Scilla', 'Schreber', 'Schermenwald', 'Köniz Ulmizberg', 'Uromyces', 'Btschelbach', 'Setaria', 'Welschkorn', 'Buchsee Lyss Thorberg', 'Taraxacum', 'Scopoli', 'Espe Fadenkraut', 'MBucksee', 'parviflora', 'Liebefeld', 'Teichbinse', 'Brombeere', 'Reg', 'Lysimachos', 'MBuchsee', '- rain', 'Bärenried', 'Hahnenfuss', 'Frienisberghöhe', 'Gummersloch Gurteiithal Längenberg', 'arvense', 'Sssdolde', 'Aceraceen', 'Mikrosporangien', 'Kl.Wabern', 'Schönbühl', 'Diadelphia', 'Gummersloch', 'Mispel', 'Grauholz', 'Weissdorn', 'Worblen', 'Plätaiius Platane Xxtuc', '- hofen', 'Utzigen', '- moos', 'Vitt Chlorocrepis', 'Leguminosen', 'Ayena Ballota', 'Bth', 'Akelei', 'Stitt', 'Hiillchen', 'Bümpliz', 'Aktenbeere', 'Rispe', 'Papaver', 'Borstengras Braunheil', 'Araliaceen', 'Borstendolde', 'Bachbummeln', 'Birola', 'Var', 'Trkenkoni', 'Stadtbach', 'Rüeggisberg', 'AspUmium', 'N.Amerika', 'Bern Gurtenthal', 'Könizstrasse', 'Wiesenknigin, ', 'Münze', 'Grisebach', 'Stndentenrsehoii', 'Knterich', 'Belpberges Yecbigenmoos MBuchseemoos', 'Aetliusa', 'rubra', 'Chrysosplenium', 'Steinlinde', 'Dolde', 'Zeliendermätteli', 'Matzenried', 'Yar', 'Var cristatum Milde', 'M.Buchseewald', 'Bodenacker', 'Streifenfarn', 'Köniz', 'K.Amerika', 'Hun', 'Riedgras Rippenfarn Rispengras Rittersporn', 'Rapiinzli', 'Cargophyllaceen', 'Evonymus', 'Nelke', 'Gmligenmoos', 'Cotoneaster', 'Tanacetum', 'Wiesel', 'Dählhölzli', 'Weinrose', 'Inula', 'Melandryum', 'Schierling Conium', 'Tannenwald Ulmizberg Buchenwald', 'Uhnizberg', 'Hinterkappelen MBuch', 'Riederen', 'Marrubium', 'Aprikosenbaum', 'Gmligen', 'Berteroa', 'B.Rosetten', 'Chlorophyll', 'Lauterbach Samstalwald', 'W.Asien', 'Aceras', 'Weyermannshaus Gramineen', 'Digynia', 'Szhlig', 'Brenklau', 'Landorf Landers', 'Kniz', 'Pfriemcnstrauch', 'Va', 'K.Lindach', 'BthStandes', 'Birke', 'Lila', 'Julienne', 'Grauholz Oberburg', 'Ilasli Holligen', 'Bolligen MBuchsecwald', 'Felsenau Dählhölzli Muri Weg', 'Windfahne Windhalm Windröschen', 'Arrhenatherum', 'Di-Trigynia', 'Corylus', 'Poltjgonaceen', 'Ilasli', 'gwald', 'Ackersenf', 'Portulaca', 'Malvales', '- thal', 'Reggisbevg', 'Spinacia', 'Calluna', 'Anethum Dil', 'Thysselinum', 'Mangold', 'NordAmerika', '- dorf', 'Thesium', 'Dentenbevg', 'Spiranthes', 'ThuilUer', 'Nestwurz', 'Schotenklee', 'Milz', 'latifolia', 'KAmerika', 'Augentrost', 'rubra Lam', 'Sesleria', 'StBasis', 'Erucago', 'Cuscuta', 'Meierysli', 'Bantiger', 'Solrtiwald', 'Buxus', 'Strauch', 'Thymus', 'Jf.Amerika', 'Johannisbeere', '/', 'Mannagrütze', 'Moosbeere', 'Bern Bremgartenwald', 'Bern Torfmoor', 'Gmligenberg', 'Besenheide', 'Cav', 'Burgdorf Schüpfen', 'roseum', 'Hypericaceen', 'Brem', 'Oltigen', 'B.Rosette', 'Aarberg Burgdorf', 'Schilf', 'Mnchenbuchsee', 'Cystöpteris', 'CAMPYLO', 'Ehrh ulmifolia', 'Brachypodium', 'PapiUonaceen', 'Mohn', 'Belpberg Thurnen Gurtenthal Ulmiz', 'Bromus', 'Dahlenwald', 'Sisymbrium', 'Asplenium', 'Saarbaum', 'Burgdorf Bargen', 'Goodyera', 'Zimmerwald Kirche', 'Bllvr', 'Krauchthal Burgdorf', 'Gürbe', 'Jjaubberg', 'Brown', 'Dioscoreaceen Diplotaxis', 'Capland', 'Lyss Gramineen Nerven', 'Lam St Antonskraut St', 'Ilunzikenbriicke', 'Oschwand', 'Khweid', 'Thierlibaum', 'Frienisberghhe', 'Nessel', 'Juglans', 'FrFleisch', 'Maiglckchen', 'Birnbaum', 'Corallorrhiza Coriandrum', 'S.O.Europa', 'Polygonatuin', 'Perlgras Perlkraut', 'Scop', 'Hornstrauch', 'Burgdorf Schlossberg Thorberg Myrrhis Süssdolde abpp Myrrhe', 'Tamus', 'Belpberges Bütschel', 'Mühleberg', 'Saxifraf', 'Ahlkirsche', 'Ortschwaben', 'Srbus', 'Ittigen', 'Saumfarn', 'Radeltingen', 'Bethlehem Gurten', 'Allioni', 'Aavberg TliysseliTmiii', 'Besenstrauch', 'Thun', 'Circaea', 'Knizberg.678', 'KlAsien', '- berghhe', 'Holl Bärenried', 'Lungenkraut', 'Arve Atticli', 'Schoenus', 'Andrzeiowski', 'Margritli', 'Arctostäphylos', 'Sollrtiwakl', 'Nord-Amerika', 'Anm Gärten', 'Tiefenauwald', 'alpina', 'Zollikofen Jjaubberg', 'Wegdorn', 'Seegras', 'Coi onilla', 'tomentsa', 'Stockerensteinbruch', 'Molassefelsen', 'Arnpelopsis', 'Diaudria', 'Thymian', 'Waldrndern', 'MENYAN', 'Ruta', 'MSeedorfsee', 'Rosskastanie', 'Aecker', 'Populus', 'Oleaceen', 'vulgaris', 'Picea', 'Salix', 'Ampfer', 'Silau', 'Schwelle', 'Buvgdovf', 'Parnassus', 'Köniz Längenberg', 'Draba', 'Hirschdorn', 'Heiteren', 'Genista Ginster St', 'Hunzikenbrücke', 'Kehrsatz Zimmerwald', 'Ulme', 'Maiblume', 'Sonnenthau', 'Aare Radelfingen', 'Cystopus', 'SAsien', 'Smith', 'Döll Habermark St', 'Hieracium', 'Gurke', 'Ballota', 'KlWabern', 'Längenberg', '- zikenbriieke', 'Grosshchstetten', 'Polypodium', 'Yechigen Kig', 'Furnariae', 'Icosandria', 'Borretsch', 'Wabern Wylerhölzchen', 'Jura Phegöpteris Buchenfarn Buche', 'Schuttes', 'Dalmazi', 'Holligen Felsenau', 'Carex Carlina', 'Yinca', 'Stbf Röhre', 'St. Metern', 'Burgdorf Niederlindach Lobsigen Radelfingen', 'Segge', 'Filipendula', 'Avieder', 'Belpmoos Aardamm', 'Sanguisorba', 'Farsetia', 'violettroth', 'Galeopsis', 'Solanum', 'Monöcisch', 'Farbkraut', 'Dhlhlzli', 'Chivon', 'Pippau', 'Gerzensee Burgdorf Radelfingen', 'Lwenschweif', 'AspUmium Milzfarn', 'Kresse', 'Muri Stein', 'Bremgartenwald MBuchsee', 'Mcehringia', 'Sibthorp', 'Sclnvarzwasserthal', 'Leibschmerz Stock', 'Steinmispel', 'Steinbrech Saxum Fels', 'Sameula', 'Bubenberg', 'Lieschgras', 'Specularia', 'Grab', 'Lyss Zollikofen', 'Engelsss', 'Scl', '- Muhleren Belpberg', 'Mnch', 'Gremii', 'Faulenmatt', 'Wylerfeld Gurtenthal', 'Tragopogon', 'Bern Kehrsatz', 'Schpfen', 'Poa', '- gartenwald', 'Sir Sterile', 'Reichenbach Radelfingen', 'Gevzensee', 'Uettligenwald', 'Burg', 'Typhaceen', 'OberLindach', '0.Indien', 'Bern Muristalden', 'Utes St', 'S.Asien', 'Schwarz', 'Whlst', 'Plantaginaceen260', 'BthStand', '0Europa', 'Ornitliogalum', 'Ostermundigenberg', 'M.Buclisee', 'Moosseedorf', 'Wylerhölzchens', 'Schwarzwasserbrcke', 'Convolvulaceen', 'Pent-Octandria', 'Rettig', 'Lolch', 'Rispengras', 'Lttigcn', 'Landers', 'Irippig Scheinquirle Szählig silvaticum St', 'Köniz Fussweg', 'Resedaceen', 'Immergrn', 'Biitschelbachthal', 'Uhus', 'Biglen', 'Sssgras', 'W.Stock', 'SEuropa', 'Giimligenmoos', 'Grmsch', 'Portula', 'Timothegras', 'Radieschen', 'Oberburg Gasei', '- steinbruch', 'Tannenwald', 'Achillea', 'Oxycoccos', 'Bartgras', 'Aira Ajuga', 'Lauchkraut', 'lutAola', 'Weidenrschen', 'Xatterzunge', 'Elteaijniis', 'Bocksbart', 'Yalerianella', 'Hesperis', 'Kiesenbach', 'Hasenlattich', 'KebenB', 'Melica Melilotus', 'Betonio', 'Breitklbchen', 'Niele', 'Buchenfarn', 'Könizberg', 'Alcea Verschieden', 'Ophrys', 'M.uchseemoos', 'foetida', 'Lhrmoos', 'Mhlethurnen', 'Seihofenmoos OAbhang', 'Nees', 'Längenberg Meven', 'Sclnneerwurz', 'Onertig Aehrchen', 'Rapa', 'Krauchthal Kühweid', 'farinosa', 'Sinngrün', 'Zehendermättoli', 'Maximowicz', 'B.Scheiden', 'Bth.Trauben', 'Rutamuraria', 'Prenanthes', 'N.Scherli', 'Punica', 'Mollii St Jkantig', 'Polygonum', 'Drakau', 'Ophioglossum', 'Burgdorf Samstalwald', 'Convallaria', 'Mrzglckchen', 'Haargras', 'Längenberg N', 'Egelmoos', 'Sandrain', 'Bärlapp Bauernsenf', 'Bergföhre Bergrose', 'Polium', 'Convallaria Convolvulaceen', 'Wimmer', 'Pentagynia', 'KZähne', 'Alsine', 'Colchicum', 'Ibsclio', 'JNeuenegg', 'Garcke St kahl', 'Bittersss', 'Leindotter', 'Agrostemma', 'Oltigen Pneumonunthe', 'intermedia', 'MSeedorf', 'DeclcB', 'Akazie', 'Meertriibeli', 'ArGia', 'Troll', 'Sori', 'Pedicularis', '- gisherg', 'Dählhölzli Bremgarten', 'Primulaceen', 'Chelidonium', 'M.Buchsee', 'Birke Bisamhyacinthe Bitterklee', 'MBuchseewald Grauholz', 'Tri-Polygynia', 'Tanne', 'TöTpayiovo', 'Lenne', 'Brlapp', 'Pastinaca', 'Könizbergwald Waldrand', 'Ammer Ankenbälli', 'Schwarzwassorthal', 'KScherli', 'Stbf', 'Digitalis', 'Emme Sense', 'Kirchdorf', 'Süssgras', 'Langacker Gümligen', 'Bern Sanguisörba', 'Straussgras', 'Thorberg', 'Peplis', 'Ulmaceen', 'Kies', 'Stein', 'PentOctandria', 'Perlgras', 'Sanguisrba', 'Lathreea', 'Ober-Muhleren', 'Caucalis', 'Huds', 'Kirchberg Emme Biglen', 'Oberburg Lochbach', 'Bern Waldrand Eiholz', 'Crepis', 'Hainsimse', 'Rhamnazeen', 'Zziwyl', 'Biitschelegg', 'Reithgras Rempe', 'Bern Muri Jaberg', 'Knizberg', 'Wimm', 'KapselFr', 'Sauerbeere', 'WiUd St', 'Gm', 'Capsa', 'Podagrria', 'Myrrhis', 'Tetragonlobus', 'Bern Dählhölzli', 'Blechnum', 'Guvtenthal', 'Bth.Stand', 'Egghölzli', 'Harzes', 'Tofieldia', 'N.Seite', 'Keggisberg', 'Kiitzing', 'Galeobdolon', 'Hunzikenbriicke', 'Polypodiazeen', 'Nacktdrüse Nägeli', 'Tiliaceen', 'Boiligen M', '0.Europa', 'NebenB', 'Yiola', 'Knoblauch', 'Emmeschachen', 'Petasites', 'Durheim', 'Sarothamnus', 'Datura', 'Crocus Cruciferen', 'Yillars', 'Paris Parnassia', 'Ledihhe', 'Xelkomvurz', 'Gmmenen', 'Hippocrepis', 'Tannmark', 'Pollich St', 'Polygalaceen', 'Milzfarn', 'Elseagnaceen', 'Engler', 'Buchsee Burgdorf Radelfingen', 'Jircaea', 'Thrishaus', 'Cannabis', 'Aug Grben', 'Bern Weinhalde', 'MBuchseemoos', 'Buta', 'Keggisbergegg', 'Weiden', 'Syngenesia', 'Polygamia', 'Tpfelfarn', 'Gnsel', 'Lwenzahn', 'Arve', 'Goldrutbe', '- zikenbrcke', 'Potamogeton', 'Amarant', 'Tilia Tilia', 'Rchb', 'Sollrtiwald', 'Küeggisberg', 'Hopfenidee', 'Raphanus', 'Euphorbice', 'Fromental Froschlöffel Fuchsschwanz Gamander', 'Aconitum', 'Sauerklee', 'Zollikofen Uliswyl', 'BthZeit', 'Betnica', 'Schwarzkorn', 'NScherli', 'Sorbus', 'Schachtelhalm', 'Gümligonmoos', 'Koch Kahl', 'Roggen Rohrglanzgras', 'Linse', 'Vicia', 'Graslilie', 'Robert', 'Amaryllidaceen Amelanchier', 'SteinFr', 'Lam', 'Steinbrck', 'Kl.Asien', 'Yecbigenmoos', 'Neubrckstrasse', 'Mistel Mohn', 'BRosetten', 'Tintenbeere', 'Bethlehem Hin', 'Lythrum', 'Minze', 'Flühe', 'Bodenacker Gurten', 'Muristalden', 'Gerzensee Burgdorf', 'Ghaerophyllmn Myrrhis', 'Wohlen', 'Schllkraut', 'Pers', 'Burgdorf Weg', 'Koriander', 'Wabern der Aare', 'Jasione', 'Kühlewylwald', 'Thuill', 'Iberis', 'Kalmus Kamille', 'Steinhlzli', 'Narcisse Natterkopf', 'Brzelenholz', 'Lindleg', 'Glanzgras', 'Cucumis', 'Köniz Belpberg', 'Dryopteris', 'Polygala', 'Wulfen', 'Bidens', 'St.Basis', 'Bilsenkraut', 'Tormentllla Schrcmk', 'Bärenklau', 'Lockerrasig', 'St.', 'Bmpliz', 'Burgdorf Lobsigensee', 'Avena Französisches Raygras Fromen', 'Heliantlius', 'Burgdorf MBuchsee', 'Meerrettig', 'SSibirien', 'Chrysanthemum', 'Serratula', 'Maykirch', 'Ulmiz', 'Niederlindaehwald', 'Bern Aarberg', 'Ainus', 'Hainbuche Hainsimse Hanf Hanfnessel', 'KZipfel', 'Weisstanne Weizen Welschkorn Wercli', 'Neottia', 'Yar EMai', 'Convolvulus', 'Diemerswyl', 'Secale', '- Mulderen longiflia', 'Jussieu', 'Malva', 'Chrosle', 'Silan', 'Melde', 'Kabis', 'Bütschelegg', 'Zäziwyl ArGia', 'Doronicum', 'Aug', 'Periclymenum', 'Ascherson', 'Saunifarn', 'Lysimachia Lvsimachie', 'Bern Reichenbachweg', 'EuphorMaceen', 'Antonskraut', 'Belpberg Thanwald', 'Köniz Bremgartenwald', 'Schnbhl', 'Wabern Muri', 'Nuphar', 'Raygras', 'Mnsingen', 'Agrostis', 'Turf', 'Ohnhorn Osterluzei Palmdorn', 'Ayena', 'Yei', 'Mikro', 'Gaud', 'Buchenwald', 'Mercurialis', 'Desr arvensis IVallroth St', 'Corallorrhiza', 'Sense', 'Solrütiwald Engehalde Gur', 'Botrychium', 'Robinie', 'Güterbahnhof', 'Frienisbergliöhe', 'Jun Hecken', 'tuberosa', 'Willd', 'Köniz Forst', 'M.Buchsecwald', 'Bargen', 'Apfelbaum', 'Knizstrasse', 'Salicaceen', 'M.Buchseemoos', 'Trrspov', 'NLindachwald', 'MBuclisee', 'Tcixa', 'Rupreohtsk', 'Deronospora', 'Cydllia', 'Thlaspi', 'Bruuch', 'Krauehthal', '- wald', 'Zinnia', 'Cadoglossum', 'Bethlehem', 'Mono-Digynia', 'Linne', 'Chlm', 'Lochbach Rappenfluh', 'Bantiger Radelfingen', 'Thurnen', 'Buxaceen Bth', 'labra', 'Seedorf Radelfingen', 'Santalaceen', 'Bern Altenberg Marzili Aarberg', 'Traganth', 'Oberbalm', 'Bern Felsen', 'Ziegelhütte', 'Oltigen Aare', 'Dichasien', 'Börstel', 'Plantago', 'Ober-Lindach', 'Krauchthalalp', 'Clematis', 'Ahorn', 'Cucurbita', 'Saponaria', 'Cardon', 'Emmoschachen', 'Ulmaria', '- tigen', 'Rapistrum', 'Kornblume rothe', 'Schosshaldenholz', 'Portulacaceen', 'Papiermühle', 'Aim', 'Cypergras', 'Weinhalde', 'Sanas', 'WStock', 'Hauswurz Semper', 'Aav', 'Senecio', 'Ehrhart', 'Burgdorf BlKr', 'Montie', 'SOEuropa', 'Chenopocliaceen', 'Cyparissias xuapicrrro Cvpresse St', 'Prinvulaceen', 'Crassulaceen', 'Spitzahorn Lenne', 'Myrtaceen', 'X.Amerika', 'S.Amerika', 'Gsteig', 'Ziost', 'M.Seedorf', 'Gümligen Thörishaus', 'Help', 'Wulf', 'Weiderich', 'Oxalidaceen', 'AViesen', 'Torilis', 'Belpbcrg', 'Dld', 'Panicum', 'Torfmooren', 'Balsamina', 'Bern Gümligen', 'Conium', 'Löhrmoos BlKr', 'Khlewylegg', 'eissenstein', 'TTpayiovo', 'Bern Neubrückfussweg', 'F.ssigbaum', 'Burgdorf Lyss', '- sporen', 'Rubus', 'Violaceen', 'Aarufer Aardamm', 'rudim', 'Laburnum', 'Crdccct', 'Rhynchospora', 'Beauvois', 'Roth maoupo Eichhörnchen', 'Azalea', 'Fr comosa St', 'Polygonaceen', 'Sparganium', 'Helleborus', 'Loran', 'Baumgarten', 'zvDoc Blume WStock', 'BeerenFr Berberis', 'Niederlindaehwald Waldrand', '- wyl', 'Ribes', 'Alchemilla', 'Negundo', 'Silene', 'Spargelerbse', 'S.Europa', 'Seedorf', 'Sevenbaum', 'Schwavzwassevthal', 'Meven', 'Sinau', '- inoos', 'Succisa', 'Rieh', 'Forst', 'Bern Schermenwald', 'Försterhaus Waldrand', 'Neubrückstrasse', 'Burgdorf Betönica Betonio Urspr Yettonica', 'Nelkenwurz', 'Grabowski', 'Alopecurus', 'Grind', 'Ohnhorn', 'Petersilie', 'Mäuseklee', 'Petrosolinum', 'Oberburg Thorberg', 'Potamogetonaceen', 'Circma', 'Myriophyllum', 'intermedia Vill', 'Strassentunnels', 'Goodyera Gramineen', 'Reichenbachweg', 'Drosera', 'Berle', 'thal', 'Riviniana', 'Fanu', 'BthStände', 'Engewald Wald', 'Steinsame', 'Hufeisenklee', 'Bern Tannacker', 'Lappa', 'Strandling', 'Lutetia', 'Wollgras Wollkraut', 'Snervig', 'Palmdorn', 'Withering', 'Diessbach', 'Ober-Muhlercn', 'Haargras Habermark', 'Thuja', 'Tetragynia', 'Goodenough', 'Gramineen', 'Jennershaus', 'Keueneck', 'Brie WStock', 'Cotonea', 'MBJ St', 'Thelgpteris', 'Bsclii', 'Echium', 'Rabenhorst', 'cylin', 'Hedera', 'Polygam', 'Ferrenberg', 'Lyssbach', 'BlKv', 'Beta', 'jM.Buclisee', 'Opuntinae', 'Erle Esche', 'Sporen', 'Gundelrebe', 'Steinbrück', 'Andrz', 'Phyteuma', 'Gandin', 'Kig', 'Aehrchen', 'Pa', 'Scabiosa', 'Berberitze', 'Crataegus', 'Löhrmoos', 'Lornaceen Dolden Kronß', 'Hainbuche', 'Cynosürus Kammgras', 'Beauv', 'Zehendermätteli', 'Alant', 'Knizbei', 'Asparagus', '- ligenberg', 'Aristolochia', 'Forst Lobsigensee', 'Steinhölzli', 'Deutschland', 'Polygynia', 'Gaudin', 'Wahlenberg', 'rothbraun KronB', 'Lysimachia', 'Egghlzli', 'Melone', 'Ginster', 'Garcke Fragaria', 'Sporangien', 'Lausekraut', 'Thorberg Trimstein', 'Kiesen der Emme', 'Bern Wylerfeld', 'Litorella', 'Btschelegg', 'Gmligonmoos', 'Buchseemoos Anm Catabrosa', 'Granatum', 'Amaryllidaceen', 'Aegopodium', 'Englisberg Längenberg', 'Mondraute Montie', 'Osterluzei', 'Parnassia', 'Phegopteris'}",1536
15916138,187689,"{'Arles', 'Tirol', 'Augsburg', 'Arona', 'Valencia', 'Oberdeutschland', 'Murten', 'Frankfurt', 'Breisach', 'Freiburg', 'Momferrat', 'Karlsruhe', 'Albi', 'Aragonien', 'Mainz', 'Flandern', 'Memmingen', 'Schwarzenburg', 'Niederrhein', 'Weesen', 'Lyon', 'Salins', 'Adria', 'Frankreichs', 'Berlin', 'Genfs', 'Pcrpignan', 'Diesbach', 'Genua', 'Lausanne', 'Schlettstadt', 'Kempten', 'Morges', 'Sibenzach', 'Provence', 'Schweiz', 'Waadt', 'Lorch', 'Niederlanden', 'Pont dAin', 'Westschweiz', 'Italien', 'Neuenburg', 'Ebda', 'Rom', 'Schaffhausen', 'Kamerach', 'Morsee', 'Baden', 'Bartholomei', 'Winterthur', 'Paris', 'Breslau', 'Savoyens', 'Orient', 'Konstanz', 'Krakau', 'Zurzach', 'Mailand', 'Frciburg', 'Rotenburg', 'Balsthal', 'Burgund', 'Epiphanien', 'Wiedlispach', 'Bern', 'Sevilla', 'Novara', 'Florenz', 'Landau', 'Wangen', 'Desgl', 'England', 'Aargau', 'Ulm', 'Simonsfeld', 'Westdeutschland', 'Bodensee', 'Barcelona', 'Freiburgs', 'LLchelles', 'Flanderns', 'Lissabon', 'Aare', 'Montferrat', 'Mellingen', 'Savoyen', 'Worms', 'Savohen', 'Saragossa', 'Pavia', 'Thonon', 'Schwaben', 'Luzern', 'Stuttgart', 'Hagenau', 'Chablais', 'Solothurn', 'Lreiburg', 'Burgdorf', 'Venedig', 'Frankreich', 'Katalonien', 'Genf', 'Aix', 'Germersheim', 'Italiens', 'Siegburg', 'Speyer', 'Macon', 'Innsbruck', 'Uri', 'Schwyzern', 'Polen', 'Lombardei', 'Alpen', 'Nyon', 'Habsburg', 'Brig', 'Spanien', 'Leutkirch', 'Indien', 'Aubonne', 'Rottweil', 'Luzernern', 'Rouen', 'Aarberg', 'Bourg', 'Rheingebiet', 'Eptingen', 'Vuippens', 'Regensburg', 'Montpellier', 'Trier', 'Prag', 'Deutschland', 'Badens', 'Rhein', 'Ostschweiz', 'Ravensburg', 'Basel', 'Deutschlands', 'Klingnau', 'Lmzburg', 'Luzem', 'Giengen', 'Basels', 'Avignon', 'Oberitalien', 'Leipzig', 'Aarau', 'Gurmels', 'Wallis', 'Eger', 'freiburg'}",155,"{'Wangen Allgäu', 'Messe Genf', 'Zurzacher Marktes', 'Mainz 1410 Totnau', 'Ostem', 'Süddeutschland', 'Freiburg, SLOC', 'Bern DiesbachHause', 'Seckelmr St Genf', 'Perpignan', 'Brugg Rottweil', 'Übenwyl', 'Erlach Burgdorf', 'Goldguldcn', 'Nürnberger Bern', 'Gmünd', 'Frankfurt Ensisheim', 'Lindau Freiburg', 'Chillon von Genf', 'Köln', 'Savoyen Gut', 'Savoyen Missiven', 'Bern Alte Missiven', 'Seckelmeisterrechn', 'Westens', 'Bern Reich', 'München', 'Lentigny Missiven', 'Gerber Zurzach', 'Österreich', 'Nördlingen', 'Richardet', 'Haller Bern', 'Hauenstein', 'Ostermesse', 'Oberlandes', 'Straßburgs', 'Bonn', 'St Konstanz', 'Missiven', 'Straßburg', 'Pont dÄin', 'Mistralis Susa', 'Rheinlande', 'Kaufhause', 'Zolles Morges', 'St Freiburg Ratsmanuale', 'Seckelmcisterrechn', 'Iribourg', 'Pyrenäenhalbinsel', 'Gens Lyon', 'Ebda St Genf', 'Württemberg', 'Pouckaoo', 'Füllistorf', 'Romont', 'Uferstraße', 'Rheine', 'Morges Nyon', 'Wolf Genf', 'Neuß Desgl', 'Nürnberg', 'Genf Seckelmeisterrechn', 'WestOstStraße', 'Carcaffone', 'fl', 'Bern Solothurn', 'Villingen Schwaben', 'Neuß', 'Lentigny', 'Liestal Balstal', 'Zürich', 'Süddeutschlands', 'Brüssel', 'Welthaus', 'Bremstein', 'Albi Mavot', 'Südfrankreich', 'Gießen', 'Höchst', 'Weißenburg', 'Oollsetiov', 'Genf Lausanne', 'Versoix', 'Genfermesfe', 'Südwesteuropa', 'Südfrankreichs', 'Hauptstraße', 'Büren', 'Österreichs', 'Wels', 'Freiburgs Bern', 'Spiez', 'Basel St Gallen', 'Bern Frankfurt', 'Jura', 'St Gens Ainutss', 'Genf Ellen', 'Epiphanienmesse', 'Greyerz', 'Zollstellm', 'St Genf', 'Genf Missiven', 'Pyrenäenhalbinjel', 'Deutschand', 'St Galler', 'Desgl 1436 Genf', 'Thonon Kamerach', 'St Verena', 'Bem Zoll Oppenheim', 'Saane'}",111,"{'chtland', 'Kolmar', 'Edda', 'Gugla', 'Mlhausen', 'Zrich', 'Urk', 'Wippens', 'Sddeutschland', '- brg', 'Piemont.fi', 'Fllistorfs', 'kitzoos', 'krooos', 'Wyl', 'Sieveking', 'Vth', 'Kunditz', 'Brugg', 'Sigmaringen', 'Llinntes', 'Oder', 'Bhmen', 'Perroman', 'Mindelheim', 'Archiv', 'Zofingen', 'Grningm', 'Bleien', 'Nicklaus', 'Walliser', 'St. Neuenburg', 'Freiburg, ', 'Mnchen', 'Ungarn', 'Vogogna', 'St. Verena', '- nenhalbinsel', 'Pyre', 'Hall', 'Reutlingen', 'Aschaffenburg', 'Seltzach', 'Reg Boret', 'Villingen', 'Zurtzach', 'Lyons', 'Dessodi', 'Freiburg.fi', 'West-Ost-Strae', 'Gens', 'Dieenhofen', 'Ringoltingen', 'Heilbronn', '- burgs', 'Weienburg', 'Sdfrankreichs', 'Bruch', 'Ravensburger', 'Petri', 'Hallwyl', 'Straburger', 'Knonau', 'Bren', 'Brgge', 'Sdfrankreich', 'Schwbisch-Gmnd', 'Straburg', 'Speier', 'Valence.fi', 'sterreichs', 'Gmf', 'Aragon', 'Wrttemberg', 'Makenberg', 'Saanestadt', 'Scckclmr', 'Dynsburg', 'Frankfurt Kln', 'Jsny', 'Bodensees', 'Bodensce', 'Nufach', 'Mayland', 'Bayern', 'Johannstag', 'Preuen', 'Willisau', 'Ravens', 'St.', 'St. Basel', 'Laupen', 'XXl', 'Lombardorum', 'Kln', 'Wrtemb', 'Erlach', 'Reis', 'Braunschweig', 'Johannis', 'St. Galler', 'Ulm Villingen', 'benwyl', 'Elsa', 'Schulte', 'Delsberg', 'Frclburg', 'Pyrenenhalbinjel', 'Metern', 'Seckelmr', 'Bernern', 'Uecht', 'Bchi', 'Posen', 'Alaun', 'Irtbourg', 'Zhringen', 'Pfingsten', 'Ursprungsland', 'Allgu', 'Vivis', 'Schlesien', 'Konstanz Rottweil', 'Ebenda', 'Kre', 'Sddeutschlands', 'Lugano', 'Hessen', 'Friburgo', 'Brssel', 'Sarburg', 'Elingen', 'St. Freiburg', 'Nrdlingen', 'Savoyer', 'IHbourg', 'Sdwestfrankreich', 'Obretzschwendi', 'Ortsasran', 'Raemy', 'sterreich', 'Lobss', 'Amman', 'VMngen', 'Feldkirch', 'Oberer Hauenstein', 'Gallen', 'Osnsvs', 'Straburgs', 'Frei', '- lingen', 'Lyoner', 'Rappoltzweiler', 'Westen', 'Regno', 'Mhen', 'Peter Arsent', 'Lutrie', 'Mavot', 'ElingemZ', 'Ehrenwein', 'Wabern', 'Nidau', 'Pyrenenhalbinsel', 'Gmnd', 'Nicholaus', 'Borel', 'Rhodos', 'Chur', 'Klben', 'Ballen', 'Domo', 'Bem', 'Biberach', '- land', 'Nmberg', 'Liestal', 'Freiburgern', 'Totnau', 'Sachsen', 'Masmnster', 'Zrichkrieg', 'Wrttemb', 'St. Gervais', 'Berns', '- bach', 'Fllistorf', 'Balstal', 'Genf.fi', 'Roletus', 'Wiflis', 'Pfortzheim', 'Baar', 'Weiser-Vhlin', 'Freiburgcr', 'Thun', 'Como', 'Scckelmr', 'Evian', '- burg', 'Br', 'Wrzburg', 'Bingen', 'Ensisheim', 'Altis', 'Dieffenhofen', 'Berner', 'Challard', 'Rothenburg', 'Jngolstadt', 'Richarde', 'Millibach', 'Sdwesteuropa', 'Nsenstadt', 'Radolfzell', 'Pont din', 'Aachen', 'Rheinfelden', 'Assenheim', 'Berchtold', 'Bernem', 'Galizien', 'Lindau', 'Waldshut', 'Dinkelsbhl', 'St. Gallen', 'Hottingen', 'Gambach', 'Uferstrae', 'Neu', 'Aldi', 'Diesbach-Hause', 'Nrnberg'}",233,"{'Kolmar', 'Mlhausen', 'Zurzacher Marktes', 'Urk', 'Wippens', '- brg', 'Süddeutschland', 'kitzoos', 'krooos', 'Wyl', 'Freiburg, SLOC', 'Vth', 'Seckelmr St Genf', 'Perpignan', 'Oder', 'Perroman', 'Brugg Rottweil', 'Mindelheim', 'Übenwyl', 'Archiv', 'Grningm', 'Nicklaus', 'Walliser', 'Freiburg, ', 'Mnchen', 'Ungarn', 'Nürnberger Bern', '- nenhalbinsel', 'Aschaffenburg', 'Seltzach', 'Chillon von Genf', 'Reg Boret', 'Villingen', 'Savoyen Gut', 'Dieenhofen', 'Savoyen Missiven', 'Bern Alte Missiven', 'Heilbronn', 'Seckelmeisterrechn', '- burgs', 'Sdfrankreichs', 'Westens', 'Lentigny Missiven', 'Österreich', 'Richardet', 'Knonau', 'Brgge', 'Hauenstein', 'Sdfrankreich', 'Schwbisch-Gmnd', 'Straburg', 'Ostermesse', 'Oberlandes', 'Straßburgs', 'Valence.fi', 'Bonn', 'Makenberg', 'Scckclmr', 'Dynsburg', 'Frankfurt Kln', 'Pont dÄin', 'Bodensce', 'Mistralis Susa', 'Bayern', 'Preuen', 'Willisau', 'St.', 'St. Basel', 'Laupen', 'Lombardorum', 'Kln', 'Wrtemb', 'Erlach', 'Braunschweig', 'Johannis', 'Ulm Villingen', 'Elsa', 'Delsberg', 'Zolles Morges', 'Pyrenenhalbinjel', 'St Freiburg Ratsmanuale', 'Seckelmcisterrechn', 'Uecht', 'Alaun', 'Zhringen', 'Ursprungsland', 'Vivis', 'Kre', 'Sddeutschlands', 'Lugano', 'Ebenda', 'Württemberg', 'Pouckaoo', 'Rheine', 'Morges Nyon', 'Sarburg', 'Savoyer', 'IHbourg', 'Nürnberg', 'Sdwestfrankreich', 'Ortsasran', 'Carcaffone', 'Bern Solothurn', 'Villingen Schwaben', 'sterreich', 'Lobss', 'Amman', 'Gallen', 'Osnsvs', 'Neuß', '- lingen', 'Lentigny', 'Lyoner', 'Zürich', 'Peter Arsent', 'Lutrie', 'ElingemZ', 'Brüssel', 'Ehrenwein', 'Bremstein', 'Gmnd', 'Borel', 'Albi Mavot', 'Chur', 'Gießen', 'Ballen', 'Bem', 'Weißenburg', 'Biberach', '- land', 'Oollsetiov', 'Nmberg', 'Versoix', 'Totnau', 'Südwesteuropa', 'Hauptstraße', 'Masmnster', 'Zrichkrieg', 'Büren', 'Wrttemb', 'St. Gervais', 'Berns', '- bach', 'Wels', 'Genf.fi', 'Spiez', 'Basel St Gallen', 'Weiser-Vhlin', 'Como', 'Scckelmr', 'Evian', 'Br', 'Wrzburg', 'Jura', 'Altis', 'Dieffenhofen', 'Epiphanienmesse', 'Berner', 'Greyerz', 'Rothenburg', 'Richarde', 'St Genf', 'Nsenstadt', 'Radolfzell', 'Pont din', 'Rheinfelden', 'Assenheim', 'Berchtold', 'Bernem', 'St Galler', 'Desgl 1436 Genf', 'Galizien', 'Lindau', 'Thonon Kamerach', 'St Verena', 'Gambach', 'Uferstrae', 'Neu', 'Diesbach-Hause', 'Bem Zoll Oppenheim', 'chtland', 'Wangen Allgäu', 'Messe Genf', 'Edda', 'Gugla', 'Zrich', 'Sddeutschland', 'Mainz 1410 Totnau', 'Sieveking', 'Piemont.fi', 'Fllistorfs', 'Kunditz', 'Brugg', 'Ostem', 'Sigmaringen', 'Llinntes', 'Bern DiesbachHause', 'Bhmen', 'Zofingen', 'Bleien', 'St. Neuenburg', 'Erlach Burgdorf', 'Goldguldcn', 'Vogogna', 'St. Verena', 'Pyre', 'Hall', 'Reutlingen', 'Gmünd', 'Frankfurt Ensisheim', 'Lindau Freiburg', 'Zurtzach', 'Lyons', 'Köln', 'Dessodi', 'Freiburg.fi', 'West-Ost-Strae', 'Gens', 'Ringoltingen', 'Weienburg', 'Bruch', 'Ravensburger', 'Petri', 'Bern Reich', 'Hallwyl', 'München', 'Gerber Zurzach', 'Straburger', 'Nördlingen', 'Haller Bern', 'Bren', 'Speier', 'sterreichs', 'Gmf', 'Aragon', 'Wrttemberg', 'St Konstanz', 'Saanestadt', 'Jsny', 'Missiven', 'Straßburg', 'Bodensees', 'Nufach', 'Mayland', 'Johannstag', 'Ravens', 'XXl', 'Rheinlande', 'Reis', 'Kaufhause', 'St. Galler', 'benwyl', 'Schulte', 'Frclburg', 'Metern', 'Bernern', 'Seckelmr', 'Bchi', 'Pyrenäenhalbinsel', 'Posen', 'Iribourg', 'Irtbourg', 'Gens Lyon', 'Pfingsten', 'Allgu', 'Schlesien', 'Konstanz Rottweil', 'Ebda St Genf', 'Hessen', 'Füllistorf', 'Romont', 'Friburgo', 'Brssel', 'Uferstraße', 'Elingen', 'St. Freiburg', 'Nrdlingen', 'Wolf Genf', 'Neuß Desgl', 'Obretzschwendi', 'WestOstStraße', 'Genf Seckelmeisterrechn', 'Raemy', 'fl', 'VMngen', 'Feldkirch', 'Oberer Hauenstein', 'Straburgs', 'Frei', 'Rappoltzweiler', 'Westen', 'Liestal Balstal', 'Regno', 'Mhen', 'Süddeutschlands', 'Mavot', 'Wabern', 'Welthaus', 'Nidau', 'Pyrenenhalbinsel', 'Nicholaus', 'Rhodos', 'Südfrankreich', 'Klben', 'Höchst', 'Domo', 'Genf Lausanne', 'Liestal', 'Freiburgern', 'Genfermesfe', 'Sachsen', 'Südfrankreichs', 'Österreichs', 'Fllistorf', 'Balstal', 'Roletus', 'Wiflis', 'Pfortzheim', 'Freiburgs Bern', 'Baar', 'Freiburgcr', 'Thun', 'Bern Frankfurt', '- burg', 'Bingen', 'Ensisheim', 'St Gens Ainutss', 'Genf Ellen', 'Challard', 'Jngolstadt', 'Zollstellm', 'Millibach', 'Sdwesteuropa', 'Genf Missiven', 'Aachen', 'Deutschand', 'Pyrenäenhalbinjel', 'Dinkelsbhl', 'St. Gallen', 'Hottingen', 'Waldshut', 'Aldi', 'Nrnberg', 'Saane'}",344
